Year since Katrina,Affected by Katrina,Rural-urban Continuum Code ,Urban Influence Code,Percent of adults with less than a high school diploma,Percent of adults with a high school diploma only,Percent of adults completing some college or associate's degree,Percent of adults with a bachelor's degree or higher,Personal income (thousands of dollars), Net earnings by place of residence, Personal current transfer receipts,  Income maintenance benefits,  Unemployment insurance compensation,  Retirement and other," Dividends, interest, and rent", Population (persons), Per capita personal income, Per capita net earnings, Per capita personal current transfer receipts,  Per capita income maintenance benefits,  Per capita unemployment insurance compensation,  Per capita retirement and other," Per capita dividends, interest, and rent", Earnings by place of work,  Wages and salaries,  Supplements to wages and salaries,   Employer contributions for employee pension and insurance funds,   Employer contributions for government social insurance,  Proprietors' income,   Farm proprietors' income,   Nonfarm proprietors' income,Total employment (number of jobs), Wage and salary employment, Proprietors employment,  Farm proprietors employment,  Nonfarm proprietors employment,Average earnings per job (dollars), Average wages and salaries, Average nonfarm proprietors' income,Patent Grants
0,1,3,2,35.2,34.9,19.4,10.5,228769,124363,66536,13622,568,52346,37870,9675,23645,12854,6877,1408,59,5410,3914,108240,65493,21494,16617,4877,21253,15178,6075,3323,2517,806,269,537,32573,26020,11313,0
0,1,8,6,37.6,30.4,22,10,246603,126124,90003,18137,812,71054,30476,10881,22664,11591,8272,1667,75,6530,2801,115142,63260,18411,13528,4883,33471,19382,14089,3743,2744,999,309,690,30762,23054,20419,0
0,1,8,7,40.5,30.3,19.2,10.1,247621,122084,92295,21751,822,69722,33242,12369,20019,9870,7462,1759,66,5637,2688,174335,117508,30883,22364,8519,25944,11535,14409,4895,3668,1227,283,944,35615,32036,15264,0
0,1,9,10,34.9,37.5,19.8,7.8,338811,195273,99635,8909,854,89872,43903,15009,22574,13010,6638,594,57,5988,2925,182731,127420,34102,24169,9933,21209,5550,15659,6225,4468,1757,366,1391,29354,28518,11257,1
0,1,9,10,35,34.7,20.6,9.6,318924,174515,102487,13022,860,88605,41922,14545,21927,11998,7046,895,59,6092,2882,232983,178334,40884,28905,11979,13765,-98,13863,5542,4472,1070,215,855,42040,39878,16214,0
0,1,8,6,35.2,31.1,21.2,12.4,294745,163246,92791,19278,874,72639,38708,14143,20840,11543,6561,1363,62,5136,2737,163679,114217,32364,23633,8731,17098,12029,5069,5839,4284,1555,354,1201,28032,26661,4221,1
0,1,3,2,34.8,35.9,21.2,8.1,391336,239234,103354,17191,943,85220,48748,16622,23543,14393,6218,1034,57,5127,2933,168755,102861,29010,21306,7704,36884,23509,13375,5363,4046,1317,366,951,31467,25423,14064,0
0,1,1,1,36.8,35.7,20.4,7.1,471142,308075,111056,13974,975,96107,52011,22042,21375,13977,5038,634,44,4360,2360,180182,125477,34516,24725,9791,20189,3217,16972,6194,4526,1668,166,1502,29090,27724,11300,2
0,1,8,6,30.3,37.8,22.1,9.8,525012,312389,138087,18122,1074,118891,74536,20192,26001,15471,6839,897,53,5888,3691,215228,116082,32192,23371,8821,66954,36271,30683,6251,4519,1732,403,1329,34431,25688,23087,0
0,1,7,11,28.1,37.4,22.5,12.1,580216,342267,145057,21970,1239,121848,92892,21569,26900,15868,6725,1019,57,5649,4307,357896,241813,63671,45722,17949,52412,14998,37414,10345,8328,2017,433,1584,34596,29036,23620,0
0,1,6,4,37.4,34.3,20.1,8.3,617946,382202,158945,14992,1277,142676,76799,24629,25090,15518,6454,609,52,5793,3118,407420,251209,68052,47610,20442,88159,30189,57970,13111,9697,3414,530,2884,31075,25906,20101,1
0,1,7,11,32.1,34.4,21.7,11.8,566844,360780,137461,20015,1461,115985,68603,23683,23935,15234,5804,845,62,4897,2897,436249,325181,78731,54067,24664,32337,10039,22298,12442,9868,2574,398,2176,35063,32953,10247,1
0,1,8,4,36.8,32.9,22.3,8,724133,439193,188850,17393,1489,169968,96090,30494,23747,14403,6193,570,49,5574,3151,507119,344313,92905,65095,27810,69901,20077,49824,15496,12731,2765,644,2121,32726,27045,23491,0
0,1,7,11,29.2,37.7,21.1,12.1,635742,367822,172245,27430,1600,143215,95675,26764,23754,13743,6436,1025,60,5351,3575,400473,282202,74401,53490,20911,43870,8092,35778,13197,10270,2927,258,2669,30346,27478,13405,0
0,1,6,3,29.6,32,26.5,11.9,2194939,1450655,456516,37162,3860,415494,287768,78692,27893,18435,5801,472,49,5280,3657,1349883,839528,212745,149516,63229,297610,152245,145365,39086,29051,10035,2001,8034,34536,28898,18094,6
0,1,3,2,26.7,33.9,25.3,14.1,1450904,886891,357490,30354,4909,322227,206523,54359,26691,16315,6576,558,90,5928,3799,1122078,777363,207868,147630,60238,136847,15507,121340,28652,23519,5133,559,4574,39162,33053,26528,4
0,1,3,2,23.6,34.1,23.8,18.5,2429403,1462942,507618,41522,6113,459983,458843,89358,27187,16372,5681,465,68,5148,5135,1289633,854407,223910,158023,65887,211316,29770,181546,42490,33055,9435,1348,8087,30351,25848,22449,8
0,1,4,5,18,29.6,29.3,23.1,5237162,3214283,848385,60698,7448,780239,1174494,162183,32292,19819,5231,374,46,4811,7242,2585394,1709193,408463,278599,129864,467738,-3504,471242,82612,61348,21264,896,20368,31296,27861,23136,9
0,1,3,2,21.2,28.4,26.4,24,5175022,3334284,907674,96625,7887,803162,933064,175731,29449,18974,5165,550,45,4570,5310,4101551,3039823,778614,559591,219023,283114,7102,276012,103621,89254,14367,472,13895,39582,34058,19864,7
0,1,2,2,23.3,31.9,26.2,18.6,10863211,6864857,2330697,358252,22101,1950344,1667657,398942,27230,17208,5842,898,55,4889,4180,8412310,6143627,1471044,1010016,461028,797639,6858,790781,218945,184313,34632,650,33982,38422,33333,23271,16
0,1,1,1,19.1,27.9,28.4,24.6,24773644,15747150,3537900,402901,36317,3098682,5488594,654919,37827,24044,5402,615,55,4731,8381,22338561,16343453,3632624,2447623,1185001,2362484,-1057,2363541,460333,398358,61975,384,61591,48527,41027,38375,42
0,1,6,7,31.7,36.4,19.5,12.4,299675,158520,59384,6662,498,52224,81771,10198,29386,15544,5823,653,49,5121,8018,161909,95000,25309,18718,6591,41600,0,41600,5214,3458,1756,0,1756,31053,27473,23690,1
0,1,6,6,27.4,37.1,25.3,10.1,365012,209528,86491,7921,587,77983,68993,15781,23130,13277,5481,502,37,4942,4372,203560,130786,39226,30150,9076,33548,0,33548,5866,4303,1563,0,1563,34702,30394,21464,0
0,1,6,6,24,32.3,27.4,16.2,1623366,976937,251601,22808,1470,227323,394828,49392,32867,19779,5094,462,30,4602,7994,959894,595370,139982,98578,41404,224542,-774,225316,27171,19461,7710,561,7149,35328,30593,31517,14
0,1,4,3,15.1,28.9,30.5,25.5,4184826,1781469,358677,34706,2994,320977,2044680,75819,55195,23496,4731,458,39,4233,26968,1976590,1402569,329312,231506,97806,244709,0,244709,53888,40122,13766,0,13766,36680,34958,17776,16
0,1,2,2,14.6,29.2,33.4,22.9,4463505,2959243,641147,57007,4861,579279,863115,141132,31626,20968,4543,404,34,4105,6116,1756952,1162215,302059,217774,84285,292678,9955,282723,51313,36092,15221,462,14759,34240,32201,19156,26
0,1,3,2,12,27.1,36.6,24.2,6916170,4269167,892935,77578,5726,809631,1754068,184045,37579,23196,4852,422,31,4399,9531,5399077,3787996,1067110,781748,285362,543971,1627,542344,123373,103414,19959,441,19518,43762,36629,27787,9
0,1,3,2,19,30.6,32.7,17.7,5311868,3309245,910204,93594,8226,808384,1092419,162917,32605,20312,5587,574,50,4962,6705,3834420,2735598,716112,518486,197626,382710,205,382505,97038,80511,16527,104,16423,39515,33978,23291,31
0,1,2,2,17.9,28.3,32.7,21,8886428,5399671,1640904,197995,10772,1432137,1845853,298339,29786,18099,5500,664,36,4800,6187,6957198,5119555,1351701,980023,371678,485942,4409,481533,172394,146989,25405,590,24815,40356,34830,19405,18
0,1,2,2,18.2,26.2,27.6,27.9,18020573,7261236,1606676,101781,11569,1493326,9152661,307452,58613,23617,5226,331,38,4857,29769,7938374,5573313,1122514,748130,374384,1242547,95793,1146754,182757,141263,41494,209,41285,43437,39453,27777,43
0,1,1,1,18,28.4,29.1,24.5,66291459,42692591,8835065,912281,108426,7814358,14763803,1746896,37948,24439,5058,522,62,4473,8451,43461101,32548494,7186072,4920509,2265563,3726535,5491,3721044,998739,802037,196702,317,196385,43516,40582,18948,262
0,1,1,1,32.1,22.3,23.9,21.7,81289794,50350363,14050299,2169987,151131,11729181,16889132,2385872,34071,21104,5889,910,63,4916,7079,63944107,45584327,10334718,7173064,3161654,8025062,66623,7958439,1387609,1095993,291616,1630,289986,46082,41592,27444,165
0,1,6,7,32.6,41.8,16.9,8.7,194653,105105,66644,12444,1495,52705,22904,9295,20942,11308,7170,1339,161,5670,2464,95058,62289,16786,12755,4031,15983,6914,9069,3210,2395,815,192,623,29613,26008,14557,0
0,1,6,6,31.5,38.5,18.8,11.2,309116,179675,90121,7985,1589,80547,39320,14313,21597,12553,6296,558,111,5628,2747,153269,101602,29596,23603,5993,22071,2432,19639,5223,3974,1249,134,1115,29345,25567,17613,0
0,1,8,7,34.6,38.6,18,8.8,238046,136310,75717,8926,1618,65173,26019,10247,23231,13302,7389,871,158,6360,2539,98726,67034,19074,14732,4342,12618,2445,10173,3745,2686,1059,235,824,26362,24957,12346,0
0,1,9,10,36.8,31.5,16.9,14.8,144366,66948,43797,8571,1654,33572,33621,5700,25327,11745,7684,1504,290,5890,5898,71270,43765,12439,9815,2624,15066,11277,3789,2345,1782,563,187,376,30392,24559,10077,1
0,1,9,10,38.6,36.7,15.3,9.4,241763,134220,78929,14518,1800,62611,28614,10258,23568,13084,7694,1415,175,6104,2789,120075,60935,18174,14395,3779,40966,17942,23024,3940,2709,1231,377,854,30476,22494,26960,0
0,1,6,5,26.4,39.7,21,12.9,383635,227022,106807,10904,1972,93931,49806,15674,24476,14484,6814,696,126,5993,3178,180916,120513,31741,24383,7358,28662,11777,16885,5103,3867,1236,175,1061,35453,31164,15914,0
0,1,7,9,42.1,31.2,14.3,12.3,164890,79974,62370,13196,1985,47189,22546,8374,19691,9550,7448,1576,237,5635,2692,86259,57141,16202,12980,3222,12916,9430,3486,2820,2253,567,183,384,30588,25362,9078,0
0,1,6,6,34.6,40,16,9.4,343332,199863,103796,13647,2042,88107,39673,15751,21797,12689,6590,866,130,5594,2519,217673,152168,39218,29014,10204,26287,2525,23762,6620,5458,1162,116,1046,32881,27880,22717,0
0,1,2,2,46.7,24,18.7,10.6,328537,220042,52270,6207,2054,44009,56225,15431,21291,14260,3387,402,133,2852,3644,327355,243437,69904,57895,12009,14014,923,13091,6949,5855,1094,132,962,47108,41578,13608,0
0,1,7,8,36.6,33.7,18.7,11,273648,154598,92050,21497,2229,68324,27000,12663,21610,12209,7269,1698,176,5396,2132,154974,91614,28204,22876,5328,35156,22250,12906,4736,3868,868,233,635,32723,23685,20324,0
0,1,7,9,34.3,35.2,18.1,12.4,408095,233859,109315,14950,2270,92095,64921,16908,24136,13831,6465,884,134,5447,3840,223705,140677,40595,32570,8025,42433,21905,20528,6156,4984,1172,199,973,36339,28226,21098,1
0,1,6,6,28.1,41.3,19.1,11.5,21161,183700,107920,15210,2360,90350,50069,14852,23006,12369,7266,1024,159,6083,3371,178700,123012,32863,24742,8121,22825,6276,16549,5476,4240,1236,164,1072,32633,29012,15438,0
0,1,9,10,40.5,34.8,15.2,9.5,261138,144823,88498,11355,2660,74483,27817,11958,21838,12111,7401,950,222,6229,2326,134356,84105,22045,16586,5459,28206,17583,10623,4335,2963,1372,724,648,30993,28385,16394,0
0,1,3,2,26.9,41.6,21.7,9.8,454129,289214,110749,14381,2782,93586,54166,20386,22277,14187,5433,705,136,4591,2657,158440,100725,32298,26011,6287,25417,1616,23801,4991,3486,1505,186,1319,31745,28894,18045,0
0,1,6,6,29.2,40.9,18.8,11.1,555846,316490,157839,19101,2989,135749,81517,23690,23463,13360,6663,806,126,5730,3441,265251,154464,42809,32950,9859,67978,27585,40393,8110,6036,2074,304,1770,32707,25590,22821,0
0,1,3,2,28.3,40.1,19.8,11.8,577325,364563,144729,16378,3329,125022,68033,22765,25360,16014,6358,719,146,5492,2988,243363,142611,40849,31180,9669,59903,41497,18406,8510,6039,2471,371,2100,28597,23615,8765,0
0,1,6,6,38.1,32.1,16.9,12.8,510311,305133,151106,20742,3393,126971,54072,20466,24935,14909,7383,1013,166,6204,2642,267327,154764,43259,33150,10109,69304,20354,48950,8401,6255,2146,565,1581,31821,24742,30961,1
0,1,6,5,25,39.5,21.7,13.8,26971,584664,269,4521,3571,108958,66504,34130,26293,17131,5317,727,166,4425,3845,394083,278237,70984,53142,17842,44862,1051,43811,12482,9088,3394,685,2709,31572,30616,16172,2
0,1,7,11,38.6,36.5,15.1,9.8,458644,253987,150776,21506,3685,125585,53881,20660,22200,12294,7298,1041,178,6079,2608,230976,132902,39258,31071,8187,58816,31444,27372,8390,5914,2476,866,1610,27530,22472,17001,0
0,1,2,2,26.6,40.6,21.7,11.1,644885,446062,133675,29009,3798,100868,65148,21929,29408,20341,6096,1323,173,4600,2971,469687,341748,83807,60927,22880,44132,7266,36866,11956,10006,1950,94,1856,39285,34154,19863,1
0,1,2,2,29.7,40.6,19.4,10.2,634575,394552,157698,23404,4042,130252,82325,26029,24380,15158,6059,899,155,5004,3163,309959,222490,56614,42638,13976,30855,4265,26590,9229,6879,2350,500,1850,33585,32343,14373,1
0,1,7,8,35.4,34.5,20.6,9.6,537472,302183,163045,34634,4073,124338,72244,19885,27029,15197,8199,1742,205,6253,3633,290234,152525,42953,33842,9111,94756,14066,80690,7685,5846,1839,328,1511,37766,26090,53402,1
0,1,1,1,31.3,34.2,23.7,10.8,795654,500978,202980,43817,4159,155004,91696,29558,26918,16949,6867,1482,141,5244,3102,941174,699462,174070,128543,45527,67642,2683,64959,18453,16029,2424,132,2292,51004,43637,28342,0
0,1,6,6,36.8,38,16,9.3,535010,319079,146201,22589,4405,119207,69730,25076,21336,12724,5830,901,176,4754,2781,341064,235692,68890,56346,12544,36482,4641,31841,10545,8803,1742,306,1436,32344,26774,22173,0
0,1,6,6,44.5,30.6,15.4,9.5,789526,446559,247420,38322,4514,204584,95547,34532,22864,12932,7165,1110,131,5924,2767,328668,208749,60506,47252,13254,59413,10990,48423,11104,8477,2627,590,2037,29599,24625,23772,1
0,1,2,2,30.9,39.1,17.3,12.8,612026,383286,125658,18931,4555,102172,103082,22075,27725,17363,5692,858,206,4628,4670,253932,166826,47012,35924,11088,40094,10471,29623,8435,6184,2251,359,1892,30105,26977,15657,1
0,1,6,5,30.6,41.2,18.3,9.9,800543,491041,192697,25673,4599,162425,116805,31202,25657,15737,6176,823,147,5206,3744,361775,234510,62842,47707,15135,64423,14072,50351,11712,9113,2599,533,2066,30889,25734,24371,0
0,1,6,4,26.1,45.2,18.7,10.1,568955,380946,126058,22108,4932,99018,61951,21399,26588,17802,5891,1033,230,4627,2895,450344,335381,99700,79331,20369,15263,-405,15668,8976,7622,1354,36,1318,50172,44002,11888,0
0,1,6,5,40.6,36.9,15.1,7.4,572531,365922,133624,21271,5082,107271,72985,23199,24679,15773,5760,917,219,4624,3146,223922,154680,39676,29757,9919,29566,-122,29688,6776,4882,1894,59,1835,33046,31684,16179,0
0,1,6,5,33.4,38.8,18.1,9.7,707605,403596,220882,36524,5492,178866,83127,29355,24105,13749,7525,1244,187,6093,2832,351486,238133,60850,45478,15372,52503,27471,25032,10597,8221,2376,342,2034,33168,28966,12307,1
0,1,2,2,34.3,38.9,17.2,9.6,818483,503560,214028,45327,5808,162893,100895,32697,25032,15401,6546,1386,178,4982,3086,864118,665135,167917,127591,40326,31066,-557,31623,17148,14825,2323,126,2197,50392,44866,14394,2
0,1,6,5,27.3,32.1,22.2,18.4,1035769,674092,237080,38526,6353,192201,124597,39107,26486,17237,6062,985,162,4915,3186,701446,417039,118237,93523,24714,166170,19488,146682,19042,15463,3579,448,3131,36837,26970,46848,1
0,1,6,5,29.2,35.9,22.3,12.6,1082407,649613,291741,31522,6431,253788,141053,41203,26270,15766,7081,765,156,6159,3423,574729,408654,105676,78254,27422,60399,1669,58730,17775,13893,3882,347,3535,32334,29414,16614,1
0,1,4,5,19.6,24.7,23.9,31.8,1190504,731266,241814,33271,6557,201986,217424,44580,26705,16403,5424,746,147,4531,4877,868226,529963,144658,113018,31640,193605,27396,166209,23084,19038,4046,277,3769,37612,27837,44099,0
0,1,6,3,31.8,40.2,17.1,10.9,1007414,529169,362823,59662,6832,296329,115422,44880,22447,11791,8084,1329,152,6603,2572,464894,323334,91437,73091,18346,50123,1186,48937,15826,11591,4235,699,3536,29375,27895,13840,1
0,1,6,6,40.2,37,14.5,8.3,959363,549805,278813,41988,6867,229958,130745,41036,23379,13398,6794,1023,167,5604,3186,431071,265581,77934,63125,14809,87556,14934,72622,15496,11711,3785,726,3059,27818,22678,23740,0
0,1,4,5,19.9,36.4,30.2,13.5,1482811,981622,247976,40890,7165,199921,253213,51808,28621,18947,4786,789,138,3859,4888,1193945,847798,290161,223978,66183,55986,2102,53884,26983,24088,2895,389,2506,44248,35196,21502,1
0,1,4,5,34.4,38,16.9,10.7,1389951,889677,309692,47105,7170,255417,190582,55828,24897,15936,5547,844,128,4575,3414,660030,450014,111267,83083,28184,98749,14020,84729,20204,14503,5701,920,4781,32668,31029,17722,3
0,1,4,5,35.3,38,17.2,9.4,1436538,908523,347232,49073,7961,290198,180783,59524,24134,15263,5833,824,134,4875,3037,694460,476681,118802,88592,30210,98977,18888,80089,21523,16243,5280,657,4623,32266,29347,17324,2
0,1,1,1,26.9,37.9,26.2,8.9,1546006,965750,400794,66812,9048,324934,179462,71300,21683,13545,5621,937,127,4557,2517,688992,489115,135923,104847,31076,63954,2026,61928,16783,15324,1459,26,1433,41053,31918,43216,2
0,1,4,5,34.1,38.3,18.2,9.4,1460928,862728,328388,56523,10123,261742,269812,53015,27557,16273,6194,1066,191,4937,5089,1255895,944039,218707,158284,60423,93149,-283,93432,30723,26104,4619,78,4541,40878,36165,20575,4
0,1,4,5,33.1,38.5,17.2,11.2,2010654,1277505,429252,75201,11255,342796,303897,72641,27679,17587,5909,1035,155,4719,4184,1598365,1192560,261352,182106,79246,144453,-1650,146103,40618,33800,6818,253,6565,39351,35283,22255,5
0,1,1,1,20,36.1,26.4,17.5,1629753,1199722,252656,43893,13326,195437,177375,50670,32164,23677,4986,866,263,3857,3501,1492111,1115019,288083,219125,68958,89009,50,88959,28541,23690,4851,46,4805,52280,47067,18514,1
0,1,1,1,23.1,38.9,25,12.9,1255056,858615,271515,64610,13697,193208,124926,45296,27708,18956,5994,1426,302,4265,2758,707025,516227,134006,100901,33105,56792,432,56360,17896,13863,4033,22,4011,39507,37238,14051,1
0,1,4,5,38,33.3,18,10.7,2170501,1286075,606024,100647,13769,491608,278402,83952,25854,15319,7219,1199,164,5856,3316,1098497,750139,199015,152354,46661,149343,5050,144293,34042,26448,7594,1047,6547,32269,28363,22040,2
0,1,3,2,33.7,38,16,12.4,2735785,1801488,471789,61112,13994,396683,462508,92656,29526,19443,5092,660,151,4281,4992,1745212,1210515,301005,226089,74916,233692,2640,231052,44801,35677,9124,324,8800,38955,33930,26256,6
0,1,2,2,17,32.5,32.4,18.1,3207984,2139207,546864,66938,14506,465420,521913,107477,29848,19904,5088,623,135,4330,4856,2125079,1500601,412593,308020,104573,211885,2715,209170,57933,48048,9885,374,9511,36682,31231,21992,1
0,1,2,2,20.4,41.7,23.4,14.5,2756904,2043214,446788,91497,15374,339917,266902,89741,30721,22768,4979,1020,171,3788,2974,1666193,1221588,299359,219782,79577,145246,-1445,146691,42265,33296,8969,236,8733,39423,36689,16797,8
0,1,4,3,28.5,34.3,21,16.3,2807808,1754711,741840,132743,15963,593134,311257,106987,26244,16401,6934,1241,149,5544,2909,1633384,1098033,305662,239999,65663,229689,6616,223073,52420,40981,11439,920,10519,31160,26794,21207,7
0,1,2,2,22.8,43.2,22.6,11.4,2919327,2132410,514638,84771,16223,413644,272279,109208,26732,19526,4712,776,149,3788,2493,910224,591901,155780,117497,38283,162543,-202,162745,33154,21456,11698,377,11321,27454,27587,14375,3
0,1,3,2,32.9,35.8,19,12.3,3071324,2100358,573760,91198,17273,465289,397206,107811,28488,19482,5322,846,160,4316,3684,2460275,1824398,399309,278572,120737,236568,2085,234483,63248,52626,10622,119,10503,38899,34667,22325,17
0,1,3,2,25.4,33.8,24.3,16.5,4065740,2322587,1031852,148443,19015,864394,711301,127544,31877,18210,8090,1164,149,6777,5577,2791841,1946726,502418,376384,126034,342697,7416,335281,74644,62895,11749,763,10986,37402,30952,30519,3
0,1,3,2,23,34.6,25.6,16.9,5290587,3462041,1094781,176605,22792,895384,733765,186417,28380,18571,5873,947,122,4803,3936,4174365,3071776,780512,584749,195763,322077,-141,322218,104860,89117,15743,732,15011,39809,34469,21465,6
0,1,3,2,21.4,30,25.9,22.7,4122709,2612343,863737,131557,22996,709184,646629,149476,27581,17477,5778,880,154,4744,4326,3161548,2288913,574604,428286,146318,298031,8793,289238,91370,74736,16634,379,16255,34602,30627,17794,9
0,1,3,2,20.2,29,25.4,25.5,7122662,4849923,922924,122520,28145,772259,1349815,202053,35251,24003,4568,606,139,3822,6680,6591176,4699705,997814,689389,308425,893657,-203,893860,154963,129799,25164,566,24598,42534,36208,36339,39
0,1,1,1,16.1,26.5,29,28.3,7973804,5537370,1228894,204130,28465,996299,1207540,217358,36685,25476,5654,939,131,4584,5556,3486396,2278674,548664,405094,143570,659058,-521,659579,96967,71030,25937,470,25467,35954,32080,25899,14
0,1,2,2,21.3,32.2,25.9,20.6,8300900,5215997,1510426,211261,36983,1262182,1574477,249593,33258,20898,6052,846,148,5057,6308,6593718,4493180,1091548,798064,293484,1008990,5062,1003928,156133,130397,25736,476,25260,42231,34458,39744,8
0,1,1,1,20.7,30,27.8,21.5,15257862,10277876,2867691,539381,53601,2274709,2112295,456554,33420,22512,6281,1181,117,4982,4627,10963758,7628856,1677134,1173556,503578,1657768,486,1657282,255091,212271,42820,45,42775,42980,35939,38744,37
0,1,1,1,25.3,23.4,25.5,25.8,14559548,8492224,3267824,846347,64765,2356712,2799500,494294,29455,17181,6611,1712,131,4768,5664,13637368,9346695,2171407,1569770,601637,2119266,0,2119266,257148,234442,22706,0,22706,53033,39868,93335,15
0,1,2,2,16.1,26.4,26.7,30.8,14513756,9686347,2428659,500462,76312,1851885,2398750,413812,35073,23408,5869,1209,184,4475,5797,13046733,9445722,2276256,1687939,588317,1324755,690,1324065,309845,266027,43818,393,43425,42107,35507,30491,57
0,1,9,10,41.2,31.2,20.5,7.1,43107,32677,6597,1519,206,4872,3833,1720,25062,18998,3835,883,120,2833,2228,25838,7813,2000,1405,595,16025,14625,1400,456,334,122,74,48,56662,23392,29167,0
0,1,9,10,34.9,32.7,21.2,11.2,183471,106424,56181,7080,622,48479,20866,9026,20327,11791,6224,784,69,5371,2312,103264,70212,18369,13024,5345,14683,4951,9732,3226,2417,809,251,558,32010,29049,17441,0
0,1,9,10,32.5,33.8,23.2,10.5,173050,98283,54080,6728,622,46730,20687,8076,21428,12170,6696,833,77,5786,2562,79540,52011,14902,11104,3798,12627,3883,8744,2651,1863,788,174,614,30004,27918,14241,0
0,1,9,10,32.3,33.9,20.7,13,246679,134800,81279,8599,647,72033,30600,9979,24720,13508,8145,862,65,7218,3066,104211,60333,16656,12126,4530,27222,9282,17940,4034,2485,1549,332,1217,25833,24279,14741,0
0,1,9,10,39.4,28.8,19.2,12.6,133684,73164,43327,9023,683,33621,17193,5707,23425,12820,7592,1581,120,5891,3013,72792,36634,9536,6842,2694,26622,22590,4032,1993,1610,383,84,299,36524,22754,13485,0
0,1,8,4,41.2,32.2,18.8,7.8,167783,104445,48956,6889,692,41375,14382,8307,20198,12573,5893,829,83,4981,1731,60604,35292,9451,6823,2628,15861,3205,12656,2078,1331,747,270,477,29165,26515,26532,0
0,1,9,8,33.4,34.7,21,10.9,239305,151808,59330,7868,758,50704,28167,10473,22850,14495,5665,751,72,4841,2689,66072,34304,9451,6762,2689,22317,8119,14198,2674,1471,1203,489,714,24709,23320,19885,1
0,1,7,9,37.9,32,19.1,11,262594,149449,81509,9982,887,70640,31636,11474,22886,13025,7104,870,77,6157,2757,114105,69558,20175,14863,5312,24372,5796,18576,4319,3183,1136,315,821,26419,21853,22626,0
0,1,9,8,39.5,28.3,21.9,10.3,202767,115683,63196,8504,888,53804,23888,10551,19218,10964,5990,806,84,5099,2264,79948,50630,15628,11841,3787,13690,6289,7401,3126,2247,879,423,456,25575,22532,16230,0
0,1,8,7,29.2,38.3,23.3,9.1,428396,288050,102664,13145,946,88573,37682,16332,26230,17637,6286,805,58,5423,2307,239434,108658,30497,22383,8114,100279,84382,15897,5571,3825,1746,662,1084,42979,28407,14665,0
0,1,8,7,27.1,34.2,26.8,12,328339,198429,98513,12078,975,85460,31397,13097,25070,15151,7522,922,74,6525,2397,179636,112855,27075,18936,8139,39706,22072,17634,4269,2960,1309,399,910,42079,38127,19378,0
0,1,3,2,28,38.1,26.2,7.7,264624,149477,88038,13107,982,73949,27109,12088,21891,12366,7283,1084,81,6118,2243,134684,93853,21940,15387,6553,18891,6956,11935,3803,2751,1052,306,746,35415,34116,15999,0
0,1,8,5,32.8,35.6,22.2,9.4,294803,169671,89444,12455,985,76004,35688,13396,22007,12666,6677,930,74,5674,2664,103720,60270,15638,11036,4602,27812,17539,10273,3747,2411,1336,537,799,27681,24998,12857,1
0,1,8,7,32.6,38,21.4,8,230538,146839,59594,9064,1016,49514,24105,13201,17464,11123,4514,687,77,3751,1826,91478,55166,16637,12611,4026,19675,12765,6910,3340,2318,1022,355,667,27389,23799,10360,0
0,1,7,10,35.6,34.6,19.6,10.2,337192,199631,98104,11447,1034,85623,39457,14803,22779,13486,6627,773,70,5784,2665,162827,98330,26135,18735,7400,38362,18524,19838,5787,4052,1735,581,1154,28137,24267,17191,0
0,1,8,7,41.9,33.1,15.1,10,200439,104422,66294,11943,1044,53307,29723,10123,19800,10315,6549,1180,103,5266,2936,86318,55857,14609,10180,4429,15852,5019,10833,3290,2263,1027,199,828,26236,24683,13083,0
0,1,1,1,39.5,30.2,21.3,9.1,251934,153504,60555,13701,1045,45809,37875,10425,24166,14725,5809,1314,100,4394,3633,596488,472366,84178,46553,37625,39944,23199,16745,16609,15931,678,79,599,35914,29651,27955,0
0,1,7,9,31,37.6,21.8,9.6,295684,160744,92153,11188,1059,79906,42787,12979,22782,12385,7100,862,82,6157,3297,142982,90538,25362,18644,6718,27082,7009,20073,4672,3063,1609,332,1277,30604,29559,15719,0
0,1,8,7,33.6,34.9,21.2,10.4,273387,157013,88157,15137,1123,71897,28217,12859,21260,12210,6856,1177,87,5591,2194,108897,63657,17502,12624,4878,27738,14651,13087,3777,2637,1140,386,754,28832,24140,17357,0
0,1,7,10,41.6,30.6,16.9,10.9,254708,141625,83637,17508,1170,64959,29446,11973,21274,11829,6985,1462,98,5425,2459,150027,85246,23868,17479,6389,40913,22740,18173,4750,3445,1305,513,792,31585,24745,22946,0
0,1,3,2,25.2,30.2,32.2,12.4,403229,245886,109198,15983,1178,92037,48145,15189,26547,16188,7189,1052,78,6059,3170,174794,117086,30895,22285,8610,26813,-11,26824,6107,4440,1667,283,1384,28622,26371,19382,0
0,1,9,10,33,34,22.5,10.4,323506,179501,106168,18525,1238,86405,37837,15081,21451,11902,7040,1228,82,5729,2509,141617,78781,21385,15445,5940,41451,21468,19983,5011,3330,1681,640,1041,28261,23658,19196,0
0,1,9,8,31.2,36.8,22.3,9.6,402360,235894,119673,14574,1250,103849,46793,16905,23801,13954,7079,862,74,6143,2768,125335,78759,22053,16210,5843,24523,6858,17665,4708,3230,1478,329,1149,26622,24384,15374,0
0,1,9,8,33.3,34.5,22.4,9.8,420652,263182,110352,16970,1302,92080,47118,17496,24043,15042,6307,970,74,5263,2693,206768,125858,33316,24056,9260,47594,26671,20923,6114,4532,1582,446,1136,33819,27771,18418,0
0,1,7,10,45.6,24.2,19.2,10.9,333080,199263,86832,17287,1336,68209,46985,15348,21702,12983,5658,1126,87,4444,3061,154930,80736,21512,15318,6194,52682,39314,13368,4516,3443,1073,387,686,34307,23449,19487,2
0,1,8,6,32.8,31.9,23.9,11.4,471758,302041,120089,18414,1353,100322,49628,19480,24218,15505,6165,945,69,5150,2548,269567,147868,39566,28497,11069,82133,42343,39790,7990,5893,2097,518,1579,33738,25092,25199,1
0,1,7,9,31.8,33.3,21,13.8,460941,269480,124258,16334,1369,106555,67203,19583,23538,13761,6345,834,70,5441,3432,256258,178266,43801,30373,13428,34191,10426,23765,7858,6001,1857,473,1384,32611,29706,17171,0
0,1,7,9,27.1,33.4,27.4,12.1,527360,318941,147724,16497,1399,129828,60695,21611,24402,14758,6836,763,65,6007,2809,282122,175995,48346,35138,13208,57781,32224,25557,8903,7004,1899,608,1291,31688,25128,19796,3
0,1,6,6,35.9,31.8,20.7,11.6,491922,311242,128747,16782,1433,110532,51933,22869,21510,13610,5630,734,63,4833,2271,285457,152822,42353,30520,11833,90282,63885,26397,8591,6577,2014,651,1363,33227,23236,19367,0
0,1,6,6,36.6,29.8,21.9,11.6,431622,251557,120935,15419,1444,104072,59130,19265,22404,13058,6277,800,75,5402,3069,235089,146264,39921,28697,11224,48904,5257,43647,7719,5943,1776,480,1296,30456,24611,33678,1
0,1,7,9,35.3,34.8,20.4,9.5,489597,296648,127260,20800,1479,104981,65689,21021,23291,14112,6054,989,70,4994,3125,283601,169406,44325,31770,12555,69870,43789,26081,8047,6254,1793,471,1322,35243,27088,19728,0
0,1,7,9,34.5,35.9,20.6,9,495171,300217,137969,14048,1491,122430,56985,21536,22993,13940,6406,652,69,5685,2646,307486,218052,56152,38862,17290,33282,2628,30654,10416,7981,2435,625,1810,29521,27321,16936,1
0,1,8,6,35.4,36,20,8.7,411155,225112,128838,9404,1637,117797,57205,19232,21379,11705,6699,489,85,6125,2974,223712,158756,42847,30489,12358,22109,2203,19906,7595,6081,1514,317,1197,29455,26107,16630,0
0,1,2,2,31.2,35.3,22.6,10.9,710058,440117,194111,22457,1651,170003,75830,27633,25696,15927,7025,813,60,6152,2744,332822,180214,48348,34656,13692,104260,63829,40431,10805,8176,2629,628,2001,30803,22042,20205,0
0,1,7,8,36.2,27.6,22.7,13.5,588484,355209,148828,18453,1723,128652,84447,22173,26541,16020,6712,832,78,5802,3809,467787,330968,84622,59905,24717,52197,5462,46735,14043,11812,2231,306,1925,33311,28020,24278,2
0,1,3,2,30.2,38.7,21.9,9.1,518280,347565,118779,17195,1725,99859,51936,20699,25039,16791,5738,831,83,4824,2509,192784,133669,35506,25521,9985,23609,2595,21014,7287,5081,2206,513,1693,26456,26308,12412,0
0,1,7,9,31.5,33.7,21.5,13.2,619329,385495,139837,13242,1741,124854,93997,26569,23310,14509,5263,498,66,4699,3538,366744,248694,62686,43546,19140,55364,9323,46041,12497,9341,3156,689,2467,29347,26624,18663,1
0,1,7,9,40.6,30.4,19.5,9.5,426344,254503,111582,14192,1769,95621,60259,18369,23210,13855,6074,773,96,5206,3280,267887,175936,45709,31196,14513,46242,12708,33534,8901,6754,2147,557,1590,30096,26049,21091,0
0,1,7,8,33.3,33.8,21.5,11.4,680713,467357,140054,13517,1807,124730,73302,28567,23829,16360,4903,473,63,4366,2566,490740,343058,83396,55870,27526,64286,6549,57737,15629,12465,3164,780,2384,31399,27522,24219,0
0,1,1,1,28.3,32.5,26.8,12.3,692782,476890,137576,15738,1828,120010,78316,26968,25689,17684,5101,584,68,4450,2904,275862,175358,45710,32501,13209,54794,11011,43783,9650,6653,2997,564,2433,28587,26358,17995,1
0,1,6,6,40.3,26.7,21.9,11.2,397335,194201,158478,33642,1883,122953,44656,20052,19815,9685,7903,1678,94,6132,2227,180222,116096,31516,22834,8682,32610,16264,16346,6309,4640,1669,468,1201,28566,25021,13610,0
0,1,6,6,33.5,33.4,21.6,11.5,578769,307226,184677,29108,1933,153636,86866,25706,22515,11952,7184,1132,75,5977,3379,332171,219247,54676,38307,16369,58248,21302,36946,11100,8610,2490,527,1963,29925,25464,18821,1
0,1,7,9,32.3,31.7,24.6,11.4,852051,554448,182195,21382,2003,158810,115408,29364,29017,18882,6205,728,68,5408,3930,679086,429387,105751,73999,31752,143948,69786,74162,18313,15766,2547,635,1912,37082,27235,38788,0
0,1,7,9,31.4,31.7,22.3,14.6,540735,321450,123231,18537,2063,102631,96054,21245,25452,15131,5800,873,97,4831,4521,342538,225634,57201,39545,17656,59703,24450,35253,9829,7861,1968,437,1531,34850,28703,23026,0
0,1,7,8,34.1,31.5,25.6,8.8,567224,362046,140002,10370,2195,127437,65176,23254,24393,15569,6021,446,94,5480,2803,245516,167618,43421,30651,12770,34477,11202,23275,7760,6170,1590,441,1149,31639,27167,20257,1
0,1,7,9,35.1,31.3,23.6,9.9,546096,330702,144542,13004,2205,129333,70852,25608,21325,12914,5644,508,86,5050,2767,305779,222841,59051,42457,16594,23887,4261,19626,9971,8507,1464,507,957,30667,26195,20508,0
0,1,6,5,35,31,22.2,11.8,635109,361190,169049,30447,2248,136354,104870,28107,22596,12851,6014,1083,80,4851,3731,324377,197926,53778,39575,14203,72673,38085,34588,9117,6750,2367,526,1841,35579,29322,18788,0
0,1,2,2,30.7,30.2,27.6,11.6,658232,405439,179946,28962,2274,148710,72847,29134,22593,13916,6176,994,78,5104,2500,326204,219262,63633,47111,16522,43309,13916,29393,11619,8914,2705,584,2121,28075,24597,13858,1
0,1,6,5,28,31.6,28,12.4,903488,578617,215155,24921,2443,187791,109716,33748,26772,17145,6375,738,72,5565,3251,576357,381090,92275,64262,28013,102992,22208,80784,16797,13404,3393,615,2778,34313,28431,29080,1
0,1,6,3,21.5,22.7,24.7,31.1,1208412,747894,192510,14778,2487,175245,268008,42526,28416,17587,4527,348,58,4121,6302,847675,583692,157443,114893,42550,106540,4915,101625,25072,19990,5082,456,4626,33810,29199,21968,4
0,1,7,8,31.9,34.8,21.5,11.7,831827,479493,238019,21222,2570,214227,114315,35688,23308,13436,6669,595,72,6003,3203,568719,413393,103435,72058,31377,51891,2644,49247,17419,14614,2805,481,2324,32649,28287,21191,0
0,1,5,8,40.7,25.6,21.7,12,643687,368248,185224,39139,2575,143510,90215,31724,20290,11608,5839,1234,81,4524,2844,422783,268978,75367,55005,20362,78438,51707,26731,12960,11395,1565,289,1276,32622,23605,20949,0
0,1,5,8,37.8,21.5,24.5,16.2,693846,370515,220160,40509,2654,176997,103171,27875,24891,13292,7898,1453,95,6350,3701,437251,296826,69672,48059,21613,70753,49223,21530,12191,10448,1743,204,1539,35867,28410,13990,0
0,1,3,2,17,27,29.2,26.8,1216539,835282,209142,27513,2688,178941,172115,46684,26059,17892,4480,589,58,3833,3687,628109,396919,99907,70612,29295,131283,13948,117335,22427,15883,6544,462,6082,28007,24990,19292,1
0,1,5,8,20,21.7,23.4,34.8,1076092,674607,182802,25144,2756,154902,218683,43985,24465,15337,4156,572,63,3522,4972,783466,557997,157088,115721,41367,68381,3602,64779,24718,21186,3532,409,3123,31696,26338,20743,6
0,1,5,8,26.6,31.7,24.2,17.5,814533,432080,234921,32383,2820,199718,147532,32674,24929,13224,7190,991,86,6112,4515,512254,359564,85684,58380,27304,67006,4042,62964,16409,13132,3277,218,3059,31218,27381,20583,0
0,1,6,4,36.5,29.5,23.1,10.8,779619,475482,198567,31833,2934,163800,105570,34684,22478,13709,5725,918,85,4723,3044,485859,312915,85769,62127,23642,87175,24862,62313,14993,11710,3283,647,2636,32406,26722,23639,1
0,1,1,1,39,32.5,19.4,9,814733,550212,186300,29854,3000,153446,78221,36052,22599,15262,5168,828,83,4256,2170,300120,187752,49767,35422,14345,62601,6726,55875,11319,7310,4009,539,3470,26515,25684,16102,5
0,1,5,8,38.1,25.7,20.4,15.9,860390,460267,238247,42551,3121,192575,161876,34178,25174,13467,6971,1245,91,5634,4736,682304,459846,124289,90087,34202,98169,42801,55368,19239,16957,2282,234,2048,35465,27118,27035,0
0,1,7,9,34.5,32.4,22.2,10.9,915632,576347,219045,23790,3131,192124,120240,37464,24440,15384,5847,635,84,5128,3209,536707,362652,98352,70318,28034,75703,17065,58638,15286,12120,3166,631,2535,35111,29922,23131,2
0,1,7,8,29.7,32,25.7,12.5,922419,517131,280832,43969,3152,233711,124456,38905,23710,13292,7218,1130,81,6007,3199,610432,419785,111509,80100,31409,79138,9878,69260,20932,16584,4348,513,3835,29163,25313,18060,0
0,1,5,8,34.7,24.3,22.1,18.8,870408,507101,241669,48136,3248,190285,121638,36305,23975,13968,6657,1326,89,5241,3350,528572,356419,95043,68862,26181,77110,46855,30255,15998,13538,2460,359,2101,33040,26327,14400,1
0,1,4,5,23,26.5,29.7,20.8,1512194,981455,278571,39745,3815,235011,252168,48836,30965,20097,5704,814,78,4812,5164,1172636,849561,221359,156963,64396,101716,15260,86456,29702,25543,4159,232,3927,39480,33260,22016,5
0,1,4,5,26.1,32.2,27.6,14,1808624,1054743,489386,53193,3941,432252,264495,65871,27457,16012,7429,808,60,6562,4015,1339356,941081,250006,181168,68838,148269,50390,97879,36937,31188,5749,929,4820,36261,30174,20307,1
0,1,6,3,25.4,31.2,29.5,13.9,1271560,759716,342830,50858,4373,287599,169014,50990,24937,14899,6723,997,86,5640,3315,453589,277708,75500,55057,20443,100381,2923,97458,17074,10917,6157,766,5391,26566,25438,18078,0
0,1,5,8,24.5,29.8,25.2,20.5,1580728,987828,306646,43572,4441,258633,286254,59237,26685,16676,5177,736,75,4366,4832,1203151,884048,229853,162240,67613,89250,16673,72577,33193,28127,5066,423,4643,36247,31431,15631,3
0,1,3,2,22.1,29.3,31.3,17.3,1272801,647897,437387,109584,5008,322795,187517,47715,26675,13578,9167,2297,105,6765,3930,784651,574588,146015,102422,43593,64048,251,63797,18149,14516,3633,252,3381,43234,39583,18869,2
0,1,3,2,20.7,27.9,28.6,22.8,1966955,1180658,450059,65021,5096,379942,336238,72043,27303,16388,6247,903,71,5274,4667,1735823,1236369,318104,228160,89944,181350,7792,173558,46335,40844,5491,360,5131,37462,30271,33825,6
0,1,5,8,25.1,28.1,30.6,16.2,2139744,1309922,486194,62392,5532,418270,343628,78082,27404,16776,6227,799,71,5357,4401,1703338,1237415,320256,225169,95087,145667,2142,143525,46385,40777,5608,388,5220,36722,30346,27495,4
0,1,5,8,33.5,28.7,21.4,16.4,1363270,792098,366693,79246,6025,281422,204479,55872,24400,14177,6563,1418,108,5037,3660,912405,625930,160608,113590,47018,125867,56434,69433,26156,22364,3792,269,3523,34883,27988,19708,3
0,1,1,1,18.4,34.1,33.2,14.3,4054175,3164791,475670,45346,6809,423515,413714,136915,29611,23115,3474,331,50,3093,3022,1923357,1301185,303399,205687,97712,318773,5867,312906,58962,44416,14546,481,14065,32620,29295,22247,6
0,1,5,8,25.3,28.2,28.4,18.1,2313159,1579943,397761,43494,7170,347097,335455,78529,29456,20119,5065,554,91,4420,4272,2372269,1763455,409391,278873,130518,199423,8729,190694,62075,54274,7801,528,7273,38216,32492,26219,10
0,1,2,2,18.2,27.4,30.6,23.8,4177315,2984469,602548,49742,7342,545464,590298,130354,32046,22895,4622,382,56,4184,4528,2652310,1876694,433821,296960,136861,341795,37948,303847,73009,58497,14512,694,13818,36329,32082,21989,11
0,1,3,2,19,32.1,32.4,16.5,3936022,2499251,930063,187479,13769,728815,506708,137913,28540,18122,6744,1359,100,5285,3674,2677484,1933696,566593,420934,145659,177195,1210,175985,63173,53606,9567,438,9129,42383,36072,19278,3
0,1,2,2,19.6,21.9,31.3,27.2,7579019,4787895,1328891,220269,18716,1089906,1462233,247370,30638,19355,5372,890,76,4406,5911,7222661,5146852,1238136,866459,371677,837673,10317,827356,169959,144438,25521,969,24552,42496,35634,33698,9
0,1,3,2,19.7,28.4,33.5,18.4,5696040,3262620,1474574,321718,22248,1130608,958846,197784,28799,16496,7455,1627,112,5716,4848,4600431,3414595,896024,632376,263648,289812,-1388,291200,117826,103307,14519,337,14182,39044,33053,20533,12
1,1,3,2,35.2,34.9,19.4,10.5,238568,126791,69781,12967,492,56322,41996,9361,25485,13545,7454,1385,53,6017,4486,112669,69441,22628,17612,5016,20600,13966,6634,3393,2506,887,253,634,33206,27710,10464,0
1,1,9,10,35,34.7,20.6,9.6,331906,179676,111817,12436,784,98597,40413,14431,23000,12451,7748,862,54,6832,2800,247406,188548,41172,28710,12462,17686,-86,17772,5661,4519,1142,211,931,43704,41723,19089,0
1,1,8,6,37.6,30.4,22,10,248017,126737,92094,18906,796,72392,29186,10677,23229,11870,8625,1771,75,6780,2734,118058,64414,18373,13454,4919,35271,16945,18326,3860,2801,1059,297,762,30585,22997,24050,0
1,1,8,7,40.5,30.3,19.2,10.1,264065,129602,100150,22010,798,77342,34313,12221,21607,10605,8195,1801,65,6329,2808,182165,119543,30216,21664,8552,32406,12527,19879,5070,3612,1458,281,1177,35930,33096,16890,0
1,1,9,10,34.9,37.5,19.8,7.8,344015,193885,106950,9386,815,96749,43180,14816,23219,13086,7219,634,55,6530,2914,176221,125471,32163,22828,9335,18587,5064,13523,6085,4286,1799,345,1454,28960,29275,9301,0
1,1,8,6,35.2,31.1,21.2,12.4,309713,165875,108220,19247,851,88122,35618,14059,22030,11798,7698,1369,61,6268,2533,165349,117485,31371,22727,8644,16493,11103,5390,5720,4181,1539,338,1201,28907,28100,4488,0
1,1,1,1,36.8,35.7,20.4,7.1,502442,330041,122439,13640,958,107841,49962,22099,22736,14935,5540,617,43,4880,2261,189808,132609,34494,24636,9858,22705,3003,19702,6336,4621,1715,163,1552,29957,28697,12695,0
1,1,3,2,34.8,35.9,21.2,8.1,420102,261667,108523,17610,979,89934,49912,16427,25574,15929,6606,1072,60,5475,3038,179445,108495,28732,20651,8081,42218,28187,14031,5487,3971,1516,359,1157,32704,27322,12127,0
1,1,7,11,28.1,37.4,22.5,12.1,608775,355843,158817,22680,1043,135094,94115,21531,28274,16527,7376,1053,48,6274,4371,370634,249149,63840,45547,18293,57645,15208,42437,10716,8584,2132,423,1709,34587,29025,24831,1
1,1,8,6,30.3,37.8,22.1,9.8,512518,298747,145421,17476,1083,126862,68350,20128,25463,14842,7225,868,54,6303,3396,189724,117030,31602,22857,8745,41092,11361,29731,6283,4515,1768,388,1380,30196,25920,21544,0
1,1,6,4,37.4,34.3,20.1,8.3,628939,379238,171368,14843,1354,155171,78333,24796,25365,15294,6911,599,55,6258,3159,402810,263040,68187,47448,20739,71583,9545,62038,13364,9927,3437,507,2930,30141,26497,21173,0
1,1,7,11,32.1,34.4,21.7,11.8,579761,360871,148473,20306,1472,126695,70417,23602,24564,15290,6291,860,62,5368,2984,429697,321194,75660,51937,23723,32843,5632,27211,12068,9585,2483,391,2092,35606,33510,13007,0
1,1,8,4,36.8,32.9,22.3,8,733585,436047,202764,17313,1527,183924,94774,30779,23834,14167,6588,562,50,5976,3079,504315,356747,91937,64070,27867,55631,6136,49495,15498,12739,2759,623,2136,32541,28004,23172,1
1,1,7,11,29.2,37.7,21.1,12.1,665489,380146,181965,26267,1664,154034,103378,26755,24873,14208,6801,982,62,5757,3864,415622,293433,74438,53030,21408,47751,7302,40449,13375,10269,3106,253,2853,31075,28575,14178,0
1,1,6,3,29.6,32,26.5,11.9,2226965,1435989,496569,38410,3539,454620,294407,79044,28174,18167,6282,486,45,5751,3725,1329599,892901,215889,150210,65679,220809,69027,151782,40422,30154,10268,1952,8316,32893,29611,18252,11
1,1,3,2,26.7,33.9,25.3,14.1,1534962,936708,382510,30695,4223,347592,215744,54413,28209,17215,7030,564,78,6388,3965,1190020,838643,210393,147041,63352,140984,2706,138278,29442,24183,5259,561,4698,40419,34679,29433,3
1,1,3,2,23.6,34.1,23.8,18.5,2564186,1552471,550420,41681,5246,503493,461295,90294,28398,17194,6096,462,58,5576,5109,1364699,909709,227699,159613,68086,227291,32442,194849,44158,34675,9483,1332,8151,30905,26235,23905,5
1,1,4,5,18,29.6,29.3,23.1,5847880,3548105,928616,58233,6570,863813,1371159,168121,34784,21104,5523,346,39,5138,8156,2905157,1914891,426787,285847,140940,563479,3095,560384,87768,64775,22993,870,22123,33100,29562,25330,7
1,1,3,2,21.2,28.4,26.4,24,5545149,3534160,965370,99874,7493,858003,1045619,181383,30571,19485,5322,551,41,4730,5765,4423397,3291893,815874,584024,231850,315630,2852,312778,108650,93227,15423,461,14962,40712,35311,20905,8
1,1,2,2,23.3,31.9,26.2,18.6,11995713,7736996,2383796,312412,19715,2051669,1874921,402916,29772,19203,5916,775,49,5092,4653,9401702,6766584,1513634,1031635,481999,1121484,19607,1101877,226409,188454,37955,645,37310,41525,35906,29533,29
1,1,1,1,19.1,27.9,28.4,24.6,26372533,16530789,3784677,416551,34262,3333864,6057067,655893,40209,25203,5770,635,52,5083,9235,23304336,17013480,3664042,2455682,1208360,2626814,-4361,2631175,466897,400705,66192,372,65820,49913,42459,39975,46
1,1,6,7,31.7,36.4,19.5,12.4,324032,166091,63783,6607,317,56859,94158,11308,28655,14688,5641,584,28,5028,8327,167609,105607,27971,20588,7383,34031,0,34031,5438,3639,1799,0,1799,30822,29021,18917,0
1,1,6,6,27.4,37.1,25.3,10.1,382188,213644,91112,7844,556,82712,77432,15856,24104,13474,5746,495,35,5216,4883,210661,141911,41534,31539,9995,27216,0,27216,6053,4524,1529,0,1529,34803,31368,17800,0
1,1,6,6,24,32.3,27.4,16.2,1833986,1094964,270448,22619,1392,246437,468574,51145,35859,21409,5288,442,27,4818,9162,1061495,693035,151364,102090,49274,217096,779,216317,29952,21952,8000,567,7433,35440,31570,29102,13
1,1,4,3,15.1,28.9,30.5,25.5,4710299,1883593,354146,25705,2713,325728,2472560,73793,63831,25525,4799,348,37,4414,33507,2098447,1501251,332086,225429,106657,265110,0,265110,54626,40241,14385,0,14385,38415,37307,18430,10
1,1,2,2,14.6,29.2,33.4,22.9,4828941,3181653,689245,57542,4660,627043,958043,142983,33773,22252,4820,402,33,4385,6700,1930943,1303843,318522,221927,96595,308578,13367,295211,52764,36956,15808,453,15355,36596,35281,19226,17
1,1,3,2,12,27.1,36.6,24.2,7250159,4329582,944539,72063,5611,866865,1976038,184071,39388,23521,5131,391,30,4709,10735,5562782,4017815,1078792,767884,310908,466175,2145,464030,125289,104985,20304,434,19870,44400,38270,23353,19
1,1,3,2,19,30.6,32.7,17.7,5706667,3553607,961382,89690,8207,863485,1191678,165644,34451,21453,5804,541,50,5213,7194,4118033,2947041,725899,508714,217185,445093,59,445034,100143,83013,17130,101,17029,41122,35501,26134,26
1,1,2,2,17.9,28.3,32.7,21,9530430,5722396,1740643,195026,9374,1536243,2067391,300395,31726,19050,5795,649,31,5114,6882,7384481,5471492,1377329,969025,408304,535660,7393,528267,176678,150413,26265,567,25698,41796,36376,20557,11
1,1,2,2,18.2,26.2,27.6,27.9,20829534,7862361,1733567,97975,11593,1623999,11233606,312621,66629,25150,5545,313,37,5195,35934,8558763,5961974,1136877,721707,415170,1459912,81165,1378747,190179,147122,43057,205,42852,45004,40524,32175,69
1,1,1,1,18,28.4,29.1,24.5,70220027,44829490,9031731,847339,92441,8091951,16358806,1739348,40371,25774,5193,487,53,4652,9405,46517171,34758148,7132780,4686075,2446705,4626243,4346,4621897,1024720,817900,206820,312,206508,45395,42497,22381,329
1,1,1,1,32.1,22.3,23.9,21.7,89171620,53639962,14735037,2078620,125870,12530547,20796621,2405911,37064,22295,6125,864,52,5208,8644,67660193,48687033,10270843,6875574,3395269,8702317,52961,8649356,1420814,1106519,314295,1581,312714,47621,44000,27659,209
1,1,9,10,36.8,31.5,16.9,14.8,149365,73955,43611,7459,561,35591,31799,5719,26117,12931,7626,1304,98,6223,5560,81946,49768,14891,11864,3027,17287,12605,4682,2464,1883,581,180,401,33257,26430,11676,0
1,1,8,7,34.6,38.6,18,8.8,256038,154595,77588,7757,582,69249,23855,10224,25043,15121,7589,759,57,6773,2333,104263,70612,20679,16241,4438,12972,3611,9361,3799,2752,1047,229,818,27445,25658,11444,0
1,1,6,7,32.6,41.8,16.9,8.7,195828,108807,65590,9255,616,55719,21431,9281,21100,11724,7067,997,66,6004,2309,97626,64169,17388,13264,4124,16069,7365,8704,3144,2341,803,186,617,31052,27411,14107,1
1,1,6,6,31.5,38.5,18.8,11.2,339569,206358,94446,7514,654,86278,38765,14519,23388,14213,6505,518,45,5942,2670,174559,114824,34483,27807,6676,25252,4049,21203,5422,4195,1227,132,1095,32195,27372,19363,0
1,1,9,10,38.6,36.7,15.3,9.4,248636,144035,77606,10071,725,66810,26995,10423,23855,13819,7446,966,70,6410,2590,130215,63070,19374,15470,3904,47771,22212,25559,4037,2755,1282,371,911,32255,22893,28056,0
1,1,2,2,46.7,24,18.7,10.6,376637,245051,61314,6036,781,54497,70272,15736,23935,15573,3896,384,50,3463,4466,320006,234569,71908,60297,11611,13529,1216,12313,6757,5582,1175,129,1046,47359,42022,11772,1
1,1,7,9,42.1,31.2,14.3,12.3,174695,85072,63469,12519,800,50150,26154,8188,21335,10390,7751,1529,98,6125,3194,93375,61518,18421,14960,3461,13436,8831,4605,2955,2405,550,177,373,31599,25579,12346,0
1,1,6,6,34.6,40,16,9.4,358863,210257,110227,11862,875,97490,38379,15720,22828,13375,7012,755,56,6202,2441,228049,153848,39765,29576,10189,34436,2179,32257,6602,5394,1208,114,1094,34542,28522,29485,0
1,1,6,5,26.4,39.7,21,12.9,393720,232466,114462,10659,881,102922,46792,15950,24685,14575,7176,668,55,6453,2934,179880,120951,32226,24936,7290,26703,5018,21685,4981,3757,1224,163,1061,36113,32194,20438,0
1,1,7,8,36.6,33.7,18.7,11,280908,162179,89747,17254,884,71609,28982,12537,22406,12936,7159,1376,71,5712,2312,161556,93435,29715,24228,5487,38406,24897,13509,4700,3803,897,231,666,34374,24569,20284,0
1,1,6,6,28.1,41.3,19.1,11.5,23162,187758,110712,13002,985,96725,46037,14773,23320,12710,7494,880,67,6547,3116,185257,129256,34316,25946,8370,21685,3702,17983,5419,4157,1262,152,1110,34187,31094,16201,0
1,1,7,9,34.3,35.2,18.1,12.4,415598,239550,110279,14419,1000,94860,65769,17109,24291,14001,6446,843,58,5544,3844,227988,146333,43514,35278,8236,38141,17126,21015,6115,4933,1182,184,998,37283,29664,21057,0
1,1,9,10,40.5,34.8,15.2,9.5,279321,161078,93431,9864,1046,82521,24812,11851,23569,13592,7884,832,88,6963,2094,165648,112163,25930,18651,7279,27555,17026,10529,4839,3293,1546,753,793,34232,34061,13277,0
1,1,3,2,26.9,41.6,21.7,9.8,484118,314006,118367,14015,1120,103232,51745,21039,23011,14925,5626,666,53,4907,2459,162867,102348,33982,27588,6394,26537,2171,24366,5002,3487,1515,189,1326,32560,29351,18376,1
1,1,6,6,29.2,40.9,18.8,11.1,557145,322281,164787,15916,1157,147714,70077,23954,23259,13454,6879,664,48,6167,2925,263518,160063,44422,34178,10244,59033,14589,44444,8235,6067,2168,288,1880,32000,26383,23640,0
1,1,2,2,26.6,40.6,21.7,11.1,724192,523811,126226,15894,1380,108952,74155,22666,31951,23110,5569,701,61,4807,3272,545403,395160,93936,67641,26295,56307,6099,50208,12786,10551,2235,93,2142,42656,37452,23440,0
1,1,6,6,38.1,32.1,16.9,12.8,560835,341525,160898,20142,1385,139371,58412,20661,27145,16530,7788,975,67,6746,2827,293430,163255,45455,34913,10542,84720,23975,60745,8572,6309,2263,587,1676,34231,25877,36244,0
1,1,3,2,28.3,40.1,19.8,11.8,596117,371221,157871,16188,1393,140290,67025,22919,26010,16197,6888,706,61,6121,2924,230345,145774,41888,32387,9501,42683,20920,21763,8266,5808,2458,346,2112,27867,25099,10304,2
1,1,6,6,36.8,38,16,9.3,567065,353483,144629,16185,1415,127029,68953,25692,22072,13758,5629,630,55,4944,2684,376193,263302,77478,62638,14840,35413,1601,33812,10818,9079,1739,300,1439,34775,29001,23497,0
1,1,7,8,35.4,34.5,20.6,9.6,515682,301539,149455,21395,1458,126602,64688,20315,25384,14843,7357,1053,72,6232,3184,279091,161820,44999,35371,9628,72272,13611,58661,7668,5811,1857,334,1523,36397,27847,38517,0
1,1,2,2,30.9,39.1,17.3,12.8,671197,428437,137960,18122,1459,118379,104800,22754,29498,18829,6063,796,64,5203,4606,274691,178039,51178,39303,11875,45474,15446,30028,8665,6264,2401,342,2059,31701,28423,14584,1
1,1,6,5,30.6,41.2,18.3,9.9,853855,520237,200372,19456,1467,179449,133246,31489,27116,16521,6363,618,47,5699,4232,380620,250686,66660,50644,16016,63274,7432,55842,11980,9259,2721,522,2199,31771,27075,25394,0
1,1,7,11,38.6,36.5,15.1,9.8,487189,279918,156895,21044,1562,134289,50376,20685,23553,13532,7585,1017,76,6492,2435,253768,138300,41543,33228,8315,73925,44220,29705,8465,5924,2541,894,1647,29978,23346,18036,0
1,1,6,5,40.6,36.9,15.1,7.4,636528,430060,137920,18758,1660,117502,68548,23477,27113,18318,5875,799,71,5005,2920,264234,176345,43861,32592,11269,44028,3094,40934,7153,5163,1990,60,1930,36940,34156,21209,0
1,1,6,6,44.5,30.6,15.4,9.5,856343,503616,255081,35418,1704,217959,97646,34839,24580,14456,7322,1017,49,6256,2803,352246,226576,65320,51179,14141,60350,8604,51746,11222,8523,2699,593,2106,31389,26584,24571,0
1,1,6,4,26.1,45.2,18.7,10.1,654494,461782,129283,17132,1711,110440,63429,21964,29798,21024,5886,780,78,5028,2888,496021,350463,117096,96597,20499,28462,1434,27028,9062,7388,1674,33,1641,54736,47437,16470,0
1,1,2,2,29.7,40.6,19.4,10.2,678819,432750,167963,23570,1716,142677,78106,26175,25934,16533,6417,900,66,5451,2984,328536,233901,59983,45494,14489,34652,5945,28707,9218,6829,2389,480,1909,35641,34251,15038,2
1,1,2,2,34.3,38.9,17.2,9.6,874524,566750,204825,29481,2328,173016,102949,33519,26090,16908,6111,880,69,5162,3071,875622,671607,172039,131491,40548,31976,3399,28577,17321,14777,2544,123,2421,50553,45449,11804,1
1,1,6,5,33.4,38.8,18.1,9.7,718226,410747,230855,34469,2367,194019,76624,29079,24699,14125,7939,1185,81,6672,2635,345761,237123,61400,46214,15186,47238,18688,28550,10637,8197,2440,335,2105,32505,28928,13563,0
1,1,6,6,40.2,37,14.5,8.3,1021383,594860,301097,40605,2461,258031,125426,42080,24272,14136,7155,965,58,6132,2981,456358,286480,85421,69443,15978,84457,19493,64964,15767,11870,3897,701,3196,28944,24135,20327,1
1,1,6,5,27.3,32.1,22.2,18.4,1096830,723414,243536,36431,2504,204601,129880,38984,28135,18557,6247,935,64,5248,3332,745002,430055,123023,97655,25368,191924,18101,173823,19246,15562,3684,433,3251,38709,27635,53468,0
1,1,4,5,19.6,24.7,23.9,31.8,1341385,841828,246112,27540,2675,215897,253445,44867,29897,18763,5485,614,60,4812,5649,1000340,577688,155260,121132,34128,267392,13144,254248,24272,19825,4447,255,4192,41214,29139,60651,9
1,1,6,5,29.2,35.9,22.3,12.6,1151499,685325,310534,30800,2686,277048,155640,41331,27860,16581,7513,745,65,6703,3766,597554,426520,109253,80983,28270,61781,1504,60277,18278,14250,4028,337,3691,32693,29931,16331,0
1,1,4,5,35.3,38,17.2,9.4,1568032,1023517,358777,43430,2864,312483,185738,60522,25908,16911,5928,718,47,5163,3069,753269,515358,128279,95611,32668,109632,20145,89487,22385,16785,5600,650,4950,33651,30703,18078,3
1,1,4,5,34.1,38.3,18.2,9.4,1688218,1036240,341982,48114,3257,290611,309996,54152,31176,19136,6315,888,60,5367,5725,1556975,1172363,256364,182394,73970,128248,2156,126092,33359,28361,4998,82,4916,46673,41337,25649,5
1,1,4,5,19.9,36.4,30.2,13.5,1518695,1011631,248636,27186,3394,218056,258428,50781,29907,19921,4896,535,67,4294,5089,1262029,891827,306449,235824,70625,63753,1941,61812,26998,23946,3052,381,2671,46745,37243,23142,0
1,1,1,1,31.3,34.2,23.7,10.8,765866,524836,130048,12463,3493,114092,110982,22329,34299,23505,5824,558,156,5110,4970,1042931,766045,189549,140292,49257,87337,11519,75818,18094,15415,2679,126,2553,57640,49695,29698,1
1,1,1,1,20,36.1,26.4,17.5,1840012,1371511,240641,28090,3504,209047,227860,52453,35079,26147,4588,536,67,3985,4344,1631724,1189119,317719,243965,73754,124886,197,124689,29692,23958,5734,44,5690,54955,49633,21914,4
1,1,6,5,25,39.5,21.7,13.8,26564,655150,247,4827,3673,104968,63060,34510,28045,18984,5350,509,59,4783,3710,417878,297507,74816,55869,18947,45555,1651,43904,12832,9286,3546,677,2869,32565,32038,15303,0
1,1,4,5,33.1,38.5,17.2,11.2,2261394,1469864,433365,61582,3948,367835,358165,73362,30825,20036,5907,839,54,5014,4882,1892956,1421804,296577,204764,91813,174575,3083,171492,42976,35817,7159,244,6915,44047,39696,24800,7
1,1,1,1,23.1,38.9,25,12.9,1358921,990851,250736,39367,4277,207092,117334,47296,28732,20950,5301,832,90,4379,2481,862186,611617,160064,121210,38854,90505,945,89560,20074,15232,4842,20,4822,42950,40153,18573,1
1,1,3,2,33.7,38,16,12.4,3297672,2184626,495033,54166,4544,436323,618013,94385,34939,23146,5245,574,48,4623,6548,2151298,1434661,343083,254644,88439,373554,12277,361277,47172,37209,9963,315,9648,45605,38557,37446,5
1,1,6,3,31.8,40.2,17.1,10.9,1110539,617060,370007,44317,5015,320675,123472,45157,24593,13665,8194,981,111,7101,2734,497900,340256,97227,77767,19460,60417,4615,55802,16512,11645,4867,687,4180,30154,29219,13350,4
1,1,4,5,34.4,38,16.9,10.7,1576790,1032268,319965,33812,5084,281069,224557,56388,27963,18307,5674,600,90,4985,3982,733021,496657,121983,91204,30779,114381,14031,100350,20807,14790,6017,894,5123,35230,33581,19588,1
1,1,4,5,38,33.3,18,10.7,2369056,1442689,637845,87239,5143,545463,288522,85128,27829,16947,7493,1025,60,6408,3389,1192346,802302,214922,165455,49467,175122,9515,165607,35122,27040,8082,1033,7049,33949,29671,23494,3
1,1,3,2,32.9,35.8,19,12.3,3646358,2588949,590142,72648,5394,512100,467267,109994,33151,23537,5365,660,49,4656,4248,3076578,2244580,464802,319199,145603,367196,9320,357876,68243,57194,11049,117,10932,45083,39245,32737,20
1,1,1,1,26.9,37.9,26.2,8.9,886277,626880,140607,13319,5673,121615,118790,16563,53509,37848,8489,804,343,7343,7172,553817,393499,112105,87709,24396,48213,6209,42004,10082,8225,1857,26,1831,54931,47842,22940,5
1,1,2,2,20.4,41.7,23.4,14.5,3211452,2448393,415918,45177,5827,364914,347141,96421,33307,25393,4314,469,60,3785,3600,1894155,1392091,331595,241684,89911,170469,704,169765,46008,35929,10079,220,9859,41170,38746,17219,10
1,1,2,2,17,32.5,32.4,18.1,3494060,2327697,574806,58307,6142,510357,591557,110606,31590,21045,5197,527,56,4614,5348,2279126,1614241,432642,320689,111953,232243,3960,228283,59808,49245,10563,366,10197,38107,32780,22387,3
1,1,2,2,22.8,43.2,22.6,11.4,3352008,2500423,531970,56475,6590,468905,319615,115722,28966,21607,4597,488,57,4052,2762,1010784,647107,167107,125768,41339,196570,1272,195298,35344,22245,13099,370,12729,28598,29090,15343,5
1,1,3,2,25.4,33.8,24.3,16.5,4298233,2517849,1054261,105525,7654,941082,726123,130103,33037,19353,8103,811,59,7233,5581,3054960,2150818,543104,405759,137345,361038,13594,347444,78036,65712,12324,731,11593,39148,32731,29970,4
1,1,3,2,21.4,30,25.9,22.7,4458370,2736564,928798,128883,9396,790519,793008,151183,29490,18101,6144,852,62,5229,5245,3326930,2414955,594878,441362,153516,317097,11423,305674,92864,75543,17321,364,16957,35826,31968,18026,6
1,1,3,2,20.2,29,25.4,25.5,8317058,5557879,987717,113143,10259,864315,1771462,209424,39714,26539,4716,540,49,4127,8459,7621473,5424823,1113394,767359,346035,1083256,2459,1080797,164905,137098,27807,543,27264,46217,39569,39642,36
1,1,4,3,28.5,34.3,21,16.3,3256757,2100691,776705,97402,11229,668074,379361,114102,28543,18411,6807,854,98,5855,3325,1924193,1281854,349236,271988,77248,293103,10380,282723,57421,44163,13258,905,12353,33510,29026,22887,5
1,1,3,2,23,34.6,25.6,16.9,5746750,3736646,1046756,105885,13283,927588,963348,185350,31005,20160,5647,571,72,5005,5197,4483240,3262042,839226,632191,207035,381972,101,381871,107345,89549,17796,722,17074,41765,36427,22366,9
1,1,2,2,21.3,32.2,25.9,20.6,8949859,5530463,1606889,209471,16629,1380789,1812507,252740,35411,21882,6358,829,66,5463,7171,7064474,4789274,1160115,846544,313571,1115085,5843,1109242,159122,132206,26916,469,26447,44397,36226,41942,15
1,1,1,1,16.1,26.5,29,28.3,8831839,6105419,1176272,81468,24070,1070734,1550148,223133,39581,27362,5272,365,108,4799,6947,4075962,2650578,609459,442734,166725,815925,2499,813426,106270,75079,31191,453,30738,38355,35304,26463,29
1,1,2,2,16.1,26.4,26.7,30.8,15665843,10552865,2285131,308129,28113,1948889,2827847,433474,36140,24345,5272,711,65,4496,6524,14224450,10469235,2469701,1823369,646332,1285514,2027,1283487,323659,274106,49553,385,49168,43949,38194,26104,39
1,1,1,1,20.7,30,27.8,21.5,16392196,11124408,2458685,227531,31606,2199548,2809103,426285,38454,26096,5768,534,74,5160,6590,12255388,8198822,1702802,1170307,532495,2353764,598,2353166,254839,203461,51378,44,51334,48091,40297,45840,59
1,1,1,1,25.3,23.4,25.5,25.8,11544619,6454944,1561583,205389,40746,1315448,3528092,230172,50156,28044,6784,892,177,5715,15328,11537237,8016976,1756816,1238792,518024,1763445,0,1763445,200130,169550,30580,0,30580,57649,47284,57667,17
1,1,9,10,41.2,31.2,20.5,7.1,34504,24355,6896,1527,155,5214,3253,1649,20924,14770,4182,926,94,3162,1973,17116,7368,1943,1382,561,7805,6318,1487,466,332,134,72,62,36730,22193,23984,0
1,1,9,10,32.5,33.8,23.2,10.5,184959,107760,55715,6402,456,48857,21484,8111,22803,13286,6869,789,56,6024,2649,83755,56816,15754,11537,4217,11185,2405,8780,2734,1952,782,168,614,30635,29107,14300,0
1,1,9,10,39.4,28.8,19.2,12.6,123485,59434,47161,9330,545,37286,16890,5510,22411,10787,8559,1693,99,6767,3065,59304,37070,9627,6884,2743,12607,8695,3912,1998,1612,386,81,305,29682,22996,12826,0
1,1,9,10,34.9,32.7,21.2,11.2,182496,101470,58422,6643,554,51225,22604,8894,20519,11409,6569,747,62,5760,2541,95725,65880,17893,13031,4862,11952,3023,8929,3146,2312,834,247,587,30428,28495,15211,0
1,1,8,4,41.2,32.2,18.8,7.8,176789,109518,53911,7033,582,46296,13360,8479,20850,12916,6358,829,69,5460,1576,59816,36649,9586,6833,2753,13581,24,13557,2115,1341,774,267,507,28282,27330,26740,0
1,1,9,10,32.3,33.9,20.7,13,253023,133911,88858,9128,589,79141,30254,10022,25247,13362,8866,911,59,7897,3019,100752,60388,16032,11550,4482,24332,4515,19817,3976,2387,1589,332,1257,25340,25299,15765,0
1,1,8,7,41.9,33.1,15.1,10,207367,108722,69210,11241,616,57353,29435,10306,20121,10549,6716,1091,60,5565,2856,88010,57629,14694,10182,4512,15687,3739,11948,3459,2239,1220,177,1043,25444,25739,11455,0
1,1,9,8,33.4,34.7,21,10.9,251827,157455,65940,8300,619,57021,28432,10534,23906,14947,6260,788,59,5413,2699,63690,36215,9607,6809,2798,17868,1627,16241,2665,1484,1181,480,701,23899,24404,23168,0
1,1,8,5,32.8,35.6,22.2,9.4,304940,173986,94111,11370,683,82058,36843,13586,22445,12806,6927,837,50,6040,2712,105269,73312,18148,12514,5634,13809,4496,9313,4103,2717,1386,521,865,25657,26983,10766,0
1,1,9,8,39.5,28.3,21.9,10.3,203257,114052,66051,8068,721,57262,23154,10533,19297,10828,6271,766,68,5436,2198,78321,52212,16125,12186,3939,9984,2561,7423,3075,2219,856,407,449,25470,23530,16532,0
1,1,3,2,28,38.1,26.2,7.7,285832,167625,87602,9721,756,77125,30605,12098,23626,13856,7241,804,62,6375,2530,141293,100997,22507,15450,7057,17789,4440,13349,3860,2779,1081,303,778,36604,36343,17158,0
1,1,1,1,39.5,30.2,21.3,9.1,259724,149164,66357,14673,765,50919,44203,10723,24221,13911,6188,1368,71,4749,4122,607145,500191,83550,44017,39533,23404,8289,15115,17094,16254,840,74,766,35518,30773,19732,0
1,1,8,7,29.2,38.3,23.3,9.1,386701,240324,107802,12715,785,94302,38575,16427,23541,14630,6562,774,48,5741,2348,184091,109758,30247,22005,8242,44086,28512,15574,5590,3802,1788,655,1133,32932,28868,13746,1
1,1,8,7,32.6,38,21.4,8,242056,154633,65236,7909,798,56529,22187,13135,18428,11773,4967,602,61,4304,1689,97871,62840,18982,14350,4632,16049,7389,8660,3532,2485,1047,348,699,27710,25288,12389,0
1,1,8,7,27.1,34.2,26.8,12,325063,189296,102131,10212,838,91081,33636,13053,24903,14502,7824,782,64,6978,2577,165719,113094,27251,18871,8380,25374,6673,18701,4474,3067,1407,397,1010,37040,36874,18516,0
1,1,8,7,33.6,34.9,21.2,10.4,272845,151345,90451,13601,851,75999,31049,12928,21105,11707,6997,1052,66,5879,2402,104626,67463,17413,12337,5076,19750,5205,14545,3795,2573,1222,377,845,27569,26220,17213,2
1,1,9,10,33,34,22.5,10.4,331502,181232,109503,14356,856,94291,40767,15594,21258,11622,7022,921,55,6047,2614,141722,87440,22327,15742,6585,31955,10039,21916,5233,3443,1790,648,1142,27082,25396,19191,0
1,1,7,9,31,37.6,21.8,9.6,306369,163101,98282,11722,861,85699,44986,12976,23610,12569,7574,903,66,6604,3467,146514,93094,24991,18060,6931,28429,2776,25653,4812,3186,1626,324,1302,30448,29220,19703,0
1,1,7,9,37.9,32,19.1,11,270467,152204,86538,10051,884,75603,31725,11453,23615,13289,7556,878,77,6601,2770,109655,68844,18808,13556,5252,22003,2820,19183,4054,2961,1093,308,785,27049,23250,24437,0
1,1,9,8,31.2,36.8,22.3,9.6,434655,265424,124612,12580,920,111112,44619,16976,25604,15635,7340,741,54,6545,2628,135098,89221,23834,17269,6565,22043,4125,17918,4933,3396,1537,324,1213,27387,26272,14772,0
1,1,9,8,33.3,34.5,22.4,9.8,438516,273579,115944,14691,943,100310,48993,17544,24995,15594,6609,837,54,5718,2793,204939,138700,35212,24943,10269,31027,7238,23789,6439,4775,1664,444,1220,31828,29047,19499,1
1,1,7,10,45.6,24.2,19.2,10.9,314481,174408,93082,17641,996,74445,46991,15283,20577,11412,6091,1154,65,4871,3075,128631,80999,20973,14899,6074,26659,13347,13312,4521,3371,1150,384,766,28452,24028,17379,0
1,1,7,10,41.6,30.6,16.9,10.9,256287,138570,88890,17851,1002,70037,28827,11875,21582,11669,7485,1503,84,5898,2428,145610,86668,23523,16990,6533,35419,17502,17917,4790,3392,1398,505,893,30399,25551,20064,0
1,1,7,10,35.6,34.6,19.6,10.2,332968,188735,106110,11709,1031,93370,38123,14947,22277,12627,7099,783,69,6247,2551,150773,99126,25948,18350,7598,25699,6426,19273,5681,3996,1685,576,1109,26540,24806,17379,1
1,1,8,6,32.8,31.9,23.9,11.4,472166,295581,123717,15629,1060,107028,52868,19555,24146,15115,6327,799,54,5473,2704,250390,151135,38548,27187,11361,60707,11252,49455,8019,5725,2294,514,1780,31225,26399,27784,0
1,1,7,9,35.3,34.8,20.4,9.5,498047,288849,129611,18353,1127,110131,79587,21111,23592,13682,6140,869,53,5217,3770,270288,183492,45771,32213,13558,41025,13003,28022,8234,6329,1905,457,1448,32826,28992,19352,0
1,1,3,2,25.2,30.2,32.2,12.4,407347,245293,106328,9613,1153,95562,55726,15968,25510,15362,6659,602,72,5985,3490,192774,133504,33566,23736,9830,25704,983,24721,6740,4766,1974,277,1697,28601,28012,14567,0
1,1,7,9,31.8,33.3,21,13.8,489620,274464,133445,17146,1166,115133,81711,19538,25060,14048,6830,878,60,5893,4182,261646,193354,44704,30574,14130,23588,3476,20112,8120,6155,1965,465,1500,32222,31414,13408,0
1,1,7,9,27.1,33.4,27.4,12.1,531614,311902,155780,15449,1178,139153,63932,21814,24370,14298,7141,708,54,6379,2931,270304,189623,50154,35774,14380,30527,6830,23697,9055,7098,1957,579,1378,29851,26715,17197,0
1,1,6,6,35.9,31.8,20.7,11.6,468577,277649,136848,16651,1201,118996,54080,23159,20233,11989,5909,719,52,5138,2335,246880,154058,41592,29219,12373,51230,24980,26250,8355,6304,2051,635,1416,29549,24438,18538,1
1,1,6,6,36.6,29.8,21.9,11.6,465568,269578,130253,15446,1268,113539,65737,19431,23960,13874,6703,795,65,5843,3383,248611,150396,39468,27921,11547,58747,2711,56036,7659,5830,1829,474,1355,32460,25797,41355,1
1,1,8,6,35.4,36,20,8.7,432232,234237,139915,9341,1300,129274,58080,19424,22252,12059,7203,481,67,6655,2990,241569,173527,45231,31768,13463,22811,1038,21773,7886,6432,1454,310,1144,30633,26979,19032,1
1,1,7,9,34.5,35.9,20.6,9,507178,304981,148602,14511,1345,132746,53595,21688,23385,14062,6852,669,62,6121,2471,313422,224442,56193,38455,17738,32787,-411,33198,10465,7962,2503,602,1901,29950,28189,17463,0
1,1,7,8,36.2,27.6,22.7,13.5,622511,370271,157814,19292,1355,137167,94426,22388,27806,16539,7049,862,61,6127,4218,484456,349409,84483,58443,26040,50564,3187,47377,14055,11726,2329,300,2029,34469,29798,23350,1
1,1,2,2,31.2,35.3,22.6,10.9,701134,422855,199761,20059,1384,178318,78518,27658,25350,15289,7223,725,50,6447,2839,312163,194762,49592,34736,14856,67809,22390,45419,11101,8326,2775,624,2151,28120,23392,21115,0
1,1,6,6,33.5,33.4,21.6,11.5,604157,315111,186706,23433,1429,161844,102340,26291,22980,11986,7102,891,54,6156,3893,342310,241032,57578,39332,18246,43700,8763,34937,11538,8947,2591,523,2068,29668,26940,16894,1
1,1,7,9,31.5,33.7,21.5,13.2,640811,386749,151659,13623,1472,136564,102403,26762,23945,14451,5667,509,55,5103,3826,367350,252425,59965,40572,19393,54960,3042,51918,12514,9332,3182,660,2522,29355,27049,20586,1
1,1,7,9,32.3,31.7,24.6,11.4,831243,515272,192145,21845,1513,168787,123826,29381,28292,17538,6540,744,51,5745,4214,659681,467813,110890,76253,34637,80978,20532,60446,18400,15742,2658,630,2028,35852,29718,29806,0
1,1,7,9,40.6,30.4,19.5,9.5,437468,251113,122822,14697,1584,106541,63533,18074,24204,13894,6796,813,88,5895,3515,263933,181891,45300,30175,15125,36742,5283,31459,8930,6753,2177,540,1637,29556,26935,19217,0
1,1,6,6,40.3,26.7,21.9,11.2,405567,196498,164388,32860,1586,129942,44681,19932,20348,9858,8247,1649,80,6519,2242,185121,126756,33432,23940,9492,24933,7863,17070,6720,4996,1724,462,1262,27548,25371,13526,0
1,1,7,8,33.3,33.8,21.5,11.4,707292,473439,153751,14410,1656,137685,80102,29098,24307,16270,5284,495,57,4732,2753,510878,364724,84515,54711,29804,61639,-274,61913,16083,12811,3272,772,2500,31765,28470,24765,2
1,1,1,1,28.3,32.5,26.8,12.3,724154,487682,152465,16707,1718,134040,84007,27473,26359,17751,5550,608,63,4879,3058,276754,181271,45836,32092,13744,49647,2884,46763,9687,6614,3073,544,2529,28570,27407,18491,2
1,1,3,2,30.2,38.7,21.9,9.1,537960,361673,116542,11371,1718,103453,59745,21382,25159,16915,5450,532,80,4838,2794,199935,136742,36159,25839,10320,27034,2969,24065,7417,5064,2353,515,1838,26956,27003,13093,1
1,1,2,2,30.7,30.2,27.6,11.6,699371,429441,191915,28389,1794,161732,78015,29540,23675,14538,6497,961,61,5475,2641,333025,232593,64901,47154,17747,35531,6099,29432,12077,9287,2790,565,2225,27575,25045,13228,0
1,1,6,5,35,31,22.2,11.8,643879,349429,181487,30770,1832,148885,112963,28714,22424,12169,6321,1072,64,5185,3934,305919,204042,55725,40834,14891,46152,20307,25845,9275,6923,2352,521,1831,32983,29473,14115,0
1,1,6,5,28,31.6,28,12.4,952694,599592,227719,23936,1850,201933,125383,34248,27818,17507,6649,699,54,5896,3661,581887,418601,93670,62865,30805,69616,8591,61025,17047,13513,3534,619,2915,34134,30978,20935,0
1,1,7,9,35.1,31.3,23.6,9.9,566567,334136,156556,13618,1885,141053,75875,25463,22251,13122,6148,535,74,5540,2980,305648,226850,58212,40994,17218,20586,435,20151,10021,8571,1450,495,955,30501,26467,21101,0
1,1,7,9,31.4,31.7,22.3,14.6,583847,334307,134870,19525,1896,113449,114670,21139,27619,15815,6380,924,90,5367,5425,348526,234697,54990,36680,18310,58839,18869,39970,9672,7558,2114,430,1684,36035,31053,23735,0
1,1,7,8,34.1,31.5,25.6,8.8,591371,368578,155592,10456,2004,143132,67201,23217,25471,15875,6702,450,86,6165,2894,249418,176149,43731,30391,13340,29538,3508,26030,7914,6278,1636,427,1209,31516,28058,21530,2
1,1,5,8,26.6,31.7,24.2,17.5,892210,473778,253700,32036,2012,219652,164732,33220,26858,14262,7637,964,61,6612,4959,577049,410186,91913,61062,30851,74950,2058,72892,17193,13697,3496,209,3287,33563,29947,22176,3
1,1,3,2,17,27,29.2,26.8,1380948,964493,212870,19676,2066,191128,203585,48850,28269,19744,4358,403,42,3913,4168,726448,472576,111989,76766,35223,141883,10795,131088,25628,18187,7441,443,6998,28346,25984,18732,0
1,1,6,3,21.5,22.7,24.7,31.1,1317820,806006,204747,15781,2107,186859,307067,44281,29760,18202,4624,356,48,4220,6935,920321,641399,169796,123279,46517,109126,2180,106946,26690,21194,5496,431,5065,34482,30263,21115,6
1,1,5,8,37.8,21.5,24.5,16.2,697993,345792,231080,41131,2161,187788,121121,27441,25436,12601,8421,1499,79,6843,4414,417486,295078,68528,46630,21898,53880,29208,24672,12143,10309,1834,194,1640,34381,28623,15044,0
1,1,5,8,40.7,25.6,21.7,12,659379,361837,195422,39317,2178,153927,102120,31464,20957,11500,6211,1250,69,4892,3246,416708,284796,77701,56028,21673,54211,25828,28383,13504,11835,1669,276,1393,30858,24064,20375,1
1,1,7,8,29.7,32,25.7,12.5,976530,552929,287309,39325,2262,245722,136292,40241,24267,13740,7140,977,56,6106,3387,661533,469341,118417,83195,35222,73775,-1340,75115,21983,17323,4660,508,4152,30093,27094,18091,1
1,1,5,8,20,21.7,23.4,34.8,1152367,710149,193787,25773,2359,165655,248431,45052,25579,15763,4301,572,52,3677,5514,824679,590126,164727,121322,43405,69826,942,68884,25745,21886,3859,393,3466,32033,26964,19874,17
1,1,6,4,36.5,29.5,23.1,10.8,812158,491769,213904,32733,2430,178741,106485,34705,23402,14170,6163,943,70,5150,3068,510293,340885,88272,62589,25683,81136,10964,70172,15509,12195,3314,634,2680,32903,27953,26184,0
1,1,7,8,31.9,34.8,21.5,11.7,864466,482977,257856,21963,2441,233452,123633,36183,23891,13348,7126,607,67,6452,3417,573608,421168,100034,67994,32040,52406,-2531,54937,17197,14330,2867,467,2400,33355,29391,22890,0
1,1,1,1,39,32.5,19.4,9,853395,575761,199410,31360,2488,165562,78224,36374,23462,15829,5482,862,68,4552,2151,303425,195559,48780,33808,14972,59086,190,58896,11387,7256,4131,510,3621,26647,26951,16265,2
1,1,5,8,38.1,25.7,20.4,15.9,875586,450179,248161,42729,2597,202835,177246,33862,25857,13295,7329,1262,77,5990,5234,703117,495457,129616,92723,36893,78044,20907,57137,19935,17604,2331,226,2105,35270,28145,27143,2
1,1,5,8,34.7,24.3,22.1,18.8,912847,527772,257569,49267,2769,205533,127506,36102,25285,14619,7134,1365,77,5693,3532,558361,392693,100198,71239,28959,65470,33507,31963,16834,14262,2572,338,2234,33169,27534,14308,1
1,1,6,3,25.4,31.2,29.5,13.9,1459914,914509,345589,32731,2880,309978,199816,55153,26470,16581,6266,593,52,5620,3623,532582,320284,83292,59440,23852,129006,1340,127666,18458,11680,6778,750,6028,28854,27422,21179,5
1,1,4,5,23,26.5,29.7,20.8,1560078,990822,292743,40164,3012,249567,276513,49440,31555,20041,5921,812,61,5048,5593,1199388,893499,226045,157491,68554,79844,14401,65443,30185,25652,4533,226,4307,39735,34832,15195,4
1,1,7,9,34.5,32.4,22.2,10.9,939619,570290,240429,25049,3068,212312,128900,37454,25087,15226,6419,669,82,5669,3442,534055,370745,95987,67078,28909,67323,6733,60590,15020,11772,3248,620,2628,35556,31494,23056,2
1,1,4,5,26.1,32.2,27.6,14,1905978,1106754,491680,43051,3105,445524,307544,66330,28735,16686,7413,649,47,6717,4637,1443524,1049744,273631,197460,76171,120149,9132,111017,39275,33341,5934,903,5031,36754,31485,22067,1
1,1,3,2,22.1,29.3,31.3,17.3,1176190,680300,268502,17155,3734,247613,227388,40087,29341,16971,6698,428,93,6177,5672,828644,591815,147050,101845,45205,89779,1378,88401,17867,13418,4449,244,4205,46378,44106,21023,0
1,1,5,8,24.5,29.8,25.2,20.5,1702357,1056555,329448,44691,3753,281004,316354,59396,28661,17788,5547,752,63,4731,5326,1304938,973341,240965,165529,75436,90632,7201,83431,34852,29606,5246,413,4833,37442,32876,17263,2
1,1,3,2,20.7,27.9,28.6,22.8,2098878,1260657,445279,49124,4070,392085,392942,73219,28666,17218,6081,671,56,5355,5367,1916904,1360036,337456,238127,99329,219412,6702,212710,48298,42133,6165,345,5820,39689,32280,36548,3
1,1,5,8,25.1,28.1,30.6,16.2,2266911,1353909,512664,59668,4608,448388,400338,78063,29040,17344,6567,764,59,5744,5128,1779953,1299711,325571,224526,101045,154671,1229,153442,47188,41310,5878,364,5514,37720,31462,27828,3
1,1,5,8,33.5,28.7,21.4,16.4,1365770,763027,387031,81411,4673,300947,215712,54325,25141,14046,7124,1499,86,5540,3971,878688,627936,156172,108771,47401,94580,26407,68173,25762,21915,3847,258,3589,34108,28653,18995,15
1,1,2,2,18.2,27.4,30.6,23.8,4599124,3214765,649726,48696,6216,594814,734633,134132,34288,23967,4844,363,46,4435,5477,2893281,2072856,452398,301044,151354,368027,10762,357265,77073,61382,15691,676,15015,37539,33770,23794,6
1,1,5,8,25.3,28.2,28.4,18.1,2396035,1582240,434014,46082,6394,381538,379781,79684,30069,19856,5447,578,80,4788,4766,2384170,1795313,400316,266514,133802,188541,-1384,189925,62491,54339,8152,511,7641,38152,33039,24856,5
1,1,1,1,18.4,34.1,33.2,14.3,4453390,3442227,537381,49603,6415,481363,473782,145220,30667,23704,3700,342,44,3315,3263,2107069,1435043,316046,207514,108532,355980,-560,356540,63577,47956,15621,444,15177,33142,29924,23492,5
1,1,3,2,19,32.1,32.4,16.5,3874896,2548431,763047,64316,9776,688955,563418,132717,29197,19202,5749,485,74,5191,4245,2789310,2013224,566631,410456,156175,209455,-508,209963,64323,53303,11020,415,10605,43364,37769,19798,4
1,1,2,2,19.6,21.9,31.3,27.2,8070305,4900349,1401986,221141,15167,1165678,1767970,248989,32412,19681,5631,888,61,4682,7101,7546820,5440690,1268473,874510,393963,837657,3828,833829,172675,145538,27137,914,26223,43705,37383,31798,4
1,1,3,2,19.7,28.4,33.5,18.4,5431563,3260669,1088878,97435,17817,973626,1082016,174449,31136,18691,6242,559,102,5581,6202,4593931,3398285,871913,606766,265147,323733,-1059,324792,112813,95438,17375,322,17053,40722,35607,19046,6
2,1,3,2,35.2,34.9,19.4,10.5,245600,123605,75465,14920,580,59965,46530,9385,26169,13170,8041,1590,62,6389,4958,111387,72987,22152,16842,5310,16248,10468,5780,3486,2489,997,277,720,31953,29324,8028,0
2,1,8,6,37.6,30.4,22,10,254839,121787,99626,21117,851,77658,33426,10774,23653,11304,9247,1960,79,7208,3102,116781,69979,19367,14021,5346,27435,9231,18204,3960,2804,1156,332,824,29490,24957,22092,0
2,1,9,10,35,34.7,20.6,9.6,339738,175138,114672,14360,877,99435,49928,14216,23898,12320,8066,1010,62,6995,3512,239120,180565,40089,27955,12134,18466,2837,15629,5635,4375,1260,241,1019,42435,41272,15338,0
2,1,8,6,35.2,31.1,21.2,12.4,325191,174440,109754,21839,882,87033,40997,13926,23351,12526,7881,1568,63,6250,2944,173715,122639,32938,23959,8979,18138,12743,5395,5931,4252,1679,374,1305,29289,28843,4134,0
2,1,8,7,40.5,30.3,19.2,10.1,273650,127774,107146,24828,931,81387,38730,12208,22416,10466,8777,2034,76,6667,3173,179882,119982,30047,21576,8471,29853,9173,20680,5128,3469,1659,327,1332,35078,34587,15526,0
2,1,1,1,36.8,35.7,20.4,7.1,540644,346947,136071,15750,997,119324,57626,22438,24095,15462,6064,702,44,5318,2568,204190,145323,37815,27119,10696,21052,2656,18396,6565,4788,1777,186,1591,31103,30352,11563,0
2,1,9,10,34.9,37.5,19.8,7.8,363961,192671,118845,10786,1023,107036,52445,14901,24425,12930,7976,724,69,7183,3520,171226,124114,31733,22516,9217,15379,5313,10066,5928,4132,1796,379,1417,28884,30037,7104,0
2,1,3,2,34.8,35.9,21.2,8.1,432974,257380,118308,20570,1050,96688,57286,16418,26372,15677,7206,1253,64,5889,3489,169054,110537,29435,20986,8449,29082,16677,12405,5461,3849,1612,410,1202,30957,28718,10320,0
2,1,8,6,30.3,37.8,22.1,9.8,541130,307676,153190,19970,1129,132091,80264,19989,27071,15392,7664,999,56,6608,4015,195054,118943,31947,23046,8901,44164,15966,28198,6262,4402,1860,436,1424,31149,27020,19802,1
2,1,7,11,28.1,37.4,22.5,12.1,620527,346770,170239,25322,1214,143703,103518,21475,28895,16148,7927,1179,57,6692,4820,362260,249633,63531,45459,18072,49096,12946,36150,10604,8247,2357,482,1875,34163,30270,19280,1
2,1,6,4,37.4,34.3,20.1,8.3,654391,377153,184084,16596,1604,165884,93154,24858,26325,15172,7405,668,65,6673,3747,391930,258653,66896,46612,20284,66381,4865,61516,12997,9482,3515,568,2947,30155,27278,20874,0
2,1,7,11,32.1,34.4,21.7,11.8,603329,356661,164794,22937,1613,140244,81874,23437,25743,15218,7031,979,69,5984,3493,420338,320721,75800,52728,23072,23817,1345,22472,11709,9193,2516,447,2069,35899,34888,10861,0
2,1,7,11,29.2,37.7,21.1,12.1,700247,390064,191580,28028,1777,161775,118603,26436,26488,14755,7247,1060,67,6119,4486,435251,310135,78079,55545,22534,47037,7653,39384,13784,10314,3470,292,3178,31577,30069,12393,0
2,1,8,4,36.8,32.9,22.3,8,767539,437551,213396,20014,1886,191496,116592,30849,24881,14184,6917,649,61,6208,3779,498208,346880,89117,62750,26367,62211,15092,47119,15040,12092,2948,704,2244,33126,28687,20998,0
2,1,6,3,29.6,32,26.5,11.9,2337093,1447764,527686,43472,3747,480467,361643,79576,29369,18193,6631,546,47,6038,4545,1324352,933017,222198,153632,68566,169137,24917,144220,41335,30257,11078,2223,8855,32039,30836,16287,4
2,1,3,2,26.7,33.9,25.3,14.1,1613941,952245,409513,34956,5448,369109,252183,54486,29621,17477,7516,642,100,6774,4628,1198598,858684,215223,150729,64494,124691,3851,120840,29626,23915,5711,654,5057,40458,35906,23896,1
2,1,3,2,23.6,34.1,23.8,18.5,2711149,1574248,585068,48926,6302,529840,551833,91107,29758,17279,6422,537,69,5816,6057,1394920,968293,236098,164596,71502,190529,21859,168670,45370,35230,10140,1530,8610,30745,27485,19590,3
2,1,4,5,18,29.6,29.3,23.1,6215336,3705193,1007781,67102,7092,933587,1502362,172404,36051,21491,5845,389,41,5415,8714,3010367,2067299,457381,305848,151533,485687,-1564,487251,92728,68195,24533,979,23554,32464,30315,20687,4
2,1,3,2,21.2,28.4,26.4,24,5872807,3633728,1075531,115614,8270,951647,1163548,184350,31857,19711,5834,627,45,5162,6312,4593025,3453207,840648,598427,242221,299170,2068,297102,111926,95404,16522,527,15995,41036,36196,18575,6
2,1,2,2,23.3,31.9,26.2,18.6,12412795,7908941,2487909,352631,20752,2114526,2015945,405715,30595,19494,6132,869,51,5212,4969,9636444,7049753,1575274,1065938,509336,1011417,7532,1003885,233054,192134,40920,744,40176,41349,36692,24987,20
2,1,1,1,19.1,27.9,28.4,24.6,27104506,16965308,4011931,473293,35972,3502666,6127267,655163,41371,25895,6124,722,55,5346,9352,23853603,17636879,3710434,2474332,1236102,2506290,-5400,2511690,470022,397966,72056,420,71636,50750,44318,35062,38
2,1,6,7,31.7,36.4,19.5,12.4,334648,163680,65637,6736,299,58602,105331,11491,29123,14244,5712,586,26,5100,9166,163039,110130,29702,22090,7612,23207,0,23207,5547,3710,1837,0,1837,29392,29685,12633,0
2,1,6,6,27.4,37.1,25.3,10.1,385979,206689,92058,7716,757,83585,87232,15908,24263,12993,5787,485,48,5254,5484,200104,141862,42104,32207,9897,16138,0,16138,5981,4366,1615,0,1615,33457,32492,9993,0
2,1,6,6,24,32.3,27.4,16.2,1884091,1064544,281499,22673,2292,256534,538048,52355,35987,20333,5377,433,44,4900,10277,998656,712975,159591,109262,50329,126090,162,125928,30791,21964,8827,686,8141,32433,32461,15468,16
2,1,4,3,15.1,28.9,30.5,25.5,4975396,1939468,366482,25864,2723,337895,2669446,72906,68244,26602,5027,355,37,4635,36615,2170394,1569486,348463,237817,110646,252445,0,252445,54978,39815,15163,0,15163,39478,39419,16649,8
2,1,2,2,14.6,29.2,33.4,22.9,5121604,3294570,753037,59835,6077,687125,1073997,146158,35042,22541,5152,409,42,4701,7348,1860972,1278853,321146,227013,94133,260973,3857,257116,53410,36831,16579,535,16044,34843,34722,16026,17
2,1,3,2,12,27.1,36.6,24.2,7452475,4289091,1001058,72218,7718,921122,2162326,182677,40796,23479,5480,395,42,5042,11837,5598355,4120123,1117058,802771,314287,361174,2472,358702,124825,103242,21583,513,21070,44850,39907,17024,13
2,1,3,2,19,30.6,32.7,17.7,5897951,3528582,1017523,89567,9858,918098,1351846,165345,35671,21341,6154,542,60,5553,8176,4086851,2982734,742797,525898,216899,361320,65,361255,100794,82430,18364,120,18244,40547,36185,19801,25
2,1,2,2,17.9,28.3,32.7,21,9837771,5785186,1859415,198437,13418,1647560,2193170,297393,33080,19453,6252,667,45,5540,7375,7595115,5670146,1435818,1019681,416137,489151,2625,486526,178616,150890,27726,658,27068,42522,37578,17974,23
2,1,2,2,18.2,26.2,27.6,27.9,21773560,7672580,1859674,101413,22201,1736060,12241306,314437,69246,24401,5914,323,71,5521,38931,8441754,6041422,1160560,752385,408175,1239772,71566,1168206,186380,140777,45603,241,45362,45293,42915,25753,53
2,1,1,1,18,28.4,29.1,24.5,72265438,45280614,9326007,844669,112154,8369184,17658817,1720825,41995,26313,5419,491,65,4863,10262,47144601,35648256,7416247,4939320,2476927,4080098,4065,4076033,1041048,820173,220875,370,220505,45286,43464,18485,305
2,1,1,1,32.1,22.3,23.9,21.7,92496742,55196769,15438276,2111539,146673,13180064,21861697,2415576,38292,22850,6391,874,61,5456,9050,69068454,50541089,10743364,7273816,3469548,7784001,58447,7725554,1454014,1113103,340911,1848,339063,47502,45406,22785,167
2,1,9,10,36.8,31.5,16.9,14.8,158778,82892,44141,7429,365,36347,31745,5513,28801,15036,8007,1348,66,6593,5758,88306,47314,13942,10968,2974,27050,22174,4876,2437,1823,614,196,418,36236,25954,11665,0
2,1,8,7,34.6,38.6,18,8.8,280375,169338,83664,7890,482,75292,27373,10189,27517,16620,8211,774,47,7390,2687,112031,76433,22491,17822,4669,13107,2843,10264,3999,2897,1102,255,847,28015,26384,12118,0
2,1,6,7,32.6,41.8,16.9,8.7,210372,116245,68857,9219,496,59142,25270,9245,22755,12574,7448,997,54,6397,2733,109203,75209,19705,14786,4919,14289,6301,7988,3370,2525,845,206,639,32404,29786,12501,0
2,1,6,6,31.5,38.5,18.8,11.2,365776,222872,100074,7447,518,92109,42830,14570,25105,15297,6868,511,36,6322,2940,185741,128678,35157,27714,7443,21906,4342,17564,5585,4304,1281,147,1134,33257,29897,15489,0
2,1,9,10,38.6,36.7,15.3,9.4,265106,157790,79009,10146,536,68327,28307,10481,25294,15055,7538,968,51,6519,2701,144463,66985,19830,15641,4189,57648,30300,27348,4133,2799,1334,414,920,34954,23932,29726,0
2,1,2,2,46.7,24,18.7,10.6,400437,260012,64787,6395,581,57811,75638,15655,25579,16609,4138,408,37,3693,4832,335359,247846,73313,61605,11708,14200,729,13471,6865,5592,1273,143,1130,48851,44322,11921,0
2,1,6,5,26.4,39.7,21,12.9,417707,246917,119156,11168,633,107355,51634,15922,26235,15508,7484,701,40,6743,3243,193201,131863,34665,27002,7663,26673,4025,22648,5278,3973,1305,175,1130,36605,33190,20042,0
2,1,7,9,42.1,31.2,14.3,12.3,195773,101027,67181,13255,651,53275,27565,8102,24164,12469,8292,1636,80,6576,3402,110598,64215,19352,15587,3765,27031,23121,3910,3072,2432,640,192,448,36002,26404,8728,0
2,1,7,8,36.6,33.7,18.7,11,291740,167639,94250,17949,664,75637,29851,12410,23508,13508,7595,1446,54,6095,2405,166751,98518,30162,24340,5822,38071,27357,10714,4852,3721,1131,259,872,34367,26476,12287,2
2,1,6,6,34.6,40,16,9.4,378687,221587,114563,11974,700,101889,42537,15588,24293,14215,7349,768,45,6536,2729,242646,164405,41670,31037,10633,36571,2258,34313,6807,5549,1258,130,1128,35647,29628,30419,0
2,1,1,1,31.3,34.2,23.7,10.8,954539,622359,127615,13313,782,113520,204565,22709,42034,27406,5620,586,34,4999,9008,1090262,817009,190616,138951,51665,82637,2608,80029,18725,15916,2809,135,2674,58225,51333,29929,0
2,1,6,6,28.1,41.3,19.1,11.5,18494,192718,116098,13501,806,101791,49413,14699,24371,13111,7898,918,55,6925,3362,192471,137341,36127,27286,8841,19003,2784,16219,5624,4318,1306,158,1148,34223,31807,14128,0
2,1,7,9,34.3,35.2,18.1,12.4,437570,248873,117548,14937,816,101795,71149,17149,25516,14512,6855,871,48,5936,4149,233966,151126,41249,32679,8570,41591,18907,22684,5976,4652,1324,195,1129,39151,32486,20092,0
2,1,3,2,26.9,41.6,21.7,9.8,516645,335065,125022,14681,890,109451,56558,21268,24292,15754,5878,690,42,5146,2659,164081,106387,34155,27477,6678,23539,2009,21530,5061,3493,1568,219,1349,32421,30457,15960,1
2,1,9,10,40.5,34.8,15.2,9.5,272431,146802,97954,9944,937,87073,27675,11708,23269,12539,8366,849,80,7437,2364,124429,74551,21716,17239,4477,28162,18407,9755,4547,2795,1752,890,862,27365,26673,11317,1
2,1,6,6,29.2,40.9,18.8,11.1,583383,333444,171222,16367,943,153912,78717,24090,24217,13842,7108,679,39,6389,3268,268282,168095,46401,35941,10460,53786,12637,41149,8358,6086,2272,312,1960,32099,27620,20994,0
2,1,1,1,26.9,37.9,26.2,8.9,1258983,617309,133125,16617,983,115525,508549,23613,53317,26143,5638,704,42,4892,21537,576813,436375,111510,84306,27204,28928,1835,27093,12327,9710,2617,29,2588,46793,44941,10469,2
2,1,2,2,26.6,40.6,21.7,11.1,785176,568659,130543,17228,984,112331,85974,23184,33867,24528,5631,743,42,4845,3708,630981,466076,109770,78925,30845,55135,1761,53374,14163,11829,2334,104,2230,44551,39401,23935,0
2,1,2,2,30.9,39.1,17.3,12.8,735150,464352,148720,19364,1011,128345,122078,22848,32176,20324,6509,848,44,5617,5343,308151,203366,55512,42007,13505,49273,17600,31673,8890,6383,2507,369,2138,34663,31861,14814,0
2,1,7,8,35.4,34.5,20.6,9.6,530971,310117,148707,22232,1025,125450,72147,20244,26229,15319,7346,1098,51,6197,3564,280747,173369,47148,36772,10376,60230,16714,43516,8089,6064,2025,388,1637,34707,28590,26583,0
2,1,6,5,40.6,36.9,15.1,7.4,690517,464541,145274,19373,1055,124846,80702,23543,29330,19732,6171,823,45,5303,3428,288160,206287,49501,36205,13296,32372,1252,31120,7369,5462,1907,68,1839,39104,37768,16922,0
2,1,6,5,30.6,41.2,18.3,9.9,910058,548401,208651,20253,1110,187288,153006,31379,29002,17477,6649,645,35,5969,4876,405504,277726,70939,53182,17757,56839,13120,43719,12336,9484,2852,581,2271,32872,29284,19251,0
2,1,6,6,36.8,38,16,9.3,600300,370527,148021,16498,1114,130409,81752,25937,23145,14286,5707,636,43,5028,3152,385755,276899,79118,63824,15294,29738,1611,28127,11239,9339,1900,334,1566,34323,29650,17961,0
2,1,3,2,28.3,40.1,19.8,11.8,618664,380247,165298,16953,1148,147197,73119,22770,27170,16699,7259,745,50,6465,3211,229454,148852,42012,32395,9617,38590,17584,21006,8229,5642,2587,367,2220,27884,26383,9462,0
2,1,7,11,38.6,36.5,15.1,9.8,516322,292211,169015,21644,1169,146202,55096,20740,24895,14089,8149,1044,56,7049,2657,263445,148251,43204,34052,9152,71990,44189,27801,8716,5987,2729,1046,1683,30225,24762,16519,0
2,1,6,6,38.1,32.1,16.9,12.8,597498,364304,169746,21058,1205,147483,63448,20670,28907,17625,8212,1019,58,7135,3070,308974,172500,47273,36109,11164,89201,32295,56906,8979,6457,2522,689,1833,34411,26715,31045,0
2,1,6,4,26.1,45.2,18.7,10.1,719147,502692,133870,17851,1304,114715,82585,22164,32447,22681,6040,805,59,5176,3726,493579,358197,102971,81420,21551,32411,754,31657,9223,7454,1769,35,1734,53516,48054,18257,0
2,1,6,6,44.5,30.6,15.4,9.5,933871,550602,272222,36019,1366,234837,111047,34873,26779,15789,7806,1033,39,6734,3184,374566,246950,68838,53560,15278,58778,11625,47153,11642,8758,2884,676,2208,32174,28197,21356,0
2,1,2,2,29.7,40.6,19.4,10.2,729542,461660,178584,24120,1487,152977,89298,26413,27621,17479,6761,913,56,5792,3381,337265,246865,61646,46660,14986,28754,3645,25109,9423,6908,2515,527,1988,35792,35736,12630,0
2,1,2,2,34.3,38.9,17.2,9.6,958683,624188,212150,31405,1610,179135,122345,33603,28530,18575,6313,935,48,5331,3641,958107,745001,184968,140180,44788,28138,2643,25495,17699,15147,2552,136,2416,54133,49185,10553,0
2,1,6,6,40.2,37,14.5,8.3,1105123,639112,321571,41894,1822,277855,144440,41809,26433,15286,7691,1002,44,6646,3455,480537,304023,87294,70185,17109,89220,23841,65379,16001,12001,4000,770,3230,30032,25333,20241,1
2,1,6,5,27.3,32.1,22.2,18.4,1127502,726289,258501,38159,1973,218369,142712,39114,28826,18569,6609,976,50,5583,3649,735325,442161,124131,98703,25428,169033,16617,152416,19152,15251,3901,476,3425,38394,28992,44501,0
2,1,4,5,34.4,38,16.9,10.7,1765274,1125005,328040,34457,2029,291554,312229,56835,31060,19794,5772,606,36,5130,5494,777957,537445,126980,94167,32813,113532,16532,97000,21336,15027,6309,988,5321,36462,35765,18230,1
2,1,4,5,19.6,24.7,23.9,31.8,1332522,802968,258270,29288,2047,226935,271284,45323,29401,17717,5698,646,45,5007,5986,972093,612674,159867,124047,35820,199552,12037,187515,24670,19904,4766,267,4499,39404,30781,41679,1
2,1,6,3,31.8,40.2,17.1,10.9,1232489,667290,389164,47025,2065,340074,176035,46376,26576,14389,8391,1014,45,7333,3796,523830,366508,102356,81889,20467,54966,3300,51666,17048,11984,5064,770,4294,30727,30583,12032,1
2,1,6,5,33.4,38.8,18.1,9.7,783690,452114,246407,36028,2090,208289,85169,28478,27519,15876,8653,1265,73,7314,2991,378156,242941,62044,46538,15506,73171,43337,29834,10699,8074,2625,374,2251,35345,30089,13254,0
2,1,4,5,35.3,38,17.2,9.4,1686218,1093318,372474,45313,2164,324997,220426,60762,27751,17993,6130,746,36,5349,3628,772736,534755,131081,97605,33476,106900,21612,85288,22992,17051,5941,731,5210,33609,31362,16370,1
2,1,4,5,34.1,38.3,18.2,9.4,1809241,1113803,351372,48035,2176,301161,344066,54104,33440,20586,6494,888,40,5566,6359,1652082,1259759,270581,192296,78285,121742,1426,120316,34305,29224,5081,97,4984,48159,43107,24140,2
2,1,1,1,20,36.1,26.4,17.5,1993601,1452842,252378,29799,2199,220380,288381,52765,37783,27534,4783,565,42,4177,5465,1775931,1327453,331640,251801,79839,116838,-328,117166,31414,25713,5701,47,5654,56533,51626,20723,2
2,1,6,5,29.2,35.9,22.3,12.6,1216253,716965,326585,32601,2284,291700,172703,41275,29467,17370,7912,790,55,7067,4184,649462,476364,114905,84020,30885,58193,45,58148,18620,14319,4301,375,3926,34880,33268,14811,3
2,1,1,1,23.1,38.9,25,12.9,1497487,1065356,254683,42024,2454,210205,177448,47386,31602,22483,5375,887,52,4436,3745,940656,663910,167161,125045,42116,109585,379,109206,21061,15884,5177,20,5157,44663,41797,21176,0
2,1,4,5,19.9,36.4,30.2,13.5,1541887,1014376,253291,27586,2589,223116,274220,49796,30964,20371,5087,554,52,4481,5507,1315380,945423,319166,244537,74629,50791,1009,49782,27231,24074,3157,425,2732,48305,39272,18222,0
2,1,4,5,33.1,38.5,17.2,11.2,2410459,1555393,450557,63231,2789,384537,404509,73482,32803,21167,6132,860,38,5233,5505,1981351,1504818,305372,209190,96182,171161,1085,170076,43642,36308,7334,265,7069,45400,41446,24059,7
2,1,3,2,33.7,38,16,12.4,3641099,2469444,519983,56138,3101,460744,651672,94745,38431,26064,5488,593,33,4863,6878,2542598,1705981,384379,281136,103243,452238,3513,448725,49311,39366,9945,347,9598,51562,43336,46752,5
2,1,3,2,32.9,35.8,19,12.3,4092446,2881728,623989,73964,3593,546432,586729,110656,36983,26042,5639,668,32,4938,5302,3391412,2497915,498047,338379,159668,395450,1392,394058,71493,60388,11105,130,10975,47437,41364,35905,16
2,1,4,5,38,33.3,18,10.7,2535040,1540725,679367,91452,3823,584092,314948,84710,29926,18188,8020,1080,45,6895,3718,1232086,848607,219596,167455,52141,163883,16897,146986,35695,27055,8640,1160,7480,34517,31366,19651,0
2,1,2,2,20.4,41.7,23.4,14.5,3589091,2728432,434485,47436,4240,382809,426174,100132,35844,27248,4339,474,42,3823,4256,2027003,1514185,349449,252662,96787,163369,35,163334,48050,37295,10755,234,10521,42185,40600,15525,6
2,1,6,5,25,39.5,21.7,13.8,28047,728441,226,5745,4597,100806,63182,34623,31125,21039,5575,528,46,5001,4511,433341,313745,77807,58295,19512,41789,-547,42336,13038,9309,3729,761,2968,33237,33703,14264,0
2,1,2,2,22.8,43.2,22.6,11.4,3708280,2751016,569218,60116,4746,504356,388046,119528,31024,23016,4762,503,40,4220,3246,1115792,734203,185250,138566,46684,196339,-1817,198156,37325,23609,13716,416,13300,29894,31098,14899,3
2,1,2,2,17,32.5,32.4,18.1,3698460,2434470,614096,61942,4901,547253,649894,112048,33008,21727,5481,553,44,4884,5800,2359382,1711626,450310,332380,117930,197446,2624,194822,62142,50713,11429,405,11024,37968,33751,17673,4
2,1,4,3,28.5,34.3,21,16.3,3533237,2207894,819177,105578,5322,708277,506166,116792,30252,18904,7014,904,46,6064,4334,2007622,1373849,369642,287729,81913,264131,9028,255103,59683,45875,13808,1018,12790,33638,29948,19946,3
2,1,3,2,25.4,33.8,24.3,16.5,4443753,2582102,1101572,108878,5689,987005,760079,130238,34120,19826,8458,836,44,7578,5836,3161886,2286080,568482,423428,145054,307324,14951,292373,79354,66776,12578,794,11784,39845,34235,24811,6
2,1,3,2,20.2,29,25.4,25.5,8657732,5794833,1046632,115524,7191,923917,1816267,211826,40872,27357,4941,545,34,4362,8574,8119449,5982938,1172760,795094,377666,963751,1468,962283,170268,141865,28403,596,27807,47686,42173,34606,38
2,1,3,2,21.4,30,25.9,22.7,4595101,2814150,980590,135897,8187,836506,800361,151157,30400,18617,6487,899,54,5534,5295,3449510,2512671,604790,448426,156364,332049,5542,326507,93839,75298,18541,399,18142,36760,33370,17997,5
2,1,1,1,16.1,26.5,29,28.3,10188713,6448333,1215548,90108,8202,1117238,2524832,226294,45024,28495,5372,398,36,4937,11157,4357552,2944049,673431,488436,184995,740072,157,739915,114856,81570,33286,498,32788,37939,36092,22567,27
2,1,3,2,23,34.6,25.6,16.9,6327311,3928813,1090371,114411,8259,967701,1308127,187081,33821,21001,5828,612,44,5173,6992,4706934,3472500,849549,631277,218272,384885,-1111,385996,109153,91597,17556,815,16741,43122,37911,23057,4
2,1,1,1,25.3,23.4,25.5,25.8,13538730,6736188,1574831,250580,12432,1311819,5227711,268751,50376,25065,5860,932,46,4881,19452,12141184,8819707,1918171,1360975,557196,1403306,0,1403306,218811,184601,34210,0,34210,55487,47777,41020,11
2,1,2,2,21.3,32.2,25.9,20.6,8925064,5494395,1687757,221679,13750,1452328,1742912,251760,35451,21824,6704,881,55,5769,6923,7108775,4991335,1186111,862389,323722,931329,6981,924348,161725,132626,29099,525,28574,43956,37635,32349,2
2,1,1,1,20.7,30,27.8,21.5,18722605,11605830,2524430,248330,17601,2258499,4592345,432683,43271,26823,5834,574,41,5220,10614,12859101,8756020,1801473,1238877,562596,2301608,243,2301365,265423,211695,53728,50,53678,48448,41361,42874,43
2,1,2,2,16.1,26.4,26.7,30.8,16588810,11071466,2329135,325739,19337,1984059,3188209,433344,38281,25549,5375,752,45,4578,7357,15089551,11243302,2563126,1876143,686983,1283123,355,1282768,328219,276995,51224,429,50795,45974,40590,25254,57
2,1,9,10,41.2,31.2,20.5,7.1,44652,34323,6933,1495,112,5326,3396,1552,28771,22115,4467,963,72,3432,2188,26882,8021,2152,1481,671,16709,15452,1257,474,343,131,70,61,56713,23385,20607,0
2,1,9,10,32.5,33.8,23.2,10.5,193143,109030,59994,6414,438,53142,24119,8165,23655,13353,7348,786,54,6509,2954,82379,56989,15856,11686,4170,9534,1905,7629,2759,1924,835,164,671,29858,29620,11370,0
2,1,9,10,39.4,28.8,19.2,12.6,138550,74118,46826,9306,457,37063,17606,5238,26451,14150,8940,1777,87,7076,3361,75217,39040,10178,7115,3063,25999,22633,3366,1988,1598,390,78,312,37836,24431,10788,0
2,1,9,10,34.9,32.7,21.2,11.2,189066,102924,60684,6954,531,53199,25458,8680,21782,11858,6991,801,61,6129,2933,97977,67843,18859,13835,5024,11275,3002,8273,3201,2319,882,248,634,30608,29255,13049,1
2,1,9,10,32.3,33.9,20.7,13,266562,138217,93515,9153,554,83808,34830,10035,26563,13773,9319,912,55,8352,3471,100871,62448,16536,11908,4628,21887,4005,17882,4161,2434,1727,337,1390,24242,25657,12865,0
2,1,8,4,41.2,32.2,18.8,7.8,182450,111436,55902,7390,564,47948,15112,8603,21208,12953,6498,859,66,5573,1757,56553,35375,9574,6931,2643,11604,688,10916,2107,1294,813,268,545,26841,27338,20029,1
2,1,8,7,41.9,33.1,15.1,10,214292,110923,72363,11786,627,59950,31006,10142,21129,10937,7135,1162,62,5911,3057,88776,61581,15281,10614,4667,11914,1479,10435,3424,2264,1160,158,1002,25928,27200,10414,0
2,1,9,8,39.5,28.3,21.9,10.3,202057,108636,67250,8259,636,58355,26171,10486,19269,10360,6413,788,61,5565,2496,79366,55379,16697,12542,4155,7290,1066,6224,3112,2221,891,401,490,25503,24934,12702,0
2,1,8,5,32.8,35.6,22.2,9.4,318004,178672,98897,11523,657,86717,40435,13400,23732,13334,7380,860,49,6471,3018,110685,77023,19241,13515,5726,14421,4904,9517,4141,2752,1389,514,875,26729,27988,10877,0
2,1,9,8,33.4,34.7,21,10.9,268808,165799,71295,8172,663,62460,31714,10630,25288,15597,6707,769,62,5876,2983,66410,37577,9925,7021,2904,18908,3687,15221,2780,1507,1273,477,796,23888,24935,19122,0
2,1,1,1,39.5,30.2,21.3,9.1,284157,169810,68487,15467,695,52325,45860,10853,26182,15646,6310,1425,64,4821,4226,607578,495918,86197,46524,39673,25463,20439,5024,16879,15923,956,70,886,35996,31145,5670,2
2,1,3,2,28,38.1,26.2,7.7,300453,173956,92829,10828,715,81286,33668,12316,24395,14124,7537,879,58,6600,2734,141781,102415,23093,16101,6992,16273,3437,12836,3876,2780,1096,307,789,36579,36840,16269,0
2,1,8,7,29.2,38.3,23.3,9.1,399296,245887,108282,12881,721,94680,45127,16462,24256,14937,6578,782,44,5751,2741,183036,107474,30220,22165,8055,45342,29877,15465,5516,3676,1840,659,1181,33183,29237,13095,1
2,1,8,7,33.6,34.9,21.2,10.4,284900,155594,93743,13913,750,79080,35563,12749,22347,12204,7353,1091,59,6203,2789,105331,71715,17786,12458,5328,15830,3702,12128,3835,2564,1271,374,897,27466,27970,13521,0
2,1,8,7,32.6,38,21.4,8,256661,161809,71259,7259,764,63236,23593,13776,18631,11746,5173,527,55,4590,1713,102602,66715,19576,14749,4827,16311,7093,9218,3497,2417,1080,349,731,29340,27602,12610,0
2,1,9,10,33,34,22.5,10.4,340250,181646,112602,14527,769,97306,46002,15515,21930,11708,7258,936,50,6272,2965,142672,91269,23513,16682,6831,27890,8100,19790,5346,3460,1886,663,1223,26688,26378,16182,0
2,1,8,7,27.1,34.2,26.8,12,331528,189340,104621,10137,785,93699,37567,13043,25418,14517,8021,777,60,7184,2880,163753,111164,27318,19432,7886,25271,8563,16708,4633,3195,1438,402,1036,35345,34793,16127,0
2,1,7,9,31,37.6,21.8,9.6,311679,160776,105554,12661,821,92072,45349,13036,23909,12333,8097,971,63,7063,3479,148740,94838,25621,18521,7100,28281,2311,25970,4950,3223,1727,324,1403,30048,29425,18510,0
2,1,7,9,37.9,32,19.1,11,277206,151620,90678,10494,829,79355,34908,11297,24538,13421,8027,929,73,7024,3090,107884,69155,18807,13580,5227,19922,2959,16963,4027,2913,1114,309,805,26790,23740,21072,0
2,1,3,2,25.2,30.2,32.2,12.4,423278,250468,111726,10284,864,100578,61084,16264,26025,15400,6870,632,53,6184,3756,189897,139399,35061,24959,10102,15437,-1313,16750,6893,4834,2059,276,1783,27549,28837,9394,0
2,1,9,8,33.3,34.5,22.4,9.8,462225,284645,121216,15252,906,105058,56364,17492,26425,16273,6930,872,52,6006,3222,212200,144964,36417,25873,10544,30819,9876,20943,6582,4777,1805,452,1353,32239,30346,15479,0
2,1,7,10,45.6,24.2,19.2,10.9,337653,193690,98448,17656,936,79856,45515,15231,22169,12717,6464,1159,61,5243,2988,150939,84998,21418,15175,6243,44523,32686,11837,4450,3262,1188,385,803,33919,26057,14741,0
2,1,8,6,32.8,31.9,23.9,11.4,496791,304336,130228,16741,950,112537,62227,19510,25463,15599,6675,858,49,5768,3189,259067,156625,40352,28550,11802,62090,19569,42521,8220,5781,2439,519,1920,31517,27093,22146,1
2,1,7,10,35.6,34.6,19.6,10.2,350870,195771,111693,12647,988,98058,43406,14967,23443,13080,7463,845,66,6552,2900,160473,99840,26383,18676,7707,34250,16677,17573,5558,3839,1719,580,1139,28872,26007,15428,1
2,1,7,10,41.6,30.6,16.9,10.9,270793,144622,94930,18671,1004,75255,31241,11880,22794,12174,7991,1572,85,6335,2630,148835,86907,23931,17333,6598,37997,21127,16870,4701,3265,1436,504,932,31660,26618,18101,0
2,1,9,8,31.2,36.8,22.3,9.6,462835,276917,132127,12606,1030,118491,53791,16857,27457,16427,7838,748,61,7029,3191,144069,98602,25402,18284,7118,20065,4212,15853,5120,3518,1602,325,1277,28138,28028,12414,0
2,1,6,6,35.9,31.8,20.7,11.6,479925,276173,143598,17511,1044,125043,60154,23353,20551,11826,6149,750,45,5354,2576,244680,158175,42371,29800,12571,44134,22049,22085,8389,6252,2137,630,1507,29167,25300,14655,1
2,1,7,9,31.8,33.3,21,13.8,506501,281389,141657,17830,1068,122759,83455,19606,25834,14352,7225,909,54,6261,4257,269298,199906,46696,32240,14456,22696,4242,18454,8238,6278,1960,467,1493,32690,31842,12360,0
2,1,7,9,27.1,33.4,27.4,12.1,562547,324961,165103,16094,1079,147930,72483,21965,25611,14794,7517,733,49,6735,3300,280333,195002,52065,37538,14527,33266,10917,22349,9106,7128,1978,560,1418,30786,27357,15761,0
2,1,7,9,35.3,34.8,20.4,9.5,531104,307481,135718,19074,1122,115522,87905,21276,24963,14452,6379,897,53,5430,4132,282866,189446,47061,33338,13723,46359,18233,28126,8418,6418,2000,451,1549,33603,29518,18158,0
2,1,6,6,36.6,29.8,21.9,11.6,492557,286280,137401,16167,1124,120110,68876,19511,25245,14673,7042,829,58,6156,3530,262863,154840,40340,28623,11717,67683,2663,65020,7694,5719,1975,475,1500,34165,27075,43347,0
2,1,2,2,31.2,35.3,22.6,10.9,738201,442743,210377,21787,1271,187319,85081,27512,26832,16093,7647,792,46,6809,3093,324707,198431,50064,35143,14921,76212,30787,45425,11190,8222,2968,631,2337,29018,24134,19437,0
2,1,3,2,30.2,38.7,21.9,9.1,559638,371614,122769,12197,1286,109286,65255,21764,25714,17075,5641,560,59,5021,2998,206175,145481,38509,27538,10971,22185,1286,20899,7557,5186,2371,526,1845,27283,28053,11327,0
2,1,7,9,34.5,35.9,20.6,9,527209,308655,156909,15299,1295,140315,61645,21884,24091,14104,7170,699,59,6412,2817,316707,230486,58232,40424,17808,27989,494,27495,10440,7845,2595,589,2006,30336,29380,13706,1
2,1,6,6,33.5,33.4,21.6,11.5,627017,325337,195020,24403,1306,169311,106660,26610,23563,12226,7329,917,49,6363,4008,352313,251883,59426,40793,18633,41004,10980,30024,11690,8920,2770,529,2241,30138,28238,13398,0
2,1,8,6,35.4,36,20,8.7,457086,244169,148685,10289,1308,137088,64232,19581,23343,12470,7593,525,67,7001,3280,241105,173384,46230,33247,12983,21491,893,20598,7663,6205,1458,308,1150,31464,27943,17911,1
2,1,7,8,36.2,27.6,22.7,13.5,624922,362545,165654,20132,1404,144118,96723,22335,27979,16232,7417,901,63,6453,4331,465425,336181,83629,59046,24583,45615,3837,41778,13766,11403,2363,300,2063,33810,29482,20251,0
2,1,7,9,32.3,31.7,24.6,11.4,843223,519635,199450,22641,1413,175396,124138,29399,28682,17675,6784,770,48,5966,4223,655192,453418,108494,75323,33171,93280,29597,63683,17874,15124,2750,637,2113,36656,29980,30139,1
2,1,7,9,31.5,33.7,21.5,13.2,663240,394512,163655,14825,1448,147382,105073,26684,24855,14785,6133,556,54,5523,3938,385480,270377,64634,44239,20395,50469,3728,46741,12933,9545,3388,643,2745,29806,28327,17028,0
2,1,1,1,28.3,32.5,26.8,12.3,754539,502263,162332,17178,1457,143697,89944,27803,27139,18065,5839,618,52,5168,3235,278571,182915,46546,32804,13742,49110,4967,44143,9783,6536,3247,532,2715,28475,27986,16259,1
2,1,6,6,40.3,26.7,21.9,11.2,433206,211034,173669,35238,1543,136888,48503,19710,21979,10707,8811,1788,78,6945,2461,200099,132113,34524,24683,9841,33462,16915,16547,6854,4915,1939,462,1477,29194,26880,11203,0
2,1,6,5,35,31,22.2,11.8,672175,366126,193510,31703,1551,160256,112539,28641,23469,12783,6756,1107,54,5595,3929,329023,219244,59573,43352,16221,50206,30534,19672,9649,7138,2511,523,1988,34099,30715,9895,1
2,1,7,9,40.6,30.4,19.5,9.5,428439,228566,130078,15347,1594,113137,69795,17884,23957,12780,7273,858,89,6326,3903,229996,172558,44207,30381,13826,13231,9075,4156,8623,6382,2241,532,1709,26672,27038,2432,0
2,1,7,8,33.3,33.8,21.5,11.4,722275,465993,165573,15717,1701,148155,90709,29264,24681,15924,5658,537,58,5063,3100,492209,356310,84665,56150,28515,51234,3773,47461,15667,12257,3410,773,2637,31417,29070,17998,2
2,1,5,8,26.6,31.7,24.2,17.5,908883,473893,263160,32703,1754,228703,171830,32889,27635,14409,8001,994,53,6954,5225,588127,427283,94459,62956,31503,66385,424,65961,17394,13735,3659,204,3455,33812,31109,19091,0
2,1,2,2,30.7,30.2,27.6,11.6,727050,437971,203164,29494,1801,171869,85915,29565,24592,14814,6872,998,61,5813,2906,337331,236312,66949,49011,17938,34070,4985,29085,12059,9149,2910,555,2355,27973,25829,12350,0
2,1,7,9,35.1,31.3,23.6,9.9,594047,346499,167795,14626,1817,151352,79753,25370,23415,13658,6614,577,72,5966,3144,317933,237279,61175,43308,17867,19479,1529,17950,10016,8487,1529,491,1038,31743,27958,17293,1
2,1,6,5,28,31.6,28,12.4,984964,606259,240215,24860,1841,213514,138490,34398,28634,17625,6983,723,54,6207,4026,558870,406605,91805,62264,29541,60460,7344,53116,16928,13232,3696,633,3063,33015,30729,17341,0
2,1,5,8,37.8,21.5,24.5,16.2,710254,363351,240280,42622,1878,195780,106623,27025,26281,13445,8891,1577,69,7244,3945,441249,295993,69296,47235,22061,75960,53498,22462,11925,9981,1944,184,1760,37002,29656,12762,0
2,1,3,2,22.1,29.3,31.3,17.3,1694047,708192,234494,20031,1895,212568,751361,41707,40618,16980,5622,480,45,5097,18015,888138,657106,160351,110302,50049,70681,-960,71641,20081,15291,4790,240,4550,44228,42973,15745,2
2,1,7,8,34.1,31.5,25.6,8.8,614319,370801,166022,11261,1908,152853,77496,23271,26398,15934,7134,484,82,6568,3330,258395,186820,46647,32905,13742,24928,4673,20255,8015,6369,1646,419,1227,32239,29333,16508,0
2,1,3,2,17,27,29.2,26.8,1504812,1039465,229302,21119,2014,206169,236045,50920,29552,20414,4503,415,40,4049,4636,779400,517780,122558,84308,38250,139062,8979,130083,27750,19932,7818,431,7387,28086,25977,17610,2
2,1,5,8,40.7,25.6,21.7,12,712970,401029,205368,41663,2072,161633,106573,31463,22661,12746,6527,1324,66,5137,3387,455556,292025,79142,56937,22205,84389,52375,32014,13131,11253,1878,267,1611,34693,25951,19872,0
2,1,6,3,21.5,22.7,24.7,31.1,1375764,846145,222861,16986,2075,203800,306758,45027,30554,18792,4949,377,46,4526,6813,963999,679753,177099,128286,48813,107147,1269,105878,27165,21451,5714,412,5302,35487,31689,19969,5
2,1,7,8,29.7,32,25.7,12.5,1000646,555708,297808,41745,2102,253961,147130,40141,24928,13844,7419,1040,52,6327,3665,661522,469780,118906,84102,34804,72836,-704,73540,22039,16997,5042,512,4530,30016,27639,16234,0
2,1,7,8,31.9,34.8,21.5,11.7,899631,492765,272867,23734,2162,246971,133999,36608,24575,13461,7454,648,59,6746,3660,591405,437456,103731,71173,32558,50218,-1031,51249,17299,14371,2928,462,2466,34187,30440,20782,1
2,1,5,8,38.1,25.7,20.4,15.9,904170,469904,255243,43945,2250,209048,179023,33540,26958,14010,7610,1310,67,6233,5338,744820,519228,135717,97135,38582,89875,35623,54252,20322,17788,2534,220,2314,36651,29190,23445,1
2,1,1,1,39,32.5,19.4,9,890794,588706,215077,32399,2299,180379,87011,36950,24108,15933,5821,877,62,4882,2355,314798,209784,51711,35945,15766,53303,2827,50476,11767,7333,4434,489,3945,26753,28608,12795,3
2,1,7,9,31.4,31.7,22.3,14.6,588724,340848,143710,20197,2351,121162,104166,21017,28012,16218,6838,961,112,5765,4956,340535,218621,50591,33851,16740,71323,34283,37040,8964,6778,2186,427,1759,37989,32254,21057,1
2,1,6,4,36.5,29.5,23.1,10.8,856929,515301,229709,34980,2391,192338,111919,34813,24615,14802,6598,1005,69,5525,3215,544681,363498,93379,66377,27002,87804,17207,70597,16081,12529,3552,630,2922,33871,29013,24161,0
2,1,5,8,34.7,24.3,22.1,18.8,981801,572664,271150,51347,2507,217296,137987,35628,27557,16073,7611,1441,70,6099,3873,606171,419896,104951,73996,30955,81324,52967,28357,16763,14043,2720,321,2399,36161,29901,11820,4
2,1,6,3,25.4,31.2,29.5,13.9,1565720,976636,368590,36037,2560,329993,220494,56053,27933,17423,6576,643,46,5887,3934,541220,338671,88731,63751,24980,113818,-2344,116162,19439,12316,7123,745,6378,27842,27498,18213,5
2,1,5,8,20,21.7,23.4,34.8,1200753,749343,209945,27448,2584,179913,241465,46032,26085,16279,4561,596,56,3908,5246,871567,629129,172543,126691,45852,69895,1431,68464,25992,21887,4105,385,3720,33532,28744,18404,18
2,1,4,5,26.1,32.2,27.6,14,2004061,1158517,514148,45824,2858,465466,331396,66760,30019,17353,7701,686,43,6972,4964,1520249,1111377,283843,205249,78594,125029,9651,115378,40033,33681,6352,891,5461,37975,32997,21128,0
2,1,4,5,23,26.5,29.7,20.8,1570803,978448,308079,42723,2895,262461,284276,49163,31951,19902,6266,869,59,5339,5782,1201261,903926,225875,157620,68255,71460,15166,56294,30034,25185,4849,223,4626,39997,35891,12169,2
2,1,7,9,34.5,32.4,22.2,10.9,975794,576703,256475,26154,3018,227303,142616,37355,26122,15438,6866,700,81,6085,3818,536539,374541,98147,69229,28918,63851,13392,50459,14940,11611,3329,620,2709,35913,32257,18626,1
2,1,3,2,20.7,27.9,28.6,22.8,2138538,1257381,465302,52614,3723,408965,415855,74057,28877,16979,6283,710,50,5522,5615,1965160,1405405,346885,245600,101285,212870,6212,206658,48633,41924,6709,337,6372,40408,33523,32432,4
2,1,5,8,33.5,28.7,21.4,16.4,1446273,820699,405944,84125,3859,317960,219630,53069,27253,15465,7649,1585,73,5991,4139,934487,648914,161502,112800,48702,124071,59318,64753,26097,21958,4139,248,3891,35808,29553,16642,12
2,1,5,8,24.5,29.8,25.2,20.5,1760498,1077364,354656,46714,3961,303981,328478,59355,29660,18151,5975,787,67,5121,5534,1355313,1048837,255273,176460,78813,51203,6010,45193,35248,29680,5568,411,5157,38451,35338,8763,1
2,1,5,8,25.1,28.1,30.6,16.2,2337586,1392921,533634,61761,4365,467508,411031,78794,29667,17678,6773,784,55,5933,5217,1828019,1344101,330558,228409,102149,153360,-335,153695,47435,41157,6278,347,5931,38537,32658,25914,6
2,1,2,2,18.2,27.4,30.6,23.8,4854574,3367748,696981,52640,5740,638601,789845,136694,35514,24637,5099,385,42,4672,5778,3036037,2190414,480758,323777,156981,364865,15281,349584,80205,63168,17037,668,16369,37853,34676,21356,12
2,1,5,8,25.3,28.2,28.4,18.1,2493415,1623935,467841,49522,5846,412473,401639,80561,30951,20158,5807,615,73,5120,4986,2444600,1847184,410200,275399,134801,187216,7357,179859,62475,53849,8626,504,8122,39129,34303,22145,7
2,1,1,1,18.4,34.1,33.2,14.3,4832513,3719208,590383,54911,6054,529418,522922,150688,32070,24682,3918,364,40,3513,3470,2255432,1573909,344561,228022,116539,336962,5199,331763,67822,51171,16651,415,16236,33255,30758,20434,12
2,1,3,2,19,32.1,32.4,16.5,4762547,2787547,746480,71990,6532,667958,1228520,136028,35012,20492,5488,529,48,4910,9031,3022030,2215777,602789,437817,164972,203464,-2586,206050,66425,54484,11941,400,11541,45495,40668,17854,7
2,1,3,2,19.7,28.4,33.5,18.4,6245100,3434297,1032650,105053,9217,918380,1778153,179054,34878,19180,5767,587,51,5129,9931,4948763,3743700,939141,651083,288058,265922,-2553,268475,121329,102826,18503,314,18189,40788,36408,14760,9
2,1,2,2,19.6,21.9,31.3,27.2,8031125,4850088,1470834,239472,13544,1217818,1710203,246546,32575,19672,5966,971,55,4940,6937,7663687,5622428,1299522,898311,401211,741737,1312,740425,174004,145000,29004,874,28130,44043,38775,26322,7
3,1,3,2,35.2,34.9,19.4,10.5,247951,114013,78411,15196,741,62474,55527,9359,26493,12182,8378,1624,79,6675,5933,109227,75995,23072,17398,5674,10160,6248,3912,3561,2531,1030,271,759,30673,30026,5154,0
3,1,9,10,35,34.7,20.6,9.6,346623,169106,122523,14728,931,106864,54994,14114,24559,11981,8681,1044,66,7571,3896,229761,175615,39195,27266,11929,14951,1382,13569,5531,4257,1274,236,1038,41541,41253,13072,0
3,1,8,6,35.2,31.1,21.2,12.4,334908,169603,117099,22520,1063,93516,48206,13882,24125,12217,8435,1622,77,6736,3473,166673,118500,33051,24421,8630,15122,10478,4644,5684,4058,1626,374,1252,29323,29202,3709,0
3,1,8,6,37.6,30.4,22,10,264422,121474,107180,22221,1321,83638,35768,10722,24662,11329,9996,2072,123,7801,3336,119871,72141,19879,14351,5528,27851,12814,15037,3973,2801,1172,333,839,30171,25755,17923,0
3,1,7,11,28.1,37.4,22.5,12.1,631357,331433,185140,26715,1454,156971,114784,21331,29598,15538,8679,1252,68,7359,5381,352515,250796,63974,45943,18031,37745,8753,28992,10522,7978,2544,468,2076,33503,31436,13965,0
3,1,9,10,34.9,37.5,19.8,7.8,375292,188179,125975,10930,1645,113400,61138,14799,25359,12716,8512,739,111,7663,4131,167497,124232,31847,22460,9387,11418,2497,8921,5781,3997,1784,363,1421,28974,31081,6278,0
3,1,1,1,36.8,35.7,20.4,7.1,567239,347829,153075,16373,1767,134935,66335,22705,24983,15319,6742,721,78,5943,2922,207521,148370,39015,27969,11046,20136,2711,17425,6577,4749,1828,181,1647,31553,31242,10580,0
3,1,8,7,40.5,30.3,19.2,10.1,278265,122395,113046,25418,1807,85821,42824,12148,22906,10075,9306,2092,149,7065,3525,167709,111350,28867,21064,7803,27492,6829,20663,5181,3371,1810,315,1495,32370,33032,13821,1
3,1,8,6,30.3,37.8,22.1,9.8,556842,304215,169619,20707,1837,147075,83008,19951,27910,15248,8502,1038,92,7372,4161,186123,118891,32253,23316,8937,34979,12888,22091,6191,4259,1932,420,1512,30063,27915,14610,1
3,1,3,2,34.8,35.9,21.2,8.1,456879,255004,133279,21544,2179,109556,68596,16260,28098,15683,8197,1325,134,6738,4219,165317,108306,28991,20755,8236,28020,17135,10885,5434,3678,1756,404,1352,30423,29447,8051,0
3,1,7,11,32.1,34.4,21.7,11.8,638730,366022,180372,24060,3225,153087,92336,23393,27304,15647,7711,1029,138,6544,3947,423543,320829,76127,52828,23299,26587,7171,19416,11183,8753,2430,444,1986,37874,36654,9776,0
3,1,7,11,29.2,37.7,21.1,12.1,709588,376147,209322,28438,3833,177051,124119,26283,26998,14311,7964,1082,146,6736,4722,431488,315681,79969,56721,23248,35838,3768,32070,13362,10048,3314,279,3035,32292,31417,10567,0
3,1,8,4,36.8,32.9,22.3,8,783052,419805,231988,21318,4222,206448,131259,30918,25327,13578,7503,690,137,6677,4245,478136,342690,88983,62859,26124,46463,11642,34821,14644,11717,2927,685,2242,32651,29247,15531,0
3,1,6,4,37.4,34.3,20.1,8.3,676766,368175,203364,17180,5385,180799,105227,24696,27404,14908,8235,696,218,7321,4261,374048,250497,65146,45531,19615,58405,5741,52664,12293,8851,3442,542,2900,30428,28302,18160,0
3,1,6,3,29.6,32,26.5,11.9,2425037,1452703,578455,44931,6779,526745,393879,80273,30210,18097,7206,560,84,6562,4907,1324133,939622,224785,155117,69668,159726,28273,131453,40359,29787,10572,2112,8460,32809,31545,15538,9
3,1,3,2,26.7,33.9,25.3,14.1,1655708,944795,445886,36896,8652,400338,265027,54473,30395,17344,8185,677,159,7349,4865,1188505,872045,221830,154400,67430,94630,10909,83721,29584,23890,5694,642,5052,40174,36503,16572,2
3,1,3,2,23.6,34.1,23.8,18.5,2763919,1557537,646035,51032,9159,585844,560347,92202,29977,16893,7007,553,99,6354,6077,1379983,983010,241064,168568,72496,155909,17116,138793,44449,33988,10461,1476,8985,31046,28922,15447,3
3,1,4,5,18,29.6,29.3,23.1,6286039,3662845,1141954,70757,11210,1059987,1481240,175827,35751,20832,6495,402,64,6029,8424,2871664,2113709,471021,315696,155325,286934,-5250,292184,92684,68177,24507,948,23559,30983,31003,12402,7
3,1,3,2,21.2,28.4,26.4,24,6077480,3641644,1199067,121883,12744,1064440,1236769,188093,32311,19361,6375,648,68,5659,6575,4678967,3561287,874026,620187,253839,243654,2443,241211,111782,94864,16918,505,16413,41858,37541,14696,8
3,1,2,2,23.3,31.9,26.2,18.6,12886607,7949789,2826400,372401,32525,2421474,2110418,409196,31493,19428,6907,910,79,5918,5157,9748842,7336555,1643230,1113036,530194,769057,7079,761978,234073,192919,41154,707,40447,41649,38029,18839,10
3,1,1,1,19.1,27.9,28.4,24.6,27814943,17059321,4504380,502532,61409,3940439,6251242,656510,42368,25985,6861,765,94,6002,9522,24009052,17847469,3770927,2511066,1259861,2390656,-6918,2397574,464398,391362,73036,399,72637,51699,45603,33008,33
3,1,6,7,31.7,36.4,19.5,12.4,330696,153702,74582,6986,480,67116,102412,11484,28796,13384,6494,608,42,5844,8918,149865,106805,29299,21897,7402,13761,0,13761,5211,3465,1746,0,1746,28759,30824,7881,0
3,1,6,6,27.4,37.1,25.3,10.1,392604,195982,106405,8587,1402,96416,90217,15851,24768,12364,6713,542,88,6083,5692,192576,142962,42647,32692,9955,6967,0,6967,5787,4205,1582,0,1582,33277,33998,4404,0
3,1,6,6,24,32.3,27.4,16.2,1981833,1043386,326586,25577,5072,295937,611861,53563,37000,19480,6097,478,95,5525,11423,933333,668049,156984,109521,47463,108300,942,107358,29547,20675,8872,666,8206,31588,32312,13083,9
3,1,4,3,15.1,28.9,30.5,25.5,4851651,1888636,421908,28205,6467,387236,2541107,72730,66708,25968,5801,388,89,5324,34939,2122687,1580657,357867,245409,112458,184163,0,184163,54831,40254,14577,0,14577,38713,39267,12634,10
3,1,2,2,14.6,29.2,33.4,22.9,5316075,3352838,868233,65573,12334,790326,1095004,148538,35789,22572,5845,441,83,5321,7372,1796249,1244139,326879,235456,91423,225231,6131,219100,51538,35385,16153,540,15613,34853,35160,14033,19
3,1,3,2,12,27.1,36.6,24.2,7387136,4102201,1143034,80033,14707,1048294,2141901,181752,40644,22570,6289,440,81,5768,11785,5465694,4098360,1138820,824237,314583,228514,673,227841,121438,100087,21351,491,20860,45008,40948,10922,10
3,1,3,2,19,30.6,32.7,17.7,6097526,3543208,1159220,100811,18528,1039881,1395098,166267,36673,21310,6972,606,111,6254,8391,4103972,2988025,763891,546114,217777,352056,-66,352122,99109,81267,17842,113,17729,41409,36768,19861,15
3,1,2,2,17.9,28.3,32.7,21,9981988,5691299,2106574,221211,25453,1859910,2184115,296854,33626,19172,7096,745,86,6265,7358,7600364,5702100,1489673,1068221,421452,408591,676,407915,174368,147254,27114,652,26462,43588,38723,15415,12
3,1,2,2,18.2,26.2,27.6,27.9,21574166,6970818,2130069,114863,40219,1974987,12473279,316641,68134,22015,6727,363,127,6237,39392,7553129,5576116,1120353,737949,382404,856660,53181,803479,178682,131655,47027,242,46785,42271,42354,17174,28
3,1,1,1,18,28.4,29.1,24.5,70307337,42756283,10544950,917811,220733,9406406,17006104,1723633,40790,24806,6118,532,128,5457,9866,45247546,35290679,7541850,5098037,2443813,2415017,-111,2415128,1022753,797400,225353,370,224983,44241,44257,10735,284
3,1,1,1,32.1,22.3,23.9,21.7,93020905,53811897,17511535,2242584,324438,14944513,21697473,2436062,38185,22090,7188,921,133,6135,8907,67840187,50946370,11046806,7558219,3488587,5847011,48176,5798835,1448666,1097020,351646,1883,349763,46829,46441,16579,148
3,1,9,10,36.8,31.5,16.9,14.8,143340,58789,48718,8539,476,39703,35833,5376,26663,10935,9062,1588,89,7385,6665,64652,50133,13961,10775,3186,558,-4433,4991,2415,1783,632,205,427,26771,28117,11689,0
3,1,8,7,34.6,38.6,18,8.8,312485,183537,94499,9120,650,84729,34449,10224,30564,17952,9243,892,64,8287,3369,115509,82586,23024,17981,5043,9899,-1275,11174,3934,2887,1047,255,792,29362,28606,14109,0
3,1,6,6,31.5,38.5,18.8,11.2,415475,248998,113112,8458,669,103985,53365,14667,28327,16977,7712,577,46,7090,3638,205645,144703,36817,28726,8091,24125,1982,22143,5701,4342,1359,151,1208,36072,33326,18330,1
3,1,6,7,32.6,41.8,16.9,8.7,228537,123666,72812,10769,705,61338,32059,9185,24882,13464,7927,1172,77,6678,3490,115307,77087,19826,14763,5063,18394,654,17740,3381,2506,875,208,667,34104,30761,26597,0
3,1,2,2,46.7,24,18.7,10.6,431135,280650,69936,7022,718,62196,80549,15767,27344,17800,4436,445,46,3945,5109,359475,265140,74553,62027,12526,19782,2150,17632,6944,5591,1353,143,1210,51768,47423,14572,0
3,1,9,10,38.6,36.7,15.3,9.4,249091,124187,89277,11552,777,76948,35627,10567,23573,11752,8449,1093,74,7282,3372,110991,71483,20137,15660,4477,19371,-6195,25566,4115,2786,1329,432,897,26972,25658,28502,0
3,1,7,9,42.1,31.2,14.3,12.3,196421,87982,78416,15722,841,61853,30023,7939,24741,11082,9877,1980,106,7791,3782,96944,65763,19140,15182,3958,12041,8707,3334,3074,2411,663,195,468,31537,27276,7124,0
3,1,6,5,26.4,39.7,21,12.9,456497,260257,134351,13294,887,120170,61889,16105,28345,16160,8342,825,55,7462,3843,203123,136076,35051,27205,7846,31996,3012,28984,5300,3998,1302,173,1129,38325,34036,25672,0
3,1,6,6,34.6,40,16,9.4,414341,239675,123191,14588,960,107643,51475,15398,26909,15565,8000,947,62,6991,3343,265377,176908,43565,31902,11663,44904,332,44572,6853,5639,1214,135,1079,38724,31372,41309,1
3,1,7,8,36.6,33.7,18.7,11,285619,145326,103251,21013,980,81258,37042,12340,23146,11777,8367,1703,79,6585,3002,150969,108462,32113,25703,6410,10394,237,10157,4949,3914,1035,260,775,30505,27711,13106,1
3,1,1,1,31.3,34.2,23.7,10.8,999714,659915,131068,14599,1046,115423,208731,22677,44085,29101,5780,644,46,5090,9205,1186928,878755,206222,151006,55216,101951,7344,94607,19301,16206,3095,128,2967,61496,54224,31886,1
3,1,6,6,28.1,41.3,19.1,11.5,18811,199873,135622,16273,1051,118298,62720,14494,27474,13790,9357,1123,73,8162,4327,199191,142315,35715,26713,9002,21161,667,20494,5594,4192,1402,171,1231,35608,33949,16648,0
3,1,7,9,34.3,35.2,18.1,12.4,484329,262365,131873,17629,1084,113160,90091,17169,28210,15281,7681,1027,63,6591,5247,249084,163502,41818,32673,9145,43764,18221,25543,5895,4517,1378,206,1172,42253,36197,21794,0
3,1,9,10,40.5,34.8,15.2,9.5,268753,131323,102930,11589,1222,90119,34500,11670,23029,11253,8820,993,105,7722,2956,109402,78243,21925,17281,4644,9234,-1901,11135,4414,2717,1697,837,860,24785,28798,12948,0
3,1,3,2,26.9,41.6,21.7,9.8,564794,348860,147358,17697,1239,128422,68576,21657,26079,16108,6804,817,57,5930,3166,169945,112931,35507,28175,7332,21507,428,21079,5211,3517,1694,217,1477,32613,32110,14271,0
3,1,6,6,29.2,40.9,18.8,11.1,654787,374700,186314,18522,1284,166508,93773,24124,27143,15532,7723,768,53,6902,3887,300656,184814,49213,37709,11504,66629,17821,48808,8492,6188,2304,316,1988,35405,29867,24551,0
3,1,2,2,30.9,39.1,17.3,12.8,788681,482456,168812,22328,1374,145110,137413,22966,34341,21007,7351,972,60,6318,5983,311825,211638,55584,41348,14236,44603,12537,32066,8977,6326,2651,366,2285,34736,33455,14033,0
3,1,2,2,26.6,40.6,21.7,11.1,856386,617329,143161,19334,1386,122441,95896,23252,36831,26550,6157,831,60,5266,4124,706224,527771,122648,88046,34602,55805,1278,54527,14920,12560,2360,104,2256,47334,42020,24170,0
3,1,6,6,36.8,38,16,9.3,664507,397528,171372,19960,1461,149951,95607,25854,25702,15376,6628,772,57,5800,3698,401126,292150,80103,63990,16113,28873,3278,25595,11059,9250,1809,342,1467,36271,31584,17447,0
3,1,3,2,28.3,40.1,19.8,11.8,670603,399521,181366,19409,1528,160429,89716,22698,29545,17602,7990,855,67,7068,3953,232487,152347,41714,31814,9900,38426,18534,19892,8158,5587,2571,368,2203,28498,27268,9030,1
3,1,6,6,38.1,32.1,16.9,12.8,591569,344171,179199,24427,1543,153229,68199,20727,28541,16605,8646,1179,74,7393,3290,289813,186337,49684,37488,12196,53792,7145,46647,9124,6632,2492,692,1800,31764,28097,25915,0
3,1,6,5,30.6,41.2,18.3,9.9,1045441,632780,229966,23468,1568,204930,182695,31497,33192,20090,7301,745,50,6506,5800,467904,312728,76093,56664,19429,79083,36538,42545,12639,9686,2953,578,2375,37021,32287,17914,0
3,1,6,5,40.6,36.9,15.1,7.4,739811,480834,166523,22572,1598,142353,92454,23534,31436,20431,7076,959,68,6049,3929,284500,205517,47151,34173,12978,31832,1461,30371,7105,5221,1884,67,1817,40042,39364,16715,0
3,1,7,11,38.6,36.5,15.1,9.8,534006,270030,193389,25454,1607,166328,70587,20758,25725,13008,9316,1226,77,8013,3400,235842,157109,44033,34219,9814,34700,13148,21552,8674,5986,2688,1002,1686,27190,26246,12783,0
3,1,7,8,35.4,34.5,20.6,9.6,590313,329933,168747,26011,1646,141090,91633,20420,28909,16157,8264,1274,81,6909,4487,296275,186839,47959,36761,11198,61477,1125,60352,8325,6208,2117,392,1725,35589,30096,34987,1
3,1,6,6,44.5,30.6,15.4,9.5,1048432,609646,303422,41140,1757,260525,135364,34316,30552,17766,8842,1199,51,7592,3945,409123,268960,71611,54805,16806,68552,21656,46896,11769,8805,2964,662,2302,34763,30546,20372,1
3,1,6,4,26.1,45.2,18.7,10.1,824949,585727,149627,20362,1779,127486,89595,22095,37336,26509,6772,922,81,5770,4055,605088,422722,119028,93599,25429,63338,510,62828,9771,8051,1720,39,1681,61927,52506,37375,0
3,1,1,1,26.9,37.9,26.2,8.9,1159780,594610,171559,23759,2207,145593,393611,28879,40160,20590,5941,823,76,5041,13630,648436,480191,126307,97050,29257,41938,6069,35869,13521,10456,3065,32,3033,47958,45925,11826,1
3,1,2,2,34.3,38.9,17.2,9.6,1054912,670574,238948,36437,2258,200253,145390,33685,31317,19907,7094,1082,67,5945,4316,1054288,823182,198960,149988,48972,32146,2491,29655,18261,15595,2666,136,2530,57734,52785,11721,2
3,1,2,2,29.7,40.6,19.4,10.2,805989,487039,203031,27566,2392,173073,115919,26590,30312,18317,7636,1037,90,6509,4359,353394,257892,61785,46282,15503,33717,-5138,38855,9445,6774,2671,538,2133,37416,38071,18216,0
3,1,6,6,40.2,37,14.5,8.3,1188521,654607,363856,49572,2603,311681,170058,42040,28271,15571,8655,1179,62,7414,4045,474329,323637,88887,70600,18287,61805,3137,58668,16177,12183,3994,783,3211,29321,26565,18271,0
3,1,6,3,31.8,40.2,17.1,10.9,1320397,706226,427436,53806,2742,370888,186735,47000,28094,15026,9094,1145,58,7891,3973,535609,383533,104950,83574,21376,47126,-2325,49451,17084,11933,5151,759,4392,31351,32141,11259,0
3,1,6,5,27.3,32.1,22.2,18.4,1171009,718152,291771,44880,2758,244133,161086,39244,29839,18300,7435,1144,70,6221,4105,715529,456889,123016,96661,26355,135624,5038,130586,18771,14871,3900,491,3409,38119,30723,38306,0
3,1,4,5,19.6,24.7,23.9,31.8,1402865,803569,295480,35392,2783,257305,303816,45726,30680,17574,6462,774,61,5627,6644,993322,667105,166011,126601,39410,160206,14815,145391,25183,20231,4952,273,4679,39444,32974,31073,6
3,1,4,5,34.4,38,16.9,10.7,1943825,1252173,367662,41262,2810,323590,323990,57421,33852,21807,6403,719,49,5635,5642,871847,583936,132453,96680,35773,155458,52205,103253,21635,15178,6457,1008,5449,40298,38473,18949,0
3,1,6,5,33.4,38.8,18.1,9.7,807388,435661,264309,42957,2831,218521,107418,28311,28519,15388,9336,1517,100,7719,3794,366538,258851,64111,47466,16645,43576,13565,30011,10837,8097,2740,375,2365,33823,31969,12690,1
3,1,4,5,35.3,38,17.2,9.4,1924079,1213236,431707,54186,2951,374570,279136,61115,31483,19852,7064,887,48,6129,4567,901040,598254,140458,103439,37019,162328,54303,108025,23570,17469,6101,741,5360,38228,34247,20154,3
3,1,4,5,34.1,38.3,18.2,9.4,1963882,1185456,383302,55466,3005,324831,395124,54352,36133,21811,7052,1020,55,5976,7270,1741389,1330167,272906,192134,80772,138316,-352,138668,34537,29267,5270,98,5172,50421,45449,26811,3
3,1,1,1,20,36.1,26.4,17.5,2141559,1566682,283969,33992,3050,246927,290908,52516,40779,29832,5407,647,58,4702,5539,1941294,1456962,364803,277056,87747,119529,-494,120023,31893,26217,5676,50,5626,60869,55573,21334,1
3,1,4,5,19.9,36.4,30.2,13.5,1660361,1067333,286144,32327,3246,250571,306884,48007,34586,22233,5960,673,68,5219,6392,1427642,1038054,349426,266160,83266,40162,-2149,42311,27475,24324,3151,424,2727,51961,42676,15516,0
3,1,6,5,29.2,35.9,22.3,12.6,1308134,762801,351661,38985,3347,309329,193672,41240,31720,18497,8527,945,81,7501,4696,706216,511560,119937,86354,33583,74719,-1910,76629,18909,14485,4424,377,4047,37348,35317,18935,2
3,1,1,1,23.1,38.9,25,12.9,1619548,1158908,292518,47937,3355,241226,168122,46811,34598,24757,6249,1024,72,5153,3592,1095649,764332,191285,144120,47165,140032,287,139745,21362,16341,5021,19,5002,51290,46774,27938,0
3,1,4,5,33.1,38.5,17.2,11.2,2652411,1631022,522912,73956,3920,445036,498477,73522,36076,22184,7112,1006,53,6053,6780,2082430,1570612,309261,210088,99173,202557,-684,203241,44299,36686,7613,258,7355,47009,42812,27633,11
3,1,3,2,33.7,38,16,12.4,4002273,2630633,595212,64790,4554,525868,776428,95603,41863,27516,6226,678,48,5501,8121,2698035,1873852,414874,301101,113773,409309,13715,395594,51012,41071,9941,350,9591,52890,45625,41246,5
3,1,4,5,38,33.3,18,10.7,2720493,1628509,737767,106405,5319,626043,354217,84427,32223,19289,8739,1260,63,7415,4196,1273953,888689,222284,167846,54438,162980,20415,142565,35770,26980,8790,1165,7625,35615,32939,18697,3
3,1,3,2,32.9,35.8,19,12.3,4385737,3019682,699509,86767,5477,607265,666546,111453,39351,27094,6276,779,49,5449,5981,3596321,2708193,533291,363376,169915,354837,8913,345924,72088,60687,11401,133,11268,49888,44626,30700,5
3,1,2,2,20.4,41.7,23.4,14.5,4014316,3052850,518903,54742,5790,458371,442563,102891,39015,29671,5043,532,56,4455,4301,2170398,1629914,373073,270296,102777,167411,553,166858,48531,37612,10919,230,10689,44722,43335,15610,3
3,1,6,5,25,39.5,21.7,13.8,32194,822303,271,7629,5825,106635,68488,34893,35033,23566,6406,606,62,5738,5061,467840,346376,82578,61042,21536,38886,-4990,43876,13306,9529,3777,759,3018,35160,36350,14538,0
3,1,2,2,17,32.5,32.4,18.1,4032352,2586914,722033,73277,6552,642204,723405,113824,35426,22727,6343,644,58,5642,6355,2481266,1825916,468119,343348,124771,187231,-3069,190300,63408,51487,11921,406,11515,39132,35464,16526,2
3,1,2,2,22.8,43.2,22.6,11.4,4093792,3005255,661853,72540,6627,582686,426684,123962,33025,24243,5339,585,53,4701,3442,1186813,817795,197576,146582,50994,171442,-1415,172857,38402,24688,13714,400,13314,30905,33125,12983,2
3,1,3,2,25.4,33.8,24.3,16.5,4734973,2644644,1192305,125413,7674,1059218,898024,130785,36204,20221,9117,959,59,8099,6866,3255051,2394936,585143,432161,152982,274972,9608,265364,79720,66874,12846,784,12062,40831,35813,22000,5
3,1,4,3,28.5,34.3,21,16.3,3797407,2353513,922147,125458,7879,788810,521747,118621,32013,19841,7774,1058,66,6650,4398,2124100,1508344,386235,297132,89103,229521,5385,224136,60137,45850,14287,1002,13285,35321,32897,16871,3
3,1,3,2,20.2,29,25.4,25.5,9870309,6357818,1208887,135049,9995,1063843,2303604,215139,45879,29552,5619,628,46,4945,10708,8796375,6363588,1221128,821687,399441,1211659,-1504,1213163,174939,143492,31447,585,30862,50283,44348,39309,36
3,1,3,2,21.4,30,25.9,22.7,4859141,2851495,1109857,163233,10674,935950,897789,151727,32026,18794,7315,1076,70,6169,5917,3489763,2567236,606910,446631,160279,315617,3405,312212,93698,74880,18818,394,18424,37245,34285,16946,5
3,1,3,2,23,34.6,25.6,16.9,6741198,4208833,1250304,139256,11102,1099946,1282061,188928,35681,22277,6618,737,59,5822,6786,5042614,3761103,901718,670138,231580,379793,-1108,380901,111404,92990,18414,806,17608,45264,40446,21632,11
3,1,1,1,16.1,26.5,29,28.3,10661320,7076737,1391113,106877,11623,1272613,2193470,229252,46505,30869,6068,466,51,5551,9568,4646158,3039455,674181,485530,188651,932522,-1007,933529,116916,81182,35734,503,35231,39739,37440,26497,23
3,1,2,2,21.3,32.2,25.9,20.6,10547594,6472781,1890884,261008,18200,1611676,2183929,251953,41863,25690,7505,1036,72,6397,8668,8218426,5186201,1198640,865428,333212,1833585,-12553,1846138,164403,132789,31614,524,31090,49990,39056,59380,11
3,1,1,1,25.3,23.4,25.5,25.8,13941922,7551908,1954091,331960,21800,1600331,4435923,301842,46189,25019,6474,1100,72,5302,14696,13497398,9577894,2042899,1450230,592669,1876605,0,1876605,233504,193783,39721,0,39721,57804,49426,47245,13
3,1,1,1,20.7,30,27.8,21.5,18892939,12465692,2872027,285113,25402,2561512,3555220,431759,43758,28872,6652,660,59,5933,8234,13611113,9125989,1853238,1271792,581446,2631886,38,2631848,268981,212746,56235,51,56184,50603,42896,46843,40
3,1,2,2,16.1,26.4,26.7,30.8,17487376,11518711,2698078,374751,26642,2296685,3270587,433723,40319,26558,6221,864,61,5295,7541,15982900,12003777,2676272,1948212,728060,1302851,-805,1303656,332621,277721,54900,417,54483,48051,43222,23928,53
3,1,9,10,41.2,31.2,20.5,7.1,29569,16809,8294,1599,170,6525,4466,1521,19440,11051,5453,1051,112,4290,2936,9208,8032,2181,1499,682,-1005,-2029,1024,469,338,131,71,60,19633,23763,17067,0
3,1,9,10,39.4,28.8,19.2,12.6,113138,38977,51861,10098,631,41132,22300,5191,21795,7509,9991,1945,122,7924,4296,39695,38148,10144,7092,3052,-8597,-12245,3648,1955,1531,424,85,339,20304,24917,10761,0
3,1,9,10,32.5,33.8,23.2,10.5,206496,111693,66633,6966,649,59018,28170,8136,25381,13728,8190,856,80,7254,3462,81442,56771,15449,11284,4165,9222,1326,7896,2708,1846,862,164,698,30075,30754,11312,0
3,1,9,10,34.9,32.7,21.2,11.2,201069,104372,66774,6850,780,59144,29923,8703,23103,11993,7673,787,90,6796,3438,98893,70371,19663,14316,5347,8859,1905,6954,3104,2262,842,238,604,31860,31110,11513,0
3,1,8,7,41.9,33.1,15.1,10,229075,115130,80258,12016,833,67409,33687,10061,22769,11443,7977,1194,83,6700,3348,95336,68647,16736,11488,5248,9953,-881,10834,3379,2384,995,158,837,28214,28795,12944,0
3,1,9,10,32.3,33.9,20.7,13,282172,141251,101701,9070,876,91755,39220,10204,27653,13843,9967,889,86,8992,3844,98533,65297,17214,12332,4882,16022,699,15323,4155,2404,1751,332,1419,23714,27162,10798,0
3,1,9,8,39.5,28.3,21.9,10.3,219704,112561,75208,8546,909,65753,31935,10392,21142,10832,7237,822,87,6327,3073,75700,54032,16368,12270,4098,5300,677,4623,2996,2121,875,385,490,25267,25475,9435,0
3,1,8,4,41.2,32.2,18.8,7.8,196281,111038,65102,7931,913,56258,20141,8769,22384,12663,7424,904,104,6416,2297,51456,34450,9491,6915,2576,7515,-801,8316,2053,1234,819,266,553,25064,27917,15038,0
3,1,9,8,33.4,34.7,21,10.9,274728,156210,80040,8834,965,70241,38478,10694,25690,14607,7485,826,90,6568,3598,56116,39586,10305,7251,3054,6225,-6989,13214,2707,1495,1212,468,744,20730,26479,17761,0
3,1,8,5,32.8,35.6,22.2,9.4,339467,183992,110867,12462,1023,97382,44608,13324,25478,13809,8321,935,77,7309,3348,110339,77149,19090,13338,5752,14100,7333,6767,4000,2667,1333,511,822,27585,28927,8232,0
3,1,7,9,37.9,32,19.1,11,293738,151083,99695,10286,1098,88311,42960,11067,26542,13652,9008,929,99,7980,3882,106892,73663,19735,14201,5534,13494,-21,13515,4077,2958,1119,305,814,26218,24903,16603,0
3,1,8,7,33.6,34.9,21.2,10.4,322031,179648,104522,14507,1099,88916,37861,12636,25485,14217,8272,1148,87,7037,2996,157677,118781,24637,16205,8432,14259,4523,9736,4115,2902,1213,355,858,38318,40931,11347,0
3,1,8,7,27.1,34.2,26.8,12,357521,200838,115097,10987,1170,102940,41586,13038,27421,15404,8828,843,90,7895,3190,174397,116859,28726,20260,8466,28812,13482,15330,4615,3234,1381,389,992,37789,36135,15454,0
3,1,8,7,29.2,38.3,23.3,9.1,425400,255828,118819,13231,1177,104411,50753,16345,26026,15652,7269,809,72,6388,3105,186792,103484,29012,21194,7818,54296,35895,18401,5338,3459,1879,635,1244,34993,29917,14792,0
3,1,3,2,28,38.1,26.2,7.7,308066,173281,99546,10849,1181,87516,35239,12337,24971,14046,8069,879,96,7094,2856,135917,100644,23228,16164,7064,12045,1157,10888,3754,2709,1045,296,749,36206,37152,14537,0
3,1,9,10,33,34,22.5,10.4,366298,186331,127815,15200,1200,111415,52152,15622,23448,11927,8182,973,77,7132,3338,146381,94731,24608,17453,7155,27042,9025,18017,5308,3430,1878,640,1238,27577,27618,14553,0
3,1,3,2,25.2,30.2,32.2,12.4,455748,267079,127268,10971,1253,115044,61401,17084,26677,15633,7450,642,73,6734,3594,190369,141764,36049,25622,10427,12556,-544,13100,6821,4803,2018,265,1753,27909,29516,7473,1
3,1,8,7,32.6,38,21.4,8,290862,173882,86709,8538,1268,76903,30271,14293,20350,12166,6067,597,89,5380,2118,101461,67192,19176,14317,4859,15093,6852,8241,3409,2362,1047,346,701,29763,28447,11756,0
3,1,1,1,39.5,30.2,21.3,9.1,298301,169715,79789,16913,1298,61578,48797,10910,27342,15556,7313,1550,119,5644,4473,588739,492476,74637,45223,29414,21626,16466,5160,15826,14889,937,75,862,37201,33076,5986,0
3,1,7,9,31,37.6,21.8,9.6,321975,153299,117402,13052,1301,103049,51274,12857,25043,11923,9131,1015,101,8015,3988,148195,99337,26872,19310,7562,21986,-789,22775,4922,3303,1619,320,1299,30109,30075,17533,1
3,1,7,10,45.6,24.2,19.2,10.9,338960,182402,110200,18820,1395,89985,46358,15225,22263,11980,7238,1236,92,5910,3045,137679,85863,21645,15071,6574,30171,19603,10568,4425,3238,1187,400,787,31114,26517,13428,0
3,1,7,10,41.6,30.6,16.9,10.9,279777,136225,107978,20018,1443,86517,35574,11823,23664,11522,9133,1693,122,7318,3009,133963,82658,22708,16358,6350,28597,14287,14310,4528,3061,1467,502,965,29585,27004,14829,0
3,1,8,6,32.8,31.9,23.9,11.4,549057,327276,151521,17534,1468,132519,70260,19594,28022,16703,7733,895,75,6763,3586,254141,159633,40956,28921,12035,53552,19090,34462,8054,5771,2283,496,1787,31555,27661,19285,0
3,1,9,8,33.3,34.5,22.4,9.8,502050,296778,138310,16281,1472,120557,66962,17550,28607,16910,7881,928,84,6869,3815,232089,158124,38394,26920,11474,35571,16336,19235,6546,4831,1715,436,1279,35455,32731,15039,1
3,1,7,10,35.6,34.6,19.6,10.2,354272,177994,124730,13060,1487,110183,51548,14912,23758,11936,8364,876,100,7389,3457,144387,98106,26283,18631,7652,19998,4623,15375,5506,3739,1767,568,1199,26224,26239,12823,0
3,1,9,8,31.2,36.8,22.3,9.6,485944,282268,146958,13847,1489,131622,56718,16772,28974,16830,8762,826,89,7848,3382,142677,100367,26072,18761,7311,16238,2820,13418,5102,3509,1593,316,1277,27965,28603,10507,1
3,1,6,6,35.9,31.8,20.7,11.6,533648,299342,164939,18892,1595,144452,69367,23641,22573,12662,6977,799,67,6110,2934,268497,172718,45466,31601,13865,50313,30279,20034,8727,6598,2129,612,1517,30766,26177,13206,1
3,1,7,9,31.8,33.3,21,13.8,544042,299819,158504,19276,1686,137542,85719,19342,28127,15501,8195,997,87,7111,4432,279896,214768,47627,32995,14632,17501,5155,12346,8098,6130,1968,459,1509,34564,35036,8182,0
3,1,7,9,27.1,33.4,27.4,12.1,603346,337522,183895,17840,1731,164324,81929,21851,27612,15447,8416,816,79,7520,3749,282129,194492,51981,37500,14481,35656,17966,17690,8854,6867,1987,545,1442,31865,28323,12268,0
3,1,7,9,35.3,34.8,20.4,9.5,561131,318697,154251,20489,1791,131971,88183,20963,26768,15203,7358,977,85,6295,4207,291096,189945,46999,33063,13936,54152,27005,27147,8218,6265,1953,446,1507,35422,30318,18014,0
3,1,6,6,36.6,29.8,21.9,11.6,530229,296758,153205,17417,1832,133956,80266,19622,27022,15124,7808,888,93,6827,4091,272046,169991,42025,29594,12431,60030,-1093,61123,7641,5656,1985,457,1528,35603,30055,40002,0
3,1,2,2,31.2,35.3,22.6,10.9,797406,468021,235718,21834,1902,211982,93667,27682,28806,16907,8515,789,69,7658,3384,344817,207697,52687,36921,15766,84433,40668,43765,11212,8367,2845,601,2244,30754,24823,19503,0
3,1,3,2,30.2,38.7,21.9,9.1,619946,409806,137396,11379,1964,124053,72744,22193,27934,18466,6191,513,88,5590,3278,257668,191065,45747,31854,13893,20856,1617,19239,7871,5644,2227,519,1708,32736,33853,11264,1
3,1,7,8,36.2,27.6,22.7,13.5,651277,360430,187345,21021,1979,164345,103502,22194,29345,16240,8441,947,89,7405,4664,459548,336902,85076,59964,25112,37570,1070,36500,13632,11338,2294,293,2001,33711,29714,18241,0
3,1,8,6,35.4,36,20,8.7,486760,245088,166204,9944,2009,154251,75468,19524,24931,12553,8513,509,103,7901,3865,241288,176522,47353,34153,13200,17413,-165,17578,7539,6114,1425,295,1130,32005,28872,15556,0
3,1,6,6,33.5,33.4,21.6,11.5,665539,338443,217804,25971,2033,189800,109292,26825,24810,12617,8119,968,76,7075,4074,365247,266111,62211,42416,19795,36925,11988,24937,11827,8916,2911,511,2400,30882,29846,10390,0
3,1,7,9,32.3,31.7,24.6,11.4,906540,556824,226084,24915,2101,199068,123632,29562,30666,18836,7648,843,71,6734,4182,706550,477451,111541,77313,34228,117558,34729,82829,17987,15210,2777,621,2156,39281,31391,38418,0
3,1,1,1,28.3,32.5,26.8,12.3,789850,504094,188982,18816,2256,167910,96774,28222,27987,17862,6696,667,80,5950,3429,272749,185254,47534,33579,13955,39961,3049,36912,9828,6442,3386,526,2860,27752,28757,12906,2
3,1,7,9,31.5,33.7,21.5,13.2,685242,394221,184476,15334,2325,166817,106545,26931,25444,14638,6850,569,86,6194,3956,406260,290944,69012,46922,22090,46304,2150,44154,13108,9677,3431,635,2796,30993,30066,15792,0
3,1,2,2,30.7,30.2,27.6,11.6,786673,460668,227698,32006,2420,193272,98307,29584,26591,15572,7697,1082,82,6533,3323,360269,253335,69650,50487,19163,37284,7190,30094,12233,9407,2826,530,2296,29451,26930,13107,0
3,1,7,9,40.6,30.4,19.5,9.5,451156,222188,142479,16261,2422,123796,86489,17639,25577,12596,8077,922,137,7018,4903,218464,170653,44049,30386,13663,3762,9292,-5530,8289,6113,2176,520,1656,26356,27916,-3339,0
3,1,7,9,34.5,35.9,20.6,9,554021,301991,177783,16481,2432,158870,74247,21982,25203,13738,8088,750,111,7227,3378,291475,211315,54706,38333,16373,25454,754,24700,9760,7143,2617,589,2028,29864,29584,12179,0
3,1,6,5,35,31,22.2,11.8,658195,331236,212862,33744,2467,176651,114097,28441,23142,11646,7484,1186,87,6211,4012,298297,227945,61985,44903,17082,8367,-9400,17767,9720,7124,2596,534,2062,30689,31997,8616,0
3,1,5,8,26.6,31.7,24.2,17.5,977024,483333,288335,34693,2500,251142,205356,32629,29943,14813,8837,1063,77,7697,6294,606869,446700,96952,65294,31658,63217,391,62826,17821,13837,3984,194,3790,34054,32283,16577,0
3,1,6,6,40.3,26.7,21.9,11.2,444335,188575,199680,38286,2580,158814,56080,19755,22492,9546,10108,1938,131,8039,2839,174865,130424,34665,24770,9895,9776,-5273,15049,6714,4740,1974,463,1511,26045,27516,9960,1
3,1,5,8,37.8,21.5,24.5,16.2,697935,312554,266184,45070,2587,218527,119197,26549,26289,11773,10026,1698,97,8231,4490,395012,289678,68583,47207,21376,36751,12188,24563,11803,9723,2080,199,1881,33467,29793,13058,0
3,1,7,9,31.4,31.7,22.3,14.6,603334,338413,162075,21622,2636,137817,102846,20878,28898,16209,7763,1036,126,6601,4926,325763,207567,46634,31205,15429,71562,37896,33666,8494,6380,2114,411,1703,38352,32534,19769,0
3,1,7,8,33.3,33.8,21.5,11.4,752011,462158,188546,17078,2830,168638,101307,29475,25514,15680,6397,579,96,5721,3437,450843,334691,81360,54578,26782,34792,995,33797,14989,11546,3443,770,2673,30078,28988,12644,1
3,1,7,9,35.1,31.3,23.6,9.9,630027,355333,187516,14690,2840,169986,87178,25481,24725,13945,7359,577,111,6671,3421,325340,244821,62971,44210,18761,17548,1434,16114,10064,8485,1579,478,1101,32327,28853,14636,1
3,1,3,2,22.1,29.3,31.3,17.3,1423813,758642,272765,21191,2851,248723,392406,42764,33295,17740,6378,496,67,5816,9176,940266,697596,169578,117534,52044,73092,-2115,75207,20552,15734,4818,234,4584,45751,44337,16406,3
3,1,6,5,28,31.6,28,12.4,1071109,655641,269951,26553,2859,240539,145517,34724,30846,18881,7774,765,82,6927,4191,577675,413933,93268,62921,30347,70474,7863,62611,16672,13033,3639,602,3037,34649,31760,20616,0
3,1,5,8,40.7,25.6,21.7,12,692677,353744,230917,44855,3026,183036,108016,30614,22626,11555,7543,1465,99,5979,3528,414824,295926,79109,56361,22748,39789,14656,25133,12811,10901,1910,276,1634,32380,27147,15381,0
3,1,7,8,29.7,32,25.7,12.5,1078503,584841,329242,43763,3090,282389,164420,40290,26769,14516,8172,1086,77,7009,4081,700782,508455,124841,87231,37610,67486,-484,67970,22312,17195,5117,494,4623,31408,29570,14703,0
3,1,3,2,17,27,29.2,26.8,1625830,1084940,264316,22270,3125,238921,276574,52772,30809,20559,5009,422,59,4527,5241,797072,546712,128828,88588,40240,121532,2732,118800,27936,20120,7816,415,7401,28532,27173,16052,0
3,1,6,3,21.5,22.7,24.7,31.1,1436162,858271,257747,17943,3231,236573,320144,45781,31370,18747,5630,392,71,5167,6993,982529,709095,181737,130431,51306,91697,1089,90608,27268,21427,5841,409,5432,36032,33094,16680,11
3,1,7,8,31.9,34.8,21.5,11.7,955897,502052,304251,25182,3265,275804,149594,36793,25980,13645,8269,684,89,7496,4066,609493,453496,108009,74142,33867,47988,660,47328,17141,14115,3026,454,2572,35558,32129,18401,0
3,1,7,8,34.1,31.5,25.6,8.8,638479,362748,187691,11807,3290,172594,88040,23412,27271,15494,8017,504,141,7372,3760,259219,192395,48208,34040,14168,18616,5283,13333,7990,6323,1667,411,1256,32443,30428,10615,2
3,1,5,8,38.1,25.7,20.4,15.9,882072,412653,279184,46715,3369,229100,190235,33329,26466,12381,8377,1402,101,6874,5708,691785,519616,133116,94215,38901,39053,-8575,47628,19834,17305,2529,232,2297,34879,30027,20735,1
3,1,6,4,36.5,29.5,23.1,10.8,880657,502658,260710,36544,3449,220717,117289,34923,25217,14393,7465,1046,99,6320,3359,532518,364328,93329,66132,27197,74861,9233,65628,15503,11963,3540,629,2911,34349,30455,22545,0
3,1,1,1,39,32.5,19.4,9,939514,585142,249988,34709,3476,211803,104384,37351,25154,15666,6693,929,93,5671,2795,316300,223825,54457,37341,17116,38018,-1104,39122,11673,7209,4464,491,3973,27097,31048,9847,0
3,1,5,8,20,21.7,23.4,34.8,1279762,776617,245680,29270,3523,212887,257465,46470,27540,16712,5287,630,76,4581,5540,917897,674966,180785,131171,49614,62146,-506,62652,26629,22334,4295,373,3922,34470,30221,15975,10
3,1,5,8,34.7,24.3,22.1,18.8,972325,514985,304843,54398,3612,246833,152497,35032,27755,14700,8702,1553,103,7046,4353,535349,397550,103825,74120,29705,33974,3235,30739,16494,13654,2840,337,2503,32457,29116,12281,2
3,1,6,3,25.4,31.2,29.5,13.9,1685342,1035609,411920,36920,3973,371027,237813,56538,29809,18317,7286,653,70,6562,4206,534812,348390,91280,65872,25408,95142,-373,95515,18669,11955,6714,731,5983,28647,29142,15964,5
3,1,4,5,23,26.5,29.7,20.8,1639216,1010939,339591,43655,4227,291709,288686,48457,33828,20863,7008,901,87,6020,5958,1293178,995511,239427,166985,72442,58240,3031,55209,30558,25689,4869,217,4652,42319,38752,11868,0
3,1,7,9,34.5,32.4,22.2,10.9,1007931,559231,290961,27743,4284,258934,157739,37453,26912,14932,7769,741,114,6914,4212,514092,365208,94633,66778,27855,54251,8024,46227,14241,10942,3299,616,2683,36099,33377,17230,2
3,1,4,5,26.1,32.2,27.6,14,2153313,1221090,574008,47702,4475,521831,358215,67318,31987,18139,8527,709,66,7752,5321,1593985,1143899,279771,199075,80696,170315,23881,146434,39337,32856,6481,869,5612,40521,34816,26093,1
3,1,5,8,24.5,29.8,25.2,20.5,1827865,1086280,399675,49352,5550,344773,341910,59160,30897,18362,6756,834,94,5828,5779,1373414,1074189,261924,181727,80197,37301,-479,37780,34857,29211,5646,396,5250,39401,36773,7196,1
3,1,3,2,20.7,27.9,28.6,22.8,2226967,1249782,528158,54959,5864,467335,449027,74196,30015,16844,7118,741,79,6299,6052,1995889,1427987,350678,248068,102610,217224,3232,213992,48071,41296,6775,329,6446,41520,34579,33198,4
3,1,5,8,33.5,28.7,21.4,16.4,1496537,810151,448852,91200,6041,351611,237534,52236,28650,15509,8593,1746,116,6731,4547,930418,683483,165972,115117,50855,80963,16526,64437,26016,22033,3983,250,3733,35763,31021,17261,6
3,1,5,8,25.1,28.1,30.6,16.2,2506798,1460345,596476,67053,6448,522975,449977,79665,31467,18331,7487,842,81,6565,5648,1923657,1416729,346112,238211,107901,160816,-537,161353,47435,41163,6272,339,5933,40554,34418,27196,3
3,1,2,2,18.2,27.4,30.6,23.8,5149319,3535750,812462,56558,8544,747360,801107,139136,37009,25412,5839,406,61,5371,5758,3176888,2294626,502723,337494,165229,379539,23277,356262,81228,63786,17442,647,16795,39111,35974,21212,4
3,1,3,2,19,32.1,32.4,16.5,4688439,2995482,853905,73554,9872,770479,839052,137791,34026,21739,6197,534,72,5592,6089,3385795,2518908,668124,485098,183026,198763,-4093,202856,68406,56867,11539,387,11152,49496,44295,18190,6
3,1,5,8,25.3,28.2,28.4,18.1,2610061,1643421,536127,52753,9936,473438,430513,81501,32025,20164,6578,647,122,5809,5282,2489634,1882038,420940,282246,138694,186656,8500,178156,63220,54332,8888,491,8397,39380,34640,21217,1
3,1,1,1,18.4,34.1,33.2,14.3,5160864,3865488,701030,59263,10301,631466,594346,156214,33037,24745,4488,379,66,4042,3805,2242740,1611965,357060,237359,119701,273715,1072,272643,67689,51046,16643,407,16236,33133,31579,16792,9
3,1,3,2,19.7,28.4,33.5,18.4,6164820,3513065,1175943,111117,13244,1051582,1475812,182735,33736,19225,6435,608,72,5755,8076,5067430,3872024,971645,683209,288436,223761,-2472,226233,122012,103607,18405,305,18100,41532,37372,12499,10
3,1,2,2,19.6,21.9,31.3,27.2,8581936,5200960,1666219,255731,20255,1390233,1714757,244695,35072,21255,6809,1045,83,5681,7008,8123409,5702350,1321954,910586,411368,1099105,813,1098292,173417,143402,30015,870,29145,46843,39765,37684,4
4,1,3,2,35.2,34.9,19.4,10.5,248314,107672,84797,16498,2006,66293,55845,9182,27044,11726,9235,1797,218,7220,6082,111521,74553,24568,18895,5673,12400,8251,4149,3432,2423,1009,268,741,32494,30769,5599,0
4,1,9,10,35,34.7,20.6,9.6,357289,177910,127643,15827,2254,109562,51736,13976,25564,12730,9133,1132,161,7839,3702,228857,170876,39779,27844,11935,18202,2060,16142,5379,4117,1262,234,1028,42546,41505,15702,0
4,1,8,6,35.2,31.1,21.2,12.4,346492,173618,122031,23826,2691,95514,50843,13746,25207,12630,8878,1733,196,6948,3699,173572,115779,33745,25270,8475,24048,18357,5691,5349,3829,1520,375,1145,32449,30237,4970,0
4,1,8,6,37.6,30.4,22,10,263516,115130,112967,23908,3030,86029,35419,10690,24651,10770,10568,2236,283,8048,3313,116314,72095,21513,15822,5691,22706,5352,17354,3981,2768,1213,337,876,29217,26046,19811,0
4,1,7,11,28.1,37.4,22.5,12.1,618986,322979,195546,29857,5092,160597,100461,21170,29239,15256,9237,1410,241,7586,4745,346327,246020,66319,48227,18092,33988,7785,26203,10056,7657,2399,460,1939,34440,32130,13514,0
4,1,8,6,30.3,37.8,22.1,9.8,564416,294183,185036,23543,5096,156397,85197,19814,28486,14847,9339,1188,257,7893,4300,187649,115828,33279,24473,8806,38542,19594,18948,6023,4084,1939,410,1529,31155,28361,12392,0
4,1,3,2,34.8,35.9,21.2,8.1,458601,243960,143484,23249,5271,114964,71157,16025,28618,15224,8954,1451,329,7174,4440,152753,99338,28500,20862,7638,24915,13188,11727,5124,3387,1737,403,1334,29811,29329,8791,1
4,1,9,10,34.9,37.5,19.8,7.8,372594,177916,139424,12794,5649,120981,55254,14689,25366,12112,9492,871,385,8236,3762,150630,107314,29936,21680,8256,13380,3203,10177,5336,3538,1798,354,1444,28229,30332,7048,0
4,1,8,7,40.5,30.3,19.2,10.1,287606,121225,124905,28610,5864,90431,41476,11870,24230,10213,10523,2410,494,7618,3494,170541,112373,28969,20962,8007,29199,8123,21076,4548,3008,1540,307,1233,37498,37358,17093,0
4,1,1,1,36.8,35.7,20.4,7.1,545746,321854,161295,19417,6202,135676,62597,22941,23789,14030,7031,846,270,5914,2729,206852,143996,40422,29693,10729,22434,2514,19920,6304,4551,1753,178,1575,32813,31641,12648,0
4,1,7,11,29.2,37.7,21.1,12.1,713704,371568,227849,32705,10092,185052,114287,26038,27410,14270,8751,1256,388,7107,4389,412551,297140,79205,56979,22226,36206,4021,32185,12426,9326,3100,270,2830,33201,31861,11373,0
4,1,7,11,32.1,34.4,21.7,11.8,614144,320232,198400,27422,10128,160850,95512,23218,26451,13792,8545,1181,436,6928,4114,367218,278000,69885,49191,20694,19333,710,18623,10110,7758,2352,444,1908,36322,35834,9760,0
4,1,8,4,36.8,32.9,22.3,8,771179,395253,253755,25560,10418,217777,122171,30646,25164,12897,8280,834,340,7106,3987,445103,313468,85309,61276,24033,46326,12286,34040,13360,10420,2940,678,2262,33316,30083,15049,0
4,1,6,4,37.4,34.3,20.1,8.3,664946,334406,223982,20715,10694,192573,106558,24691,26931,13544,9071,839,433,7799,4316,327272,215591,58126,40973,17153,53555,6503,47052,10708,7456,3252,527,2725,30563,28915,17267,0
4,1,3,2,26.7,33.9,25.3,14.1,1661254,929678,479492,43751,14152,421589,252084,54426,30523,17082,8810,804,260,7746,4632,1172351,850156,226858,161328,65530,95337,8617,86720,28733,23003,5730,638,5092,40802,36958,17031,1
4,1,6,3,29.6,32,26.5,11.9,2402760,1407231,628715,55851,19810,553054,366814,80351,29903,17514,7825,695,247,6883,4565,1292883,891145,229800,163275,66525,171938,28488,143450,38426,27940,10486,2042,8444,33646,31895,16988,5
4,1,3,2,23.6,34.1,23.8,18.5,2744942,1535274,695076,59543,21308,614225,514592,92526,29667,16593,7512,644,230,6638,5562,1387893,970847,255880,182830,73050,161166,12980,148186,43682,33172,10510,1445,9065,31773,29267,16347,1
4,1,4,5,18,29.6,29.3,23.1,6224967,3625210,1255988,92244,34628,1129116,1343769,179406,34698,20207,7001,514,193,6294,7490,2721074,1999571,478837,330994,147843,242666,945,241721,89324,64680,24644,922,23722,30463,30915,10190,6
4,1,3,2,21.2,28.4,26.4,24,6080771,3551682,1317079,142171,37999,1136909,1212010,192792,31541,18422,6832,737,197,5897,6287,4551365,3412167,896414,650683,245731,242784,2785,239999,107440,90253,17187,490,16697,42362,37807,14374,3
4,1,2,2,23.3,31.9,26.2,18.6,12592489,7684564,2963955,432848,91966,2439141,1943970,411994,30565,18652,7194,1051,223,5920,4718,9557729,7177450,1713825,1192678,521147,666454,19045,647409,225897,183314,42583,680,41903,42310,39154,15450,19
4,1,1,1,19.1,27.9,28.4,24.6,26524095,16647785,4737926,583040,171021,3983865,5138384,658441,40283,25284,7196,885,260,6050,7804,23376089,16846178,3820740,2615720,1205020,2709171,-2435,2711606,443314,368667,74647,387,74260,52730,45695,36515,43
4,1,6,7,31.7,36.4,19.5,12.4,310902,150479,77818,8471,1370,67977,82605,11515,27000,13068,6758,736,119,5903,7174,152591,105268,29290,21843,7447,18033,0,18033,5224,3391,1833,0,1833,29210,31043,9838,2
4,1,6,6,27.4,37.1,25.3,10.1,392064,198613,110744,9897,3394,97453,82707,15933,24607,12466,6951,621,213,6116,5191,178778,132515,39380,29985,9395,6883,0,6883,5434,3904,1530,0,1530,32900,33943,4499,0
4,1,6,6,24,32.3,27.4,16.2,1984122,1032712,354578,30086,13206,311286,596832,54534,36383,18937,6502,552,242,5708,10944,880501,639530,152250,105284,46966,88721,2926,85795,29203,19874,9329,652,8677,30151,32179,9888,7
4,1,4,3,15.1,28.9,30.5,25.5,4207740,1762427,463488,35208,18143,410137,1981825,72627,57936,24267,6382,485,250,5647,27288,2003669,1501571,345421,234393,111028,156677,0,156677,52674,37690,14984,0,14984,38039,39840,10456,11
4,1,2,2,14.6,29.2,33.4,22.9,5292233,3345943,938018,75333,31749,830936,1008272,149544,35389,22374,6273,504,212,5556,6742,1766152,1232064,325412,233805,91607,208676,2091,206585,50860,34524,16336,553,15783,34726,35687,13089,19
4,1,3,2,12,27.1,36.6,24.2,7056214,3933227,1252249,97200,36712,1118337,1870738,181153,38952,21712,6913,537,203,6173,10327,5362235,4066391,1137652,817550,320102,158192,-2072,160264,117653,96109,21544,473,21071,45577,42310,7606,4
4,1,3,2,19,30.6,32.7,17.7,5923569,3424220,1263422,121384,48161,1093877,1235927,167464,35372,20447,7544,725,288,6532,7380,3978507,2918768,751560,534015,217545,308179,-56,308235,96101,78081,18020,109,17911,41399,37381,17209,13
4,1,2,2,17.9,28.3,32.7,21,9828892,5524432,2289279,257429,69424,1962426,2015181,297015,33092,18600,7708,867,234,6607,6785,7461533,5589969,1473679,1051737,421942,397885,-4833,402718,167009,139558,27451,654,26797,44677,40055,15028,10
4,1,2,2,18.2,26.2,27.6,27.9,18245590,6392163,2371485,151449,96657,2123379,9481942,318485,57289,20071,7446,476,303,6667,29772,6914321,5037850,1031894,678466,353428,844577,58057,786520,169935,120794,49141,242,48899,40688,41706,16085,39
4,1,1,1,18,28.4,29.1,24.5,66417531,40860378,11316138,1093975,599346,9622817,14241015,1733310,38318,23574,6529,631,346,5552,8216,43013891,32994246,7057745,4737480,2320265,2961900,842,2961058,974057,739449,234608,373,234235,44160,44620,12641,260
4,1,1,1,32.1,22.3,23.9,21.7,85727172,48253099,19125302,2721196,893556,15510550,18348771,2463943,34793,19584,7762,1104,363,6295,7447,61663967,48084376,10528690,7178181,3350509,3050901,87723,2963178,1401524,1033789,367735,1940,365795,43998,46513,8101,182
4,1,9,10,36.8,31.5,16.9,14.8,174602,85099,50709,8587,1256,40866,38794,5311,32876,16023,9548,1617,236,7695,7304,91104,48084,13450,10382,3068,29570,24794,4776,2258,1586,672,209,463,40347,30318,10315,0
4,1,6,7,32.6,41.8,16.9,8.7,238156,127942,76942,10847,1680,64415,33272,9117,26122,14033,8439,1190,184,7065,3649,123296,83552,22033,16658,5375,17711,-69,17780,3565,2560,1005,212,793,34585,32637,22421,0
4,1,2,2,46.7,24,18.7,10.6,433796,279025,74444,6874,1787,65783,80327,15639,27738,17842,4760,440,114,4206,5136,379051,273550,77918,64634,13284,27583,5249,22334,7054,5665,1389,143,1246,53736,48288,17925,1
4,1,7,9,42.1,31.2,14.3,12.3,210720,97204,82514,15378,1943,65193,31002,7862,26802,12364,10495,1956,247,8292,3943,105198,66695,19522,15668,3854,18981,16404,2577,3052,2376,676,190,486,34469,28070,5302,0
4,1,9,10,38.6,36.7,15.3,9.4,276717,150134,92927,11428,2196,79303,33656,10471,26427,14338,8875,1091,210,7574,3214,137006,73244,21221,16654,4567,42541,9814,32727,4194,2829,1365,448,917,32667,25890,35689,0
4,1,6,6,31.5,38.5,18.8,11.2,405672,233449,122646,9022,2205,111419,49577,14717,27565,15863,8334,613,150,7571,3369,196547,136937,37918,30102,7816,21692,1388,20304,5585,4272,1313,156,1157,35192,32055,17549,1
4,1,8,7,34.6,38.6,18,8.8,306248,168992,101669,9687,2223,89759,35587,10185,30069,16592,9982,951,218,8813,3494,119330,83736,23981,18853,5128,11613,-391,12004,3968,2896,1072,255,817,30073,28914,14693,1
4,1,7,8,36.6,33.7,18.7,11,308662,167005,105099,20187,2272,82640,36558,12040,25636,13871,8729,1677,189,6864,3036,179946,110774,33615,26888,6727,35557,22265,13292,5086,4022,1064,258,806,35381,27542,16491,0
4,1,6,5,26.4,39.7,21,12.9,467836,266053,141272,13525,2580,125167,60511,16118,29026,16507,8765,839,160,7766,3754,213735,134948,34786,26974,7812,44001,3288,40713,5109,3846,1263,173,1090,41835,35088,37351,1
4,1,1,1,31.3,34.2,23.7,10.8,927040,630225,135129,15193,2622,117314,161686,22730,40785,27727,5945,668,115,5161,7113,1204512,871353,214164,158714,55450,118995,7265,111730,19293,16114,3179,124,3055,62433,54074,36573,0
4,1,6,6,34.6,40,16,9.4,422391,238041,132808,14491,2893,115424,51542,15393,27440,15464,8628,941,188,7498,3348,261399,173929,44520,32856,11664,42950,1607,41343,6730,5577,1153,142,1011,38841,31187,40893,0
4,1,7,9,34.3,35.2,18.1,12.4,470084,253102,139494,17987,3171,118336,77488,17230,27283,14690,8096,1044,184,6868,4497,237970,155861,42236,33366,8870,39873,17019,22854,5857,4448,1409,219,1190,40630,35041,19205,0
4,1,2,2,30.9,39.1,17.3,12.8,784317,489443,177141,22148,3355,151638,117733,22847,34329,21423,7753,969,147,6637,5153,329970,215912,57713,43000,14713,56345,13826,42519,9168,6337,2831,359,2472,35991,34072,17200,0
4,1,3,2,26.9,41.6,21.7,9.8,568921,347270,155316,18677,3524,133115,66335,22069,25779,15736,7038,846,160,6032,3006,189303,123752,40097,31889,8208,25454,1554,23900,5446,3695,1751,216,1535,34760,33492,15570,0
4,1,2,2,26.6,40.6,21.7,11.1,859702,616541,153447,19518,3635,130294,89714,23352,36815,26402,6571,836,156,5580,3842,695155,508412,125002,91588,33414,61741,-14,61755,14514,12039,2475,101,2374,47895,42230,26013,0
4,1,9,10,40.5,34.8,15.2,9.5,291517,148348,109868,11653,3737,94478,33301,11633,25059,12752,9445,1002,321,8122,2863,126112,80931,22880,18065,4815,22301,9352,12949,4322,2654,1668,788,880,29179,30494,14715,0
4,1,6,6,29.2,40.9,18.8,11.1,657314,365220,202444,18485,3879,180080,89650,24199,27163,15092,8366,764,160,7442,3705,298332,180853,48903,37724,11179,68576,21438,47138,8295,5976,2319,323,1996,35965,30263,23616,0
4,1,6,5,40.6,36.9,15.1,7.4,752144,494158,170430,21847,4188,144395,87556,23508,31995,21021,7250,929,178,6142,3725,285758,185792,45831,33970,11861,54135,2384,51751,6954,5045,1909,64,1845,41093,36827,28049,0
4,1,7,8,35.4,34.5,20.6,9.6,637558,363505,180033,26824,4192,149017,94020,20726,30761,17539,8686,1294,202,7190,4536,351589,179777,49406,38629,10777,122406,8609,113797,8281,6119,2162,395,1767,42457,29380,64401,0
4,1,6,5,30.6,41.2,18.3,9.9,988695,600655,241206,24174,4311,212721,146834,31530,31357,19050,7650,767,137,6747,4657,467528,309249,79325,60199,19126,78954,35329,43625,12358,9506,2852,573,2279,37832,32532,19142,0
4,1,7,11,38.6,36.5,15.1,9.8,556413,287904,203104,26124,4323,172657,65405,20677,26910,13924,9823,1263,209,8350,3163,259966,155783,45132,35591,9541,59051,32027,27024,8687,5935,2752,955,1797,29926,26248,15038,0
4,1,6,4,26.1,45.2,18.7,10.1,806386,576817,152088,20253,4360,127475,77481,22231,36273,25947,6841,911,196,5734,3485,621575,432394,126873,100216,26657,62308,1286,61022,10168,8303,1865,41,1824,61131,52077,33455,0
4,1,6,6,36.8,38,16,9.3,695750,423319,185302,19763,4433,161106,87129,25863,26901,16368,7165,764,171,6229,3369,442648,325097,87282,69005,18277,30269,4425,25844,11203,9418,1785,353,1432,39512,34519,18047,0
4,1,6,6,38.1,32.1,16.9,12.8,612788,349266,193226,24977,4455,163794,70296,20664,29655,16902,9351,1209,216,7927,3402,296580,189591,51650,39237,12413,55339,12588,42751,9176,6604,2572,684,1888,32321,28709,22644,0
4,1,2,2,29.7,40.6,19.4,10.2,836455,494558,212614,27737,4928,179949,129283,26413,31668,18724,8050,1050,187,6813,4895,353037,251570,63084,48284,14800,38383,-5216,43599,9413,6560,2853,553,2300,37505,38349,18956,1
4,1,6,6,44.5,30.6,15.4,9.5,1034393,593806,312982,41257,5071,266654,127605,34078,30354,17425,9184,1211,149,7825,3744,431667,275828,76035,58803,17232,79804,26172,53632,11842,8822,3020,645,2375,36452,31266,22582,1
4,1,3,2,28.3,40.1,19.8,11.8,677784,402541,189510,20230,5575,163705,85733,22609,29979,17804,8382,895,247,7241,3792,221265,139997,40003,30889,9114,41265,18667,22598,7625,5073,2552,369,2183,29018,27596,10352,0
4,1,1,1,26.9,37.9,26.2,8.9,1016190,604314,196935,28864,5797,162274,214941,32878,30908,18380,5990,878,176,4936,6538,671615,482555,137473,108119,29354,51587,4769,46818,14147,10752,3395,33,3362,47474,44880,13926,1
4,1,2,2,34.3,38.9,17.2,9.6,1048308,659920,248289,36000,5966,206323,140099,33393,31393,19762,7435,1078,179,6179,4195,978799,749487,190205,145018,45187,39107,3250,35857,17522,14715,2807,136,2671,55861,50934,13425,0
4,1,6,6,40.2,37,14.5,8.3,1248061,697332,383341,51144,6221,325976,167388,42034,29692,16590,9120,1217,148,7755,3982,518613,340977,94769,75334,19435,82867,12995,69872,16454,12262,4192,794,3398,31519,27808,20563,0
4,1,6,3,31.8,40.2,17.1,10.9,1307680,672195,465560,57054,7016,401490,169925,47262,27669,14223,9851,1207,148,8495,3595,529002,376360,105286,84460,20826,47356,-3123,50479,16776,11526,5250,751,4499,31533,32653,11220,2
4,1,6,5,27.3,32.1,22.2,18.4,1174773,699813,309076,46326,7105,255645,165884,39425,29798,17750,7840,1175,180,6484,4208,708347,465444,128094,101200,26894,114809,13034,101775,18932,14866,4066,506,3560,37415,31309,28588,0
4,1,4,5,19.6,24.7,23.9,31.8,1377601,772572,317765,35635,7478,274652,287264,46270,29773,16697,6868,770,162,5936,6208,952787,658873,168846,129899,38947,125068,15779,109289,25212,19876,5336,280,5056,37791,33149,21616,4
4,1,1,1,20,36.1,26.4,17.5,2088308,1519304,295102,35323,7817,251962,273902,52719,39612,28819,5598,670,148,4779,5196,1944674,1438685,378245,289508,88737,127744,-442,128186,31190,25497,5693,52,5641,62349,56426,22724,4
4,1,4,5,34.4,38,16.9,10.7,1878601,1219833,388013,42610,8142,337261,270755,57684,32567,21147,6727,739,141,5847,4694,874054,582317,138287,102490,35797,153450,46519,106931,21993,15317,6676,1025,5651,39742,38018,18922,2
4,1,4,5,19.9,36.4,30.2,13.5,1739194,1120595,311256,36886,8287,266083,307343,50903,34167,22014,6115,725,163,5227,6038,1485617,1065935,373689,284257,89432,45993,-2480,48473,27483,24295,3188,425,2763,54056,43875,17544,1
4,1,4,5,35.3,38,17.2,9.4,1913596,1199983,461574,56060,8511,397003,252039,61451,31140,19527,7511,912,139,6460,4101,873002,561378,138229,103105,35124,173395,50588,122807,23131,16753,6378,742,5636,37742,33509,21790,3
4,1,4,5,34.1,38.3,18.2,9.4,1877477,1142936,411617,56147,8760,346710,322924,54551,34417,20952,7546,1029,161,6356,5920,1665373,1258137,275824,197716,78108,131412,-678,132090,33629,28218,5411,99,5312,49522,44586,24866,1
4,1,6,5,29.2,35.9,22.3,12.6,1276141,723124,372272,41159,8812,322301,180745,41131,31026,17581,9051,1001,214,7836,4394,667525,479290,116349,85625,30724,71886,-1130,73016,18172,13780,4392,382,4010,36734,34782,18208,1
4,1,1,1,23.1,38.9,25,12.9,1550207,1090025,310297,48750,8909,252638,149885,46336,33456,23524,6697,1052,192,5452,3235,1076772,738362,203439,156814,46625,134971,768,134203,21505,16257,5248,18,5230,50071,45418,25660,1
4,1,6,5,33.4,38.8,18.1,9.7,849081,460945,286844,44275,9287,233282,101292,28147,30166,16376,10191,1573,330,8288,3599,382976,240453,59408,44929,14479,83115,46812,36303,10446,7458,2988,374,2614,36662,32241,13888,0
4,1,3,2,33.7,38,16,12.4,3817705,2478991,627210,66158,11097,549955,711504,96080,39735,25801,6528,689,115,5724,7405,2546466,1826272,423535,312422,111113,296659,14389,282270,50283,40227,10056,350,9706,50643,45399,29082,7
4,1,4,5,33.1,38.5,17.2,11.2,2510467,1573031,547009,75920,11862,459227,390427,73372,34216,21439,7455,1035,162,6259,5321,2014818,1498049,315946,220460,95486,200823,-800,201623,43106,35074,8032,247,7785,46741,42711,25899,5
4,1,3,2,32.9,35.8,19,12.3,4231820,2852581,725999,87965,13137,624897,653240,111689,37889,25540,6500,788,118,5595,5849,3478763,2591605,547240,383380,163860,339918,8048,331870,69456,57939,11517,136,11381,50086,44730,29160,15
4,1,4,5,38,33.3,18,10.7,2709588,1596446,780947,107589,14311,659047,332195,83825,32324,19045,9316,1283,171,7862,3963,1260047,876073,228833,175210,53623,155141,15339,139802,35870,26864,9006,1163,7843,35128,32611,17825,0
4,1,2,2,20.4,41.7,23.4,14.5,4066056,3098922,546258,57716,15367,473175,420876,105172,38661,29465,5194,549,146,4499,4002,2182198,1611057,382460,279530,102930,188681,889,187792,48247,36742,11505,227,11278,45230,43848,16651,8
4,1,2,2,17,32.5,32.4,18.1,4054590,2622707,767471,75967,16983,674521,664412,115187,35200,22769,6663,660,147,5856,5768,2507873,1831915,493280,362681,130599,182678,-682,183360,62659,50454,12205,407,11798,40024,36309,15542,7
4,1,2,2,22.8,43.2,22.6,11.4,4112040,2994916,707739,75803,18133,613803,409385,126230,32576,23726,5607,601,144,4863,3243,1155435,769388,194773,146829,47944,191274,-1131,192405,37481,23954,13527,391,13136,30827,32119,14647,4
4,1,3,2,25.4,33.8,24.3,16.5,4678078,2644246,1246041,128375,20070,1097596,787791,131095,35685,20170,9505,979,153,8373,6009,3243948,2348295,589108,438904,150204,306545,23551,282994,77450,64570,12880,773,12107,41884,36368,23374,4
4,1,4,3,28.5,34.3,21,16.3,3752529,2278424,982677,129704,20565,832408,491428,120009,31269,18985,8188,1081,171,6936,4095,2086462,1463446,388749,303241,85508,234267,63,234204,59761,45059,14702,992,13710,34913,32478,17083,1
4,1,3,2,21.4,30,25.9,22.7,4977911,2944877,1175081,167316,25368,982397,857953,153058,32523,19240,7677,1093,166,6418,5605,3601492,2593885,620775,458912,161863,386832,8048,378784,92814,73231,19583,392,19191,38803,35421,19738,4
4,1,3,2,20.2,29,25.4,25.5,9042116,5961022,1257407,141558,28698,1087151,1823687,219466,41201,27161,5729,645,131,4954,8310,8204658,6047967,1248423,864079,384344,908268,-1204,909472,171268,138658,32610,575,32035,47905,43618,28390,40
4,1,3,2,23,34.6,25.6,16.9,6468157,4101474,1317865,142831,29397,1145637,1048818,191080,33851,21465,6897,747,154,5996,5489,4879936,3576006,906062,681608,224454,397868,1142,396726,108791,89772,19019,801,18218,44856,39834,21777,8
4,1,1,1,16.1,26.5,29,28.3,10396885,7060392,1487924,112814,29520,1345590,1848569,231224,44965,30535,6435,488,128,5819,7995,4701814,3056994,696840,506114,190726,947980,755,947225,117468,80452,37016,508,36508,40026,37998,25946,19
4,1,2,2,21.3,32.2,25.9,20.6,9793652,5893266,2000502,271697,47453,1681352,1899884,253245,38673,23271,7899,1073,187,6639,7502,7588619,5062346,1219238,894156,325082,1307035,-155,1307190,162007,129309,32698,523,32175,46841,39149,40628,12
4,1,1,1,25.3,23.4,25.5,25.8,13708627,8151035,2218827,377320,59079,1782428,3338765,327803,41820,24866,6769,1151,180,5437,10185,13009176,9370421,2105136,1511101,594035,1533619,0,1533619,235208,191581,43627,0,43627,55309,48911,35153,11
4,1,1,1,20.7,30,27.8,21.5,17612739,11571912,2986886,300180,67267,2619439,3053941,431921,40778,26792,6915,695,156,6065,7071,13027898,9038600,1907723,1328889,578834,2081575,353,2081222,266373,208530,57843,52,57791,48908,43344,36013,50
4,1,2,2,16.1,26.4,26.7,30.8,17181191,11384327,2821785,380371,68164,2373250,2975079,437623,39260,26014,6448,869,156,5423,6798,16385920,12173978,2788281,2050167,738114,1423661,-641,1424302,333872,276192,57680,407,57273,49078,44078,24869,29
4,1,9,10,41.2,31.2,20.5,7.1,31602,17525,8476,1718,389,6369,5601,1443,21900,12145,5874,1191,270,4414,3881,11915,9133,2485,1737,748,297,-777,1074,515,381,134,68,66,23136,23971,16273,0
4,1,9,10,39.4,28.8,19.2,12.6,112688,36757,54157,10592,1380,42185,21774,5076,22200,7241,10669,2087,272,8311,4290,37787,37914,9983,7068,2915,-10110,-13957,3847,1953,1487,466,89,377,19348,25497,10204,0
4,1,9,10,32.5,33.8,23.2,10.5,213714,110821,74709,7906,1706,65097,28184,8112,26345,13661,9210,975,210,8025,3474,84102,57199,15897,11651,4246,11006,2409,8597,2643,1807,836,165,671,31821,31654,12812,0
4,1,9,10,34.9,32.7,21.2,11.2,200111,101413,69908,8038,2064,59806,28790,8576,23334,11825,8152,937,241,6974,3357,98630,69064,19293,14026,5267,10273,2207,8066,3102,2201,901,234,667,31796,31378,12093,0
4,1,8,4,41.2,32.2,18.8,7.8,192749,101874,70209,9307,2074,58828,20666,8689,22183,11724,8080,1071,239,6770,2378,50552,34231,9292,6684,2608,7029,799,6230,2044,1192,852,267,585,24732,28717,10650,0
4,1,8,7,41.9,33.1,15.1,10,236432,117005,83513,13209,2164,68140,35914,9994,23657,11708,8356,1322,217,6818,3594,102006,74136,18160,12367,5793,9710,302,9408,3600,2579,1021,156,865,28335,28746,10876,1
4,1,9,10,32.3,33.9,20.7,13,291928,144686,106370,10695,2378,93297,40872,10164,28722,14235,10465,1052,234,9179,4021,99620,63382,16688,11751,4937,19550,2483,17067,4174,2340,1834,328,1506,23867,27086,11333,0
4,1,9,8,39.5,28.3,21.9,10.3,231109,104612,92677,10817,2455,79405,33820,10526,21956,9938,8805,1028,233,7544,3213,76932,54909,16850,12617,4233,5173,2961,2212,3001,2120,881,373,508,25635,25900,4354,0
4,1,9,8,33.4,34.7,21,10.9,277459,151094,87400,10127,2575,74698,38965,10604,26166,14249,8242,955,243,7044,3675,51204,36639,9959,7110,2849,4606,-8068,12674,2706,1396,1310,461,849,18922,26246,14928,0
4,1,3,2,28,38.1,26.2,7.7,309601,168812,103458,12507,2688,88263,37331,12206,25365,13830,8476,1025,220,7231,3058,127743,95357,21161,14580,6581,11225,1193,10032,3519,2518,1001,291,710,36301,37870,14130,0
4,1,8,5,32.8,35.6,22.2,9.4,329924,172795,114520,14024,2715,97781,42609,13171,25049,13119,8695,1065,206,7424,3235,94588,60997,15703,11116,4587,17888,8537,9351,3639,2257,1382,511,871,25993,27026,10736,0
4,1,8,7,33.6,34.9,21.2,10.4,310385,162601,109631,17399,2757,89475,38153,12553,24726,12953,8733,1386,220,7128,3039,121097,87046,19799,13622,6177,14252,6172,8080,3634,2424,1210,339,871,33323,35910,9277,1
4,1,8,7,32.6,38,21.4,8,300210,173558,91909,10155,2857,78897,34743,14449,20777,12012,6361,703,198,5460,2405,98298,65683,19182,14310,4872,13433,3905,9528,3402,2326,1076,346,730,28894,28239,13052,0
4,1,8,7,29.2,38.3,23.3,9.1,441270,267915,125029,14978,2919,107132,48326,16520,26711,16218,7568,907,177,6485,2925,199220,102448,27863,20099,7764,68909,49643,19266,5249,3335,1914,619,1295,37954,30719,14877,0
4,1,8,7,27.1,34.2,26.8,12,358226,194123,123223,12991,2928,107304,40880,13054,27442,14871,9439,995,224,8220,3132,172083,114252,27596,19530,8066,30235,15095,15140,4454,3085,1369,380,989,38636,37035,15308,0
4,1,3,2,25.2,30.2,32.2,12.4,462590,249780,145763,13664,3121,128978,67047,17408,26573,14349,8373,785,179,7409,3852,163956,133586,34287,24271,10016,-3917,-418,-3499,6485,4537,1948,256,1692,25282,29444,-2068,0
4,1,1,1,39.5,30.2,21.3,9.1,292090,163127,85165,19767,3151,62247,43798,10862,26891,15018,7841,1820,290,5731,4032,513878,420257,70776,39137,31639,22845,17084,5761,14240,13296,944,78,866,36087,31608,6652,0
4,1,7,9,37.9,32,19.1,11,289167,141696,106618,12032,3173,91413,40853,10948,26413,12943,9739,1099,290,8350,3732,110019,75448,20316,14587,5729,14255,1073,13182,4070,2963,1107,303,804,27032,25463,16396,1
4,1,9,10,33,34,22.5,10.4,360215,179087,133908,17772,3266,112870,47220,15505,23232,11550,8636,1146,211,7280,3045,136302,86814,22479,15824,6655,27009,8739,18270,5091,3168,1923,626,1297,26773,27403,14086,0
4,1,7,10,45.6,24.2,19.2,10.9,335386,182096,110607,20711,3359,86537,42683,15266,21969,11928,7245,1357,220,5669,2796,146216,85224,21958,15330,6628,39034,22210,16824,4465,3254,1211,409,802,32747,26191,20978,1
4,1,7,10,35.6,34.6,19.6,10.2,349692,167161,134262,15290,3402,115570,48269,14940,23406,11189,8987,1023,228,7736,3231,137576,101558,26500,18696,7804,9518,-6351,15869,5534,3776,1758,558,1200,24860,26896,13224,0
4,1,7,10,41.6,30.6,16.9,10.9,273164,131449,107716,21684,3477,82555,33999,11646,23456,11287,9249,1862,299,7089,2919,125775,76360,21144,15178,5966,28271,11823,16448,4325,2874,1451,500,951,29081,26569,17295,1
4,1,8,6,32.8,31.9,23.9,11.4,536390,300792,161312,20495,3599,137218,74286,19516,27485,15413,8266,1050,184,7031,3806,250959,161042,41435,29204,12231,48482,17937,30545,7838,5607,2231,479,1752,32018,28722,17434,0
4,1,9,8,31.2,36.8,22.3,9.6,471407,263275,153327,15149,3765,134413,54805,16671,28277,15792,9197,909,226,8063,3287,134866,96780,25595,18270,7325,12491,4484,8007,5022,3470,1552,311,1241,26855,27890,6452,1
4,1,9,8,33.3,34.5,22.4,9.8,489687,274329,146405,18131,3845,124429,68953,17344,28234,15817,8441,1045,222,7174,3976,216354,144747,37178,26303,10875,34429,18860,15569,6208,4542,1666,424,1242,34851,31869,12535,1
4,1,6,6,35.9,31.8,20.7,11.6,538308,305840,168724,22254,3972,142498,63744,23790,22627,12856,7092,935,167,5990,2679,278207,175979,46980,33014,13966,55248,33615,21633,8813,6662,2151,597,1554,31568,26415,13921,0
4,1,7,9,31,37.6,21.8,9.6,323244,150682,126204,15292,4020,106892,46358,12827,25200,11747,9839,1192,313,8333,3614,141704,94702,25637,18152,7485,21365,1128,20237,4785,3209,1576,318,1258,29614,29511,16087,0
4,1,7,9,35.3,34.8,20.4,9.5,555476,304991,164672,24775,4504,135393,85813,20763,26753,14689,7931,1193,217,6521,4133,277383,176368,45532,32252,13280,55483,31404,24079,7820,5866,1954,443,1511,35471,30066,15936,0
4,1,7,9,27.1,33.4,27.4,12.1,607030,328440,195161,20442,4603,170116,83429,21790,27858,15073,8956,938,211,7807,3829,272485,183972,49921,36005,13916,38592,20150,18442,8482,6518,1964,533,1431,32125,28225,12887,1
4,1,6,6,36.6,29.8,21.9,11.6,535380,305392,161317,20848,4718,135751,68671,19611,27300,15572,8226,1063,241,6922,3502,277266,157619,39715,27885,11830,79932,3249,76683,7239,5185,2054,443,1611,38302,30399,47600,0
4,1,3,2,30.2,38.7,21.9,9.1,614560,398376,144554,14017,4762,125775,71630,22280,27583,17880,6488,629,214,5645,3215,237673,175315,43393,30114,13279,18965,1488,17477,7446,5209,2237,517,1720,31920,33656,10161,0
4,1,8,6,35.4,36,20,8.7,485313,233804,173915,12727,4895,156293,77594,19552,24822,11958,8895,651,250,7994,3969,224154,162377,43527,31145,12382,18250,-494,18744,7117,5648,1469,284,1185,31496,28749,15818,2
4,1,7,9,40.6,30.4,19.5,9.5,441093,210364,153586,19236,4897,129453,77143,17439,25293,12063,8807,1103,281,7423,4424,219956,175247,44264,30267,13997,445,12883,-12438,8284,6041,2243,512,1731,26552,29010,-7185,0
4,1,2,2,31.2,35.3,22.6,10.9,791733,455161,247870,26789,4939,216142,88702,27512,28778,16544,9010,974,180,7856,3224,354444,210286,54373,38173,16200,89785,42261,47524,11093,8202,2891,581,2310,31952,25638,20573,0
4,1,6,6,33.5,33.4,21.6,11.5,669614,332820,236240,31069,5390,199781,100554,26979,24820,12336,8756,1152,200,7405,3727,371772,269088,63832,43680,20152,38852,13293,25559,11618,8733,2885,501,2384,32000,30813,10721,0
4,1,7,8,36.2,27.6,22.7,13.5,628611,331008,206661,25027,5590,176044,90942,22036,28527,15021,9378,1136,254,7989,4127,428686,308899,79075,55711,23364,40712,3546,37166,12459,10161,2298,287,2011,34408,30400,18481,1
4,1,7,8,34.1,31.5,25.6,8.8,600339,308728,209173,14536,5716,188921,82438,23329,25734,13234,8966,623,245,8098,3534,215389,176943,45304,32045,13259,-6858,4695,-11553,7439,5789,1650,406,1244,28954,30565,-9287,2
4,1,6,5,35,31,22.2,11.8,671794,334710,224975,39096,5902,179977,112109,28201,23822,11869,7978,1386,209,6382,3975,313410,228688,62792,45528,17264,21930,5122,16808,9863,6964,2899,538,2361,31776,32839,7119,0
4,1,5,8,26.6,31.7,24.2,17.5,909985,431967,300041,40157,6020,253864,177977,32305,28169,13372,9288,1243,186,7858,5509,530734,390223,90394,61533,28861,50117,3969,46148,16814,12783,4031,185,3846,31565,30527,11999,1
4,1,2,2,30.7,30.2,27.6,11.6,786731,443551,245564,37975,6087,201502,97616,29484,26683,15044,8329,1288,206,6834,3311,354363,242932,69112,50339,18773,42319,9443,32876,11736,8877,2859,507,2352,30195,27366,13978,0
4,1,5,8,37.8,21.5,24.5,16.2,732212,321143,280294,51112,6127,223055,130775,26257,27886,12231,10675,1947,233,8495,4981,400072,289360,68760,46909,21851,41952,13685,28267,11638,9406,2232,204,2028,34376,30763,13938,0
4,1,7,9,32.3,31.7,24.6,11.4,920902,548627,236300,28685,6276,201339,135975,29694,31013,18476,7958,966,211,6780,4579,685496,438654,103892,71742,32150,142950,35100,107850,16707,13958,2749,612,2137,41030,31427,50468,1
4,1,1,1,28.3,32.5,26.8,12.3,793883,489466,209566,22550,6310,180706,94851,28509,27847,17169,7351,791,221,6339,3327,272466,184557,48411,34308,14103,39498,3893,35605,9698,6235,3463,520,2943,28095,29600,12098,0
4,1,7,9,31.5,33.7,21.5,13.2,682191,382374,198858,19578,6409,172871,100959,27070,25201,14125,7346,723,237,6386,3730,398314,279789,69060,47490,21570,49465,3646,45819,12628,9185,3443,629,2814,31542,30462,16283,0
4,1,7,9,31.4,31.7,22.3,14.6,585190,324354,172157,25125,6493,140539,88679,20804,28129,15591,8275,1208,312,6755,4263,306848,193280,45057,30732,14325,68511,34080,34431,8065,6025,2040,397,1643,38047,32080,20956,1
4,1,7,9,31.8,33.3,21,13.8,496197,242475,173745,23295,6520,143930,79977,19211,25829,12622,9044,1213,339,7492,4163,210930,151528,38398,26906,11492,21004,7712,13292,7267,5243,2024,457,1567,29026,28901,8482,2
4,1,5,8,40.7,25.6,21.7,12,696648,348666,240453,50162,6604,183687,107529,29574,23556,11790,8131,1696,223,6211,3636,413096,297121,79955,57130,22825,36020,14511,21509,12542,10549,1993,274,1719,32937,28166,12513,0
4,1,7,9,34.5,35.9,20.6,9,554746,288496,189619,19918,6624,163077,76631,22171,25021,13012,8553,898,299,7355,3456,269271,191916,50706,35923,14783,26649,1264,25385,9096,6488,2608,592,2016,29603,29580,12592,0
4,1,6,6,40.3,26.7,21.9,11.2,448803,175899,218897,42432,6749,169716,54007,19461,23062,9039,11248,2180,347,8721,2775,163163,119377,31466,22343,9123,12320,-6441,18761,6536,4336,2200,460,1740,24964,27532,10782,0
4,1,6,5,28,31.6,28,12.4,1029232,616072,283191,30921,7098,245172,129969,34877,29510,17664,8120,887,204,7030,3726,552155,395263,92056,62706,29350,64836,9915,54921,16141,12362,3779,579,3200,34208,31974,17163,1
4,1,7,9,35.1,31.3,23.6,9.9,621495,329872,204129,19322,7210,177597,87494,25553,24322,12909,7988,756,282,6950,3424,300459,223535,58870,41586,17284,18054,1659,16395,9410,7839,1571,468,1103,31930,28516,14864,1
4,1,3,2,22.1,29.3,31.3,17.3,1410911,737184,293615,27327,7300,258988,380112,43471,32456,16958,6754,629,168,5958,8744,942179,718398,180026,124782,55244,43755,-1495,45250,20338,15734,4604,229,4375,46326,45659,10343,3
4,1,7,8,33.3,33.8,21.5,11.4,741270,446135,202285,21652,7478,173155,92850,29770,24900,14986,6795,727,251,5816,3119,430155,332252,80633,53728,26905,17270,977,16293,14590,11137,3453,774,2679,29483,29833,6082,2
4,1,7,8,29.7,32,25.7,12.5,1051858,547354,352387,51261,7791,293335,152117,40332,26080,13571,8737,1271,193,7273,3772,651682,463329,118116,83280,34836,70237,2439,67798,21500,16212,5288,481,4807,30311,28579,14104,1
4,1,5,8,34.7,24.3,22.1,18.8,979302,513261,317330,60714,7924,248692,148711,34450,28427,14899,9211,1762,230,7219,4317,548983,394939,103183,73275,29908,50861,11836,39025,16367,13347,3020,340,2680,33542,29590,14562,3
4,1,3,2,17,27,29.2,26.8,1668341,1100639,288369,27901,7964,252504,279333,54197,30783,20308,5321,515,147,4659,5154,785425,535646,127921,87925,39996,121858,5723,116135,27042,19081,7961,404,7557,29045,28072,15368,1
4,1,5,8,38.1,25.7,20.4,15.9,887381,410634,299688,53738,8359,237591,177059,32508,27297,12632,9219,1653,257,7309,5447,668908,495057,129584,91935,37649,44267,-6372,50639,18977,16303,2674,234,2440,35248,30366,20754,0
4,1,5,8,20,21.7,23.4,34.8,1262752,760407,263337,34265,8816,220256,239008,47400,26640,16042,5556,723,186,4647,5042,903097,658252,179444,130967,48477,65401,-230,65631,25854,21543,4311,367,3944,34931,30555,16641,8
4,1,1,1,39,32.5,19.4,9,913248,542341,272488,41441,8878,222169,98419,37231,24529,14567,7319,1113,238,5967,2643,312172,221244,55012,37799,17213,35916,377,35539,11447,6872,4575,494,4081,27271,32195,8708,2
4,1,7,8,31.9,34.8,21.5,11.7,968565,497468,325128,30616,9125,285387,145969,36868,26271,13493,8819,830,248,7741,3959,595401,441525,105146,71895,33251,48730,-423,49153,16581,13444,3137,452,2685,35909,32842,18307,0
4,1,6,4,36.5,29.5,23.1,10.8,875040,491208,274901,42485,9171,223245,108931,34768,25168,14128,7907,1222,264,6421,3133,519994,354288,93143,66125,27018,72563,10220,62343,15318,11546,3772,628,3144,33947,30685,19829,1
4,1,6,3,25.4,31.2,29.5,13.9,1678184,1005704,446197,45754,9589,390854,226283,56085,29922,17932,7956,816,171,6969,4035,522752,337947,90172,64993,25179,94633,651,93982,18210,11431,6779,723,6056,28707,29564,15519,3
4,1,6,3,21.5,22.7,24.7,31.1,1432923,836086,277246,21784,10267,245195,319591,46712,30676,17899,5935,466,220,5249,6842,954869,691319,175381,125149,50232,88169,2599,85570,26355,20476,5879,404,5475,36231,33762,15629,2
4,1,4,5,26.1,32.2,27.6,14,2127771,1182379,610066,57345,11126,541595,335326,67443,31549,17532,9046,850,165,8030,4972,1533082,1088235,280169,201588,78581,164678,30930,133748,37536,31027,6509,856,5653,40843,35074,23660,2
4,1,7,9,34.5,32.4,22.2,10.9,978775,525737,311250,31821,11275,268154,141788,37258,26270,14111,8354,854,303,7197,3806,483288,344819,90212,63405,26807,48257,4438,43819,13703,10415,3288,615,2673,35269,33108,16393,1
4,1,4,5,23,26.5,29.7,20.8,1569569,940173,365011,51304,11350,302357,264385,48548,32330,19366,7519,1057,234,6228,5446,1169670,901485,229531,161300,68231,38654,7433,31221,28701,23752,4949,210,4739,40754,37954,6588,4
4,1,5,8,24.5,29.8,25.2,20.5,1762061,1022743,427368,57293,13948,356127,311950,59663,29534,17142,7163,960,234,5969,5229,1323309,1047722,261877,182063,79814,13710,-233,13943,33767,27879,5888,385,5503,39189,37581,2534,2
4,1,3,2,20.7,27.9,28.6,22.8,2253763,1273820,570265,66814,14512,488939,409678,74863,30105,17015,7617,892,194,6531,5472,2028093,1435831,354252,250089,104163,238010,2654,235356,47820,40974,6846,325,6521,42411,35042,36092,4
4,1,5,8,33.5,28.7,21.4,16.4,1473942,781312,477382,102451,15046,359885,215248,51565,28584,15152,9258,1987,292,6979,4174,887724,641690,158982,110290,48692,87052,19017,68035,24819,20645,4174,242,3932,35768,31082,17303,13
4,1,5,8,25.1,28.1,30.6,16.2,2433147,1392460,624580,77861,15886,530833,416107,80275,30310,17346,7781,970,198,6613,5184,1835244,1335364,336334,232602,103732,163546,426,163120,44889,38559,6330,335,5995,40884,34632,27209,2
4,1,5,8,25.3,28.2,28.4,18.1,2559991,1594766,570557,64718,20548,485291,394668,82436,31054,19346,6921,785,249,5887,4788,2413285,1815826,408561,272850,135711,188898,3911,184987,60186,51312,8874,480,8394,40097,35388,22038,9
4,1,2,2,18.2,27.4,30.6,23.8,5057278,3420356,871828,69213,22215,780400,765094,140634,35961,24321,6199,492,158,5549,5440,2994016,2160992,490056,331835,158221,342968,25505,317463,78790,61043,17747,630,17117,38000,35401,18547,9
4,1,3,2,19,32.1,32.4,16.5,4673755,2929398,912720,89231,25392,798097,831637,139176,33582,21048,6558,641,182,5734,5975,3378675,2508547,692141,513922,178219,177987,-4744,182731,67086,55557,11529,381,11148,50363,45153,16391,1
4,1,1,1,18.4,34.1,33.2,14.3,5051576,3725927,762807,75935,28055,658817,562842,159706,31630,23330,4776,475,176,4125,3524,2165628,1557902,354980,237487,117493,252746,6471,246275,65612,48703,16909,401,16508,33007,31988,14919,9
4,1,3,2,19.7,28.4,33.5,18.4,6250641,3562224,1248931,139605,33122,1076204,1439486,184930,33800,19263,6754,755,179,5820,7784,5051594,3787539,985749,689728,296021,278306,-1731,280037,119094,100460,18634,298,18336,42417,37702,15273,13
4,1,2,2,19.6,21.9,31.3,27.2,8072213,4774131,1798046,301749,48051,1448246,1500036,244474,33019,19528,7355,1234,197,5924,6136,7810207,5691611,1339843,926003,413840,778753,2807,775946,171790,139881,31909,870,31039,45464,40689,24999,2
5,1,8,6,23.4,37,28.2,11.4,240588,103430,90639,17948,3142,69549,46519,8997,26741,11496,10074,1995,349,7730,5171,105277,69670,23380,17996,5384,12227,7548,4679,3259,2187,1072,268,804,32303,31856,5820,0
5,1,9,10,19.9,39.9,28.6,11.6,387443,196568,140126,17108,3215,119803,50749,13849,27976,14194,10118,1235,232,8651,3664,239313,173023,40214,27840,12374,26076,3597,22479,5174,4016,1158,234,924,46253,43083,24328,2
5,1,8,4,20,42,21.1,16.9,277353,122032,117319,25277,3305,88737,38002,10567,26247,11548,11102,2392,313,8398,3596,122738,74638,22458,16414,6044,25642,3982,21660,3913,2715,1198,343,855,31367,27491,25333,0
5,1,8,6,17.3,39.7,24.7,18.2,367332,180685,136700,26100,3847,106753,49947,13730,26754,13160,9956,1901,280,7775,3638,183095,116977,35425,26568,8857,30693,19727,10966,5377,3788,1589,380,1209,34052,30881,9070,1
5,1,8,7,20.5,37.6,28.7,13.3,390040,184381,150138,15182,3853,131103,55521,14494,26910,12721,10359,1047,266,9045,3831,155413,107793,30333,21514,8819,17287,1728,15559,5236,3479,1757,346,1411,29682,30984,11027,0
5,1,9,10,20.9,43.2,23.9,12,299946,126538,129905,29961,3997,95947,43503,11562,25942,10944,11236,2591,346,8298,3763,169806,107275,28780,20911,7869,33751,7659,26092,4405,2896,1509,301,1208,38548,37042,21599,0
5,1,3,2,18.9,42.7,23.9,14.4,457048,238757,154372,25291,4440,124641,63919,15745,29028,15164,9805,1606,282,7916,4060,156483,99100,28883,20919,7964,28500,13514,14986,4914,3260,1654,405,1249,31844,30399,11998,0
5,1,3,2,20.2,37.8,30.3,11.8,577747,301478,194139,25999,5038,163102,82130,19749,29254,15265,9830,1316,255,8259,4159,195863,120144,34656,25089,9567,41063,15531,25532,5849,4038,1811,404,1407,33487,29753,18146,0
5,1,1,1,17.9,43.9,25,13.2,573892,336115,173540,21440,5225,146875,64237,22872,25091,14695,7587,937,228,6422,2809,222978,151620,42988,31122,11866,28370,2104,26266,6249,4526,1723,176,1547,35682,33500,16979,0
5,1,7,11,16.8,39.6,28.1,15.4,643067,332933,209390,31598,6228,171564,100744,20944,30704,15896,9998,1509,297,8192,4810,357680,250822,68294,49078,19216,38564,7612,30952,9936,7535,2401,456,1945,35998,33288,15914,0
5,1,6,4,22.8,36.2,28.1,12.9,676916,337940,230458,22583,7803,200072,108518,24408,27733,13845,9442,925,320,8197,4446,330923,210120,59098,41063,18035,61705,8554,53151,10415,7388,3027,516,2511,31774,28441,21167,0
5,1,7,11,17,46.7,23.8,12.5,629665,328384,211187,29975,8027,173185,90094,23010,27365,14271,9178,1303,349,7527,3915,375649,282912,69715,48692,21023,23022,-778,23800,9532,7289,2243,448,1795,39409,38814,13259,0
5,1,7,11,19.3,35.3,31.9,13.4,797221,401477,270263,28324,9172,232767,125481,30816,25870,13028,8770,919,298,7553,4072,443521,308705,84573,59542,25031,50243,13164,37079,12911,9923,2988,677,2311,34352,31110,16045,2
5,1,7,11,18.5,44.3,24.2,13,738027,386796,241344,35072,9504,196768,109887,25765,28645,15012,9367,1361,369,7637,4265,427095,303352,80829,57427,23402,42914,4139,38775,12221,9019,3202,263,2939,34948,33635,13193,0
5,1,3,2,16.1,33.7,31.4,18.8,1729429,953468,519469,48741,13965,456763,256492,54525,31718,17487,9527,894,256,8377,4704,1262725,928242,243660,170078,73582,90823,-3420,94243,29256,23566,5690,640,5050,43161,39389,18662,2
5,1,4,3,17.9,35.9,31.3,14.9,2464213,1420430,678725,62679,18915,597131,365058,80466,30624,17653,8435,779,235,7421,4537,1323919,900776,234394,164052,70342,188749,29347,159402,37615,27596,10019,1986,8033,35197,32642,19843,5
5,1,3,2,14.1,35.3,28.1,22.5,2886404,1616473,752448,67520,22147,662781,517483,92735,31125,17431,8114,728,239,7147,5580,1421988,971691,259383,182268,77115,190914,-394,191308,43230,32756,10474,1425,9049,32894,29665,21141,4
5,1,3,2,9.8,27.8,31.7,30.7,6643563,3814502,1441178,109557,40737,1290884,1387883,183110,36282,20832,7871,598,222,7050,7580,2799688,2000662,487721,332314,155407,311305,-8550,319855,89246,63795,25451,906,24545,31370,31361,13031,11
5,1,3,2,11.8,29.4,28.5,30.2,6300795,3685506,1439119,160618,42906,1235595,1176170,194993,32313,18901,7380,824,220,6337,6032,4773665,3542546,936976,672554,264422,294143,2076,292067,107768,90373,17395,479,16916,44296,39199,17266,15
5,1,2,2,13.7,32.6,30.6,23,13217713,7871817,3295987,484283,107400,2704304,2049909,413320,31979,19045,7974,1172,260,6543,4960,9912939,7325775,1769228,1215916,553312,817936,9110,808826,226900,183224,43676,658,43018,43689,39983,18802,18
5,1,1,1,10.6,26.8,30.7,31.9,27816002,17187423,5166811,659730,162232,4344849,5461768,658048,42270,26119,7852,1003,247,6603,8300,23932787,16805264,3869075,2623290,1245785,3258448,-1523,3259971,439137,362557,76580,377,76203,54500,46352,42780,50
5,1,6,6,18.6,36.7,26.2,18.4,331875,157181,90754,9947,1778,79029,83940,11522,28804,13642,7877,863,154,6859,7285,165643,106740,31356,23675,7681,27547,0,27547,5470,3476,1994,0,1994,30282,30708,13815,1
5,1,3,2,15.7,36.6,29.2,18.5,417204,209074,122854,10862,3576,108416,85276,15824,26365,13212,7764,686,226,6851,5389,182543,129010,40032,30918,9114,13501,0,13501,5378,3770,1608,0,1608,33943,34220,8396,0
5,1,3,2,14.1,26.5,32.6,26.7,2185745,1124728,409753,34317,13891,361545,651264,55213,39588,20371,7421,622,252,6548,11795,956738,640144,158507,110785,47722,158087,3054,155033,29153,19751,9402,640,8762,32818,32411,17694,14
5,1,4,3,8.8,27.8,31.6,31.8,4473432,1841866,529043,39240,19857,469946,2102523,73219,61097,25156,7225,536,271,6418,28716,2106018,1540868,364760,248329,116431,200390,0,200390,53678,38029,15649,0,15649,39234,40518,12805,15
5,1,2,2,9.3,27.1,36.4,27.1,5551100,3468792,1051702,86473,32560,932669,1030606,152911,36303,22685,6878,566,213,6099,6740,1822027,1224737,338521,245871,92650,258769,6883,251886,50606,34174,16432,568,15864,36004,35838,15878,13
5,1,3,2,8.4,25.3,36.6,29.8,7381151,4022774,1414720,111229,40501,1262990,1943657,180714,40844,22260,7829,615,224,6989,10755,5504808,4062112,1193968,865699,328269,248728,-1130,249858,115269,93660,21609,455,21154,47756,43371,11811,7
5,1,3,2,10.9,30.9,35.9,22.4,6224875,3532153,1424918,141477,52933,1230508,1267804,169207,36789,20875,8421,836,313,7272,7493,4104614,2987129,799598,571998,227600,317887,-29,317916,95619,77471,18148,105,18043,42927,38558,17620,15
5,1,2,2,9.4,27.3,37.3,26,10255412,5691339,2502665,287184,74472,2141009,2061408,298036,34410,19096,8397,964,250,7184,6917,7689695,5640743,1576382,1140983,435399,472570,-2003,474573,167126,139231,27895,657,27238,46011,40514,17423,20
5,1,2,2,13.5,26.4,25.2,34.9,20229837,7176524,2597439,185240,101351,2310848,10455874,322601,62709,22246,8052,574,314,7163,32411,7515678,5113752,1074238,715102,359136,1327688,60015,1267673,170283,119829,50454,242,50212,44136,42675,25246,46
5,1,1,1,11.4,27.2,29.9,31.5,71516929,43677255,12354654,1300038,669936,10384680,15485020,1752907,40799,24917,7048,742,382,5924,8834,46305890,33222637,7332268,4972922,2359346,5750985,7134,5743851,976643,731219,245424,377,245047,47413,45435,23440,339
5,1,1,1,19,28.2,25,27.8,95889775,54390054,20892527,3108157,1017656,16766714,20607194,2507228,38245,21693,8333,1240,406,6687,8219,66368042,48561848,10966077,7563170,3402907,6840117,121258,6718859,1414370,1029961,384409,2000,382409,46924,47149,17570,260
5,1,9,10,23.8,45.9,20.6,9.7,151910,74292,49898,8794,1613,39491,27720,5231,29040,14202,9539,1681,308,7549,5299,79639,46654,13791,10913,2878,19194,13661,5533,2181,1474,707,212,495,36515,31651,11178,0
5,1,8,7,18.5,42.6,23.2,15.6,275597,160025,75598,11317,1773,62508,39974,9099,30289,17587,8308,1244,195,6870,4393,163775,109778,29228,22467,6761,24769,-467,25236,3924,2805,1119,214,905,41737,39137,27885,0
5,1,2,2,18.5,33.9,24.6,23,440009,287658,78038,8109,2203,67726,74313,15640,28134,18392,4990,518,141,4330,4751,385504,266343,83500,69687,13813,35661,6794,28867,7024,5559,1465,142,1323,54884,47912,21819,3
5,1,6,6,24.6,41.7,21.5,12.2,443914,262963,128785,10156,2259,116370,52166,14907,29779,17640,8639,681,152,7806,3499,235999,164101,44954,35271,9683,26944,1071,25873,5954,4634,1320,159,1161,39637,35412,22285,0
5,1,9,10,22.6,41.6,21.9,13.9,300224,168923,98097,12176,2398,83523,33204,10378,28929,16277,9452,1173,231,8048,3199,151164,77822,23460,18531,4929,49882,6894,42988,4276,2877,1399,460,939,35352,27050,45781,0
5,1,8,7,23.1,42.8,21.8,12.4,306692,170285,102381,11109,2433,88839,34026,10154,30204,16770,10083,1094,240,8749,3351,122400,82951,25033,19865,5168,14416,468,13948,3880,2774,1106,253,853,31546,29903,16352,1
5,1,7,11,29.5,39.3,21.5,9.8,219560,103087,85302,16221,2444,66637,31171,7737,28378,13324,11025,2097,316,8613,4029,112198,66491,20031,16078,3953,25676,18433,7243,2971,2270,701,184,517,37764,29291,14010,0
5,1,6,6,20.9,42.4,23.8,13,497644,299407,145956,14622,2716,128618,52281,16309,30513,18358,8949,897,167,7886,3206,252207,142853,39289,30979,8310,70065,4038,66027,5231,3925,1306,171,1135,48214,36396,58174,0
5,1,7,9,24.7,39.3,22.5,13.4,307276,165270,107771,22052,2773,82946,34235,12105,25384,13653,8903,1822,229,6852,2828,176352,106082,34759,28219,6540,35511,17352,18159,5062,3908,1154,253,901,34838,27145,20154,2
5,1,6,6,20.1,43.7,23.1,13.1,437958,255154,134838,15888,3007,115943,47966,15302,28621,16675,8812,1038,197,7577,3135,278315,175200,47124,35248,11876,55991,3080,52911,6699,5467,1232,148,1084,41546,32047,48811,0
5,1,1,1,17.8,36.3,26.6,19.3,998905,686959,158955,16964,3085,138906,152991,23123,43200,29709,6874,734,133,6007,6616,1287790,915387,235136,176372,58764,137267,10258,127009,19813,16157,3656,118,3538,64997,56656,35899,1
5,1,6,6,20.6,41.3,24.1,14,490303,271102,146731,19122,3464,124145,72470,17175,28547,15785,8543,1113,202,7228,4220,251302,156900,44768,35757,9011,49634,18227,31407,5857,4389,1468,229,1239,42906,35748,25349,0
5,1,6,6,16.5,44.7,24.6,14.2,700202,399879,207828,18593,3703,185532,92495,24233,28895,16501,8576,767,153,7656,3817,337432,188551,53833,41796,12037,95048,27621,67427,8452,6048,2404,327,2077,39923,31176,32464,0
5,1,9,10,23,44.8,20.3,12,301743,159500,110621,12689,3915,94017,31622,11575,26069,13780,9557,1096,338,8122,2732,130877,77494,23500,18905,4595,29883,12933,16950,4176,2585,1591,732,859,31340,29978,19732,0
5,1,3,2,18.2,42.3,31.1,8.5,582740,355348,161711,19753,3961,137997,65681,22335,26091,15910,7240,884,177,6179,2941,212860,136721,44454,35212,9242,31685,1380,30305,5525,3748,1777,213,1564,38527,36478,19377,1
5,1,2,2,21.2,37.9,25.1,15.8,801212,504068,184118,23440,4536,156142,113026,22816,35116,22093,8070,1027,199,6844,4954,362514,226892,64919,49226,15693,70703,11685,59018,9313,6371,2942,349,2593,38926,35613,22761,0
5,1,7,8,23.6,40.6,24.4,11.4,676472,417129,183461,28653,4560,150248,75882,20839,32462,20017,8804,1375,219,7210,3641,418567,188883,54525,42853,11672,175159,16544,158615,8365,6257,2108,395,1713,50038,30187,92595,0
5,1,3,2,14.2,46.6,26.5,12.8,670551,399365,197972,22650,4767,170555,73214,22837,29362,17488,8669,992,209,7468,3206,250212,151885,45945,35855,10090,52382,20352,32030,7919,5311,2608,368,2240,31596,28598,14299,0
5,1,7,11,24.8,42.2,21.5,11.4,563538,288360,209535,28165,4991,176379,65643,20810,27080,13857,10069,1353,240,8476,3154,264577,159641,48926,39079,9847,56010,25460,30550,8670,5948,2722,900,1822,30516,26839,16767,0
5,1,2,2,17.1,37.5,25.3,20.1,910548,659637,161393,21024,5011,135358,89518,23953,38014,27539,6738,878,209,5651,3737,713312,496203,129483,96759,32724,87626,4134,83492,14210,11689,2521,98,2423,50198,42450,34458,0
5,1,2,2,17.4,42.3,26.8,13.5,898507,539479,220332,29833,5145,185354,138696,26668,33692,20229,8262,1119,193,6950,5201,420835,293083,75510,58425,17085,52242,-5295,57537,10012,6921,3091,563,2528,42033,42347,22760,6
5,1,6,6,21,40.7,22.5,15.8,1001703,613293,249917,26599,5164,218154,138493,31634,31665,19387,7900,841,163,6896,4378,477169,311371,84893,65507,19386,80905,22315,58590,12266,9323,2943,563,2380,38902,33398,24618,0
5,1,6,6,20.6,39,25,15.4,626690,360468,202219,26232,5463,170524,64003,20760,30187,17364,9741,1264,263,8214,3083,322847,205951,59307,45598,13709,57589,8540,49049,9487,6845,2642,672,1970,34030,30088,24898,2
5,1,6,6,20.4,42.6,23.9,13.1,684253,407309,192608,21301,5672,165635,84336,25721,26603,15836,7488,828,221,6440,3279,411436,288278,85921,69716,16205,37237,3339,33898,10736,8929,1807,359,1448,38323,32286,23410,0
5,1,6,4,26.4,42.5,20.8,10.3,783405,521848,181553,23858,5950,151745,80004,23334,33574,22364,7781,1022,255,6503,3429,307019,189873,48060,36074,11986,69086,5092,63994,6850,4923,1927,62,1865,44820,38569,34313,0
5,1,6,6,26,38.4,22.7,12.9,1037169,593398,320081,44269,6002,269810,123690,33956,30544,17475,9426,1304,177,7946,3643,465853,286743,83893,65732,18161,95217,24560,70657,11791,8832,2959,622,2337,39509,32466,30234,0
5,1,1,1,15.8,44.5,25.7,14,853886,615312,165718,22265,6033,137420,72856,22052,38721,27903,7515,1010,274,6232,3304,700456,450277,137491,110563,26928,112688,2741,109947,10090,8048,2042,43,1999,69421,55949,55001,0
5,1,1,1,18.3,39.1,30.5,12.1,1126393,691271,239630,36685,6927,196018,195492,36823,30589,18773,6508,996,188,5323,5309,782406,535501,154782,121758,33024,92123,5246,86877,15988,11753,4235,34,4201,48937,45563,20680,0
5,1,2,2,22.5,38.8,23.8,15,1085290,698741,257852,38869,7253,211730,128697,33391,32502,20926,7722,1164,217,6341,3854,1064987,791663,211108,163674,47434,62216,5825,56391,17875,14926,2949,135,2814,59580,53039,20039,0
5,1,6,6,26.1,39.3,23.3,11.3,1286057,731644,401139,55070,7586,338483,153274,42110,30540,17375,9526,1308,180,8038,3640,552636,345215,101407,81337,20070,106014,21841,84173,16448,12208,4240,797,3443,33599,28278,24448,0
5,1,6,5,15,33.1,32.6,19.4,1244927,750866,329472,50190,7736,271546,164589,39526,31496,18997,8336,1270,196,6870,4164,753798,463181,135268,107911,27357,155349,19127,136222,18616,14425,4191,517,3674,40492,32110,37077,0
5,1,6,3,23.4,41.1,23.3,12.2,1334345,691917,488823,62318,8637,417868,153605,47120,28318,14684,10374,1323,183,8868,3260,551993,378637,111480,89971,21509,61876,-1068,62944,16521,11279,5242,736,4506,33412,33570,13969,2
5,1,6,5,19.7,44.2,22.2,13.9,843994,443066,301720,48771,8977,243972,99208,27872,30281,15896,10825,1750,322,8753,3559,361375,214193,61440,47323,14117,85742,41283,44459,10301,7268,3033,371,2662,35082,29471,16701,0
5,1,4,5,11.8,26.8,25.2,36.2,1442308,854588,340603,40263,9211,291129,247117,46858,30780,18238,7269,859,197,6213,5274,1019957,660513,181454,141450,40004,177990,18103,159887,25038,19658,5380,283,5097,40736,33600,31369,9
5,1,5,8,12.5,36.6,33.2,17.7,1862578,1200669,336954,38999,9510,288445,324955,52721,35329,22774,6391,740,180,5471,6164,1618686,1129404,419609,320822,98787,69673,-2251,71924,28496,25270,3226,423,2803,56804,44693,25660,0
5,1,1,1,11.8,35.4,30.5,22.3,2106160,1551930,323892,38349,9544,275999,230338,52815,39878,29384,6133,726,181,5226,4361,1950755,1401814,392325,305434,86891,156616,-257,156873,30386,24442,5944,55,5889,64199,57353,26638,3
5,1,2,2,18.7,39.4,26.5,15.5,1349648,783313,390586,44264,9562,336760,175749,41196,32762,19014,9481,1074,232,8175,4266,739936,517334,131424,98226,33198,91178,-579,91757,18347,14038,4309,384,3925,40330,36852,23378,2
5,1,2,2,24.2,41.7,22,12.1,1984048,1310223,410098,47530,9612,352956,263727,58112,34142,22547,7057,818,165,6074,4538,935313,586259,148065,111854,36211,200989,60920,140069,21780,14929,6851,1033,5818,42944,39270,24075,1
5,1,2,2,22.4,40.8,24.7,12.2,1952820,1236086,478644,61679,9771,407194,238090,61859,31569,19982,7738,997,158,6583,3849,902832,562449,148659,113156,35503,191724,42028,149696,23050,16695,6355,740,5615,39168,33690,26660,4
5,1,1,1,15.8,37.3,30.5,16.4,1560104,1084411,334583,53339,11584,269660,141110,45606,34208,23778,7336,1170,254,5913,3094,1102428,764605,220148,171742,48406,117675,1477,116198,21717,16243,5474,18,5456,50763,47073,21297,2
5,1,4,5,20.2,48.9,20.2,10.6,1952636,1190240,441597,63001,12146,366450,320799,54556,35791,21817,8094,1155,223,6717,5880,1742156,1277900,291029,212052,78977,173227,-598,173825,33142,27550,5592,99,5493,52566,46385,31645,1
5,1,3,2,23.9,39.7,20.1,16.3,3896491,2613295,680240,74165,14005,592070,602956,96737,40279,27014,7032,767,145,6120,6233,2796609,1888340,460329,344725,115604,447940,20999,426941,50049,39608,10441,347,10094,55877,47676,42297,7
5,1,2,2,21.5,43.5,22.3,12.7,2587228,1651683,577962,86574,14364,477024,357583,73270,35311,22542,7888,1182,196,6510,4880,2003805,1422752,317202,226515,90687,263851,-564,264415,42188,33362,8826,234,8592,47497,42646,30775,15
5,1,3,2,21.7,39.6,24.3,14.4,4270849,2979681,790514,99084,16913,674517,500654,111514,38299,26720,7089,889,152,6049,4490,3588210,2622692,577251,410942,166309,388267,11249,377018,69363,57265,12098,138,11960,51731,45799,31523,15
5,1,4,5,23.5,42.4,20.5,13.5,2801372,1650880,809659,116776,17013,675870,340833,83492,33553,19773,9697,1399,204,8095,4082,1323206,891626,248408,193952,54456,183172,10896,172276,36211,26884,9327,1155,8172,36542,33166,21081,0
5,1,2,2,11.2,28.7,34.5,25.7,4363911,2870006,823399,82932,18009,722458,670506,117627,37100,24399,7000,705,153,6142,5700,2792961,1991714,562201,417322,144879,239046,2762,236284,63945,51481,12464,405,12059,43678,38688,19594,10
5,1,2,2,11.6,33.9,26.9,27.6,4276001,3234979,599226,65576,20248,513402,441796,107870,39640,29990,5555,608,188,4759,4096,2290843,1661456,416679,310828,105851,212708,1596,211112,48156,36611,11545,220,11325,47571,45381,18641,3
5,1,2,2,14.7,40.4,27.5,17.4,4234344,3074212,769740,84809,23709,661222,390392,128709,32899,23885,5980,659,184,5137,3033,1260475,810893,214069,162693,51376,235513,-215,235728,37799,24304,13495,378,13117,33347,33365,17971,2
5,1,3,2,15.3,37.1,27.5,20.1,4761857,2742542,1290872,139358,23763,1127751,728443,131772,36137,20813,9796,1058,180,8558,5528,3324355,2304464,613927,465075,148852,405964,33204,372760,75894,63083,12811,753,12058,43803,36531,30914,6
5,1,3,2,18,36.2,25.9,19.9,3986966,2484699,1048856,139707,26855,882294,453411,121485,32819,20453,8634,1150,221,7263,3732,2397216,1575401,429765,336680,93085,392050,4565,387485,60129,45043,15086,972,14114,39868,34975,27454,5
5,1,3,2,14.4,34,27.3,24.3,5094940,3098141,1240601,181820,31304,1027477,756198,153969,33091,20122,8057,1181,203,6673,4911,3729342,2604046,667531,501861,165670,457765,11089,446676,92343,72428,19915,386,19529,40386,35954,22872,9
5,1,1,1,10.5,25.9,31.1,32.5,11146718,7577657,1635567,125750,34982,1474835,1933494,234533,47527,32310,6974,536,149,6288,8244,5254806,3223536,776217,576754,199463,1255053,2916,1252137,118184,80585,37599,509,37090,44463,40002,33759,27
5,1,3,2,13.9,33.9,30.5,21.7,6647732,4201435,1417954,162191,36194,1219569,1028343,193036,34438,21765,7346,840,187,6318,5327,4962508,3520328,958765,735390,223375,483415,3113,480302,106982,87477,19505,790,18715,46386,40243,25664,3
5,1,2,2,13,28.9,26.2,31.8,9720972,6344879,1364262,159794,36274,1168194,2011831,222159,43757,28560,6141,719,163,5258,9056,8719308,6270413,1346771,946102,400669,1102124,1082,1101042,172842,138680,34162,561,33601,50447,45215,32768,34
5,1,2,2,13.5,33.2,29.4,24,10379522,6365713,2103882,300698,49588,1753596,1909927,255657,40599,24899,8229,1176,194,6859,7471,8059773,5167206,1308006,972704,335302,1584561,-205,1584766,163050,128821,34229,517,33712,49431,40112,47009,16
5,1,1,1,14.1,23,26.4,36.5,14658466,8898691,2588183,454929,72427,2060827,3171592,347824,42143,25584,7441,1308,208,5925,9118,13730862,9562200,2229231,1611433,617798,1939431,0,1939431,241853,194416,47437,0,47437,56774,49184,40884,19
5,1,1,1,15.1,31.4,28.3,25.2,18268133,12054120,3253593,343750,81147,2828696,2960420,432679,42221,27859,7520,794,188,6538,6842,13660378,9222572,2048452,1452564,595888,2389354,919,2388435,267347,207568,59779,51,59728,51096,44432,39989,49
5,1,2,2,9.8,27.2,28.6,34.5,17596474,11569791,3032188,416751,85616,2529821,2994495,440625,39935,26258,6882,946,194,5741,6796,16358147,11925525,2906785,2174057,732728,1525837,58,1525779,329496,269420,60076,393,59683,49646,44264,25565,42
5,1,8,7,34.4,38.2,21.3,6.1,30461,16687,9078,1827,377,6874,4696,1393,21867,11979,6517,1312,271,4935,3371,12774,8663,2276,1573,703,1835,628,1207,491,359,132,67,65,26016,24131,18569,0
5,1,8,7,24.7,25.3,28.6,21.5,132669,52816,57798,10654,1569,45575,22055,4886,27153,10810,11829,2181,321,9328,4514,52629,38474,9919,7020,2899,4236,-493,4729,1970,1490,480,94,386,26715,25821,12251,0
5,1,9,10,15.5,37.8,30.6,16.2,224697,118036,79311,8702,1720,68889,27350,8110,27706,14554,9779,1073,212,8494,3372,90780,61506,16622,12128,4494,12652,1910,10742,2772,1902,870,166,704,32749,32338,15259,0
5,1,1,1,26.9,35.5,27.3,10.3,196832,101851,74131,10442,1923,61766,20850,8695,22637,11714,8526,1201,221,7104,2398,52902,35920,9385,6628,2757,7597,-1759,9356,2090,1205,885,268,617,25312,29809,15164,0
5,1,9,10,18.6,35.6,28.5,17.3,208345,107746,72134,8908,1940,61286,28465,8568,24317,12575,8419,1040,226,7153,3322,104188,70997,19063,13742,5321,14128,2478,11650,3112,2161,951,229,722,33479,32854,16136,1
5,1,9,10,14.8,36.1,30.9,18.1,305206,155682,112218,11706,2345,98167,37306,10258,29753,15177,10940,1141,229,9570,3637,106221,63955,16968,12018,4950,25298,4562,20736,4189,2405,1784,325,1459,25357,26593,14212,0
5,1,8,7,30.2,36.5,18.4,14.9,244676,121011,89446,14483,2390,72573,34219,9863,24807,12269,9069,1468,242,7358,3469,107138,79217,18597,12462,6135,9324,-256,9580,3613,2665,948,156,792,29653,29725,12096,0
5,1,9,8,17.9,34.5,31.2,16.4,296404,165111,92654,10805,2397,79452,38639,10602,27957,15574,8739,1019,226,7494,3645,62333,38800,10146,7060,3086,13387,-3522,16909,2734,1396,1338,456,882,22799,27794,19171,0
5,1,9,8,20,33,33.9,13.1,237988,105057,101681,11182,2441,88058,31250,10471,22728,10033,9711,1068,233,8410,2984,81851,55288,16600,12407,4193,9963,2574,7389,2980,2112,868,362,506,27467,26178,14603,1
5,1,8,7,24.1,36.8,30.5,8.7,318000,182662,101309,11292,2809,87208,34029,14392,22096,12692,7039,785,195,6059,2364,100333,65461,18756,13884,4872,16116,4008,12108,3413,2309,1104,347,757,29397,28350,15995,0
5,1,3,2,19.3,38.6,31.6,10.6,313011,172598,106956,13286,2862,90808,33457,12233,25587,14109,8743,1086,234,7423,2735,128137,95659,21027,14462,6565,11451,-504,11955,3497,2497,1000,286,714,36642,38310,16744,0
5,1,8,7,18.6,37.5,30.1,13.8,363489,195458,130088,13608,2918,113562,37943,12906,28164,15145,10080,1054,226,8799,2940,173047,111807,26829,18980,7849,34411,15753,18658,4376,2989,1387,372,1015,39545,37406,18382,0
5,1,8,7,24.3,35.8,25,15,307465,153412,118572,18536,2967,97069,35481,12471,24654,12301,9508,1486,238,7784,2845,107049,70500,17294,11991,5303,19255,5490,13765,3508,2215,1293,324,969,30516,31828,14205,1
5,1,7,9,19.8,33.7,25.6,21,295894,143335,112648,13039,2988,96621,39911,10892,27166,13160,10342,1197,274,8871,3664,119275,80126,21055,15035,6020,18094,2471,15623,4115,3022,1093,303,790,28985,26514,19776,1
5,1,9,10,24.6,35.9,28.2,11.2,387907,197741,141315,16141,3008,122166,48851,14970,25912,13209,9440,1078,201,8161,3263,164987,107235,27101,18927,8174,30651,11578,19073,5693,3917,1776,549,1227,28981,27377,15544,0
5,1,8,7,19.8,42.3,26.8,11,458988,277491,135452,16249,3034,116169,46045,16503,27812,16815,8208,985,184,7039,2790,205128,102771,27706,19810,7896,74651,51315,23336,5223,3277,1946,604,1342,39274,31361,17389,1
5,1,8,5,21.1,38.9,26.7,13.2,335485,174986,120112,15552,3065,101495,40387,13130,25551,13327,9148,1184,233,7730,3076,97828,61874,15291,10724,4567,20663,7452,13211,3516,2200,1316,512,804,27824,28125,16432,0
5,1,7,9,31.8,30.1,25.3,12.9,291825,146890,112804,23593,3241,85970,32131,11481,25418,12794,9825,2055,282,7488,2799,138931,78138,21545,15497,6048,39248,16444,22804,4605,2925,1680,500,1180,30170,26714,19325,0
5,1,7,9,19,37,30,14,352343,170729,134656,16344,3285,115027,46958,12626,27906,13522,10665,1294,260,9110,3719,158002,104422,27521,19464,8057,26059,2708,23351,5031,3419,1612,319,1293,31406,30542,18060,0
5,1,6,6,17.4,34.9,32.7,15,491430,266257,162962,15193,3352,144417,62211,17904,27448,14871,9102,849,187,8066,3475,182247,136792,34146,23949,10197,11309,-948,12257,6427,4452,1975,248,1727,28356,30726,7097,0
5,1,7,9,29.1,34.6,26.2,10.1,335949,176481,120206,22278,3523,94405,39262,15338,21903,11506,7837,1452,230,6155,2560,144202,87922,21517,14715,6802,34763,11123,23640,4656,3301,1355,418,937,30971,26635,25229,1
5,1,1,1,21.3,29.5,32,17.1,288731,155324,91193,20914,3580,66699,42214,10761,26831,14434,8474,1943,333,6198,3923,499253,412531,69271,37248,32023,17451,8536,8915,13679,12632,1047,79,968,36498,32658,9210,0
5,1,9,10,19.8,45,24.8,10.3,376685,188445,141529,19191,3598,118740,46711,15401,24458,12236,9190,1246,234,7710,3033,140551,85649,22231,15788,6443,32671,6573,26098,5001,3141,1860,614,1246,28105,27268,20945,1
5,1,8,6,18.3,36.8,28.8,16.1,540210,301908,169718,22466,3826,143426,68584,19575,27597,15423,8670,1148,195,7327,3504,255202,165182,42034,29658,12376,47986,13742,34244,7783,5472,2311,462,1849,32790,30187,18520,1
5,1,9,8,15.9,37.3,32.9,13.9,497296,280371,157034,19631,3829,133574,59891,17007,29241,16486,9233,1154,225,7854,3522,236489,158044,39455,27699,11756,38990,18361,20629,6512,4746,1766,414,1352,36316,33300,15258,1
5,1,9,8,21.1,34.9,30.8,13.3,494356,274797,166946,17142,3849,145955,52613,16731,29547,16424,9978,1025,230,8724,3145,144592,98395,25388,18071,7317,20809,3997,16812,4965,3322,1643,306,1337,29122,29619,12574,0
5,1,7,9,16.7,29.9,37.1,16.3,619151,332727,208526,22544,4311,181671,77898,21664,28580,15359,9625,1041,199,8386,3596,277894,187672,49743,35483,14260,40479,19302,21177,8332,6413,1919,523,1396,33353,29264,15170,0
5,1,6,6,21.7,38.3,27.9,12.1,563684,319233,182406,24802,4391,153213,62045,23738,23746,13448,7684,1045,185,6454,2614,286869,176632,46654,32702,13952,63583,36079,27504,8649,6467,2182,586,1596,33168,27313,17233,0
5,1,7,9,25.5,36.5,26.2,11.8,477773,251477,160509,20179,4453,135877,65787,17439,27397,14420,9204,1157,255,7792,3772,279210,191257,46198,30761,15437,41755,18111,23644,8626,6376,2250,505,1745,32368,29996,13550,0
5,1,6,6,20.6,37.1,30.3,11.9,631103,404881,159165,16876,4523,137766,67057,22648,27866,17877,7028,745,200,6083,2961,210182,147865,38519,27529,10990,23798,-1421,25219,7182,4934,2248,515,1733,29265,29969,14552,1
5,1,6,6,22.6,30.9,34.1,12.3,549533,316368,169673,22052,4567,143054,63492,19488,28199,16234,8707,1132,234,7341,3258,279839,153973,38705,27207,11498,87161,346,86815,7179,5108,2071,430,1641,38980,30144,52904,1
5,1,8,6,20.9,40.9,26.7,11.5,504916,249392,183990,13997,4732,165261,71534,19619,25736,12712,9378,713,241,8424,3646,234318,164348,43574,30972,12602,26396,1237,25159,6991,5532,1459,275,1184,33517,29709,21249,1
5,1,7,9,24.9,37.4,25,12.6,578214,319745,177308,27039,4809,145460,81161,20768,27842,15396,8538,1302,232,7004,3908,298379,185130,46343,32428,13915,66906,33391,33515,7947,5900,2047,441,1606,37546,31378,20869,0
5,1,2,2,20.7,35.2,30.8,13.3,814725,460647,266339,29249,4974,232116,87739,27526,29598,16735,9676,1063,181,8433,3187,373881,220720,56831,39925,16906,96330,41694,54636,11316,8404,2912,561,2351,33040,26264,23239,0
5,1,7,8,21.2,29,31.7,18.1,652207,350777,216132,27451,5126,183555,85298,21842,29860,16060,9895,1257,235,8404,3905,462239,326667,80458,55543,24915,55114,3954,51160,12545,10252,2293,283,2010,36846,31864,25453,1
5,1,7,8,22.3,30.1,34.6,13,644588,340777,227298,15891,5353,206054,76513,23419,27524,14551,9706,679,229,8799,3267,240023,177115,44288,30901,13387,18620,2887,15733,7359,5682,1677,401,1276,32616,31171,12330,0
5,1,6,4,22.4,33.7,29.4,14.5,577742,302732,201474,21860,5575,174039,73536,22185,26042,13646,9082,985,251,7845,3315,286898,199879,51011,35459,15552,36008,-133,36141,9177,6528,2649,596,2053,31263,30619,17604,0
5,1,7,9,21.8,32.8,31.4,14.1,950243,572741,254475,32527,5679,216269,123027,29674,32023,19301,8576,1096,191,7288,4146,707059,435278,101363,69752,31611,170418,36176,134242,16404,13585,2819,604,2215,43103,32041,60606,0
5,1,2,2,23.6,36,26.1,14.3,691662,353713,236178,40809,6025,189344,101771,28131,24587,12574,8396,1451,214,6731,3618,340489,237341,64819,47058,17761,38329,9087,29242,9974,7069,2905,544,2361,34138,33575,12385,0
5,1,6,4,21.7,33.2,30.5,14.7,695217,385980,212301,22055,6133,184113,96936,27140,25616,14222,7822,813,226,6784,3572,392262,273043,65543,44414,21129,53676,629,53047,12198,8691,3507,627,2880,32158,31417,18419,2
5,1,6,6,24.7,41,23.6,10.7,473454,189655,233839,45032,6135,182672,49960,19400,24405,9776,12054,2321,316,9416,2575,179710,119659,31409,22307,9102,28642,2582,26060,6787,4305,2482,458,2024,26479,27795,12875,0
5,1,7,9,21.8,33.3,32.6,12.3,636245,332049,221504,21008,6236,194260,82692,25227,25221,13162,8780,833,247,7700,3278,304969,224045,58207,41018,17189,22717,-502,23219,9271,7713,1558,459,1099,32895,29048,21127,0
5,1,2,2,21.5,30.7,34.5,13.3,810065,454223,267077,41625,6273,219179,88765,29436,27520,15431,9073,1414,213,7446,3016,358595,236638,66444,48256,18188,55513,9291,46222,11545,8539,3006,487,2519,31061,27713,18349,0
5,1,7,9,20.9,33.5,29.7,15.9,508147,244160,184530,25567,6307,152656,79457,19200,26466,12717,9611,1332,328,7951,4138,213844,151897,37571,25958,11613,24376,9510,14866,7177,5081,2096,457,1639,29796,29895,9070,0
5,1,6,6,22.1,37.4,27.6,12.9,695393,344924,251765,34850,6379,210536,98704,26992,25763,12779,9327,1291,236,7800,3657,397984,282730,64391,43419,20972,50863,11982,38881,11533,8652,2881,493,2388,34508,32678,16282,1
5,1,1,1,19.5,31.5,32.9,16.1,803114,484106,232231,25505,6490,200236,86777,28996,27697,16696,8009,880,224,6906,2993,277110,188427,48323,34043,14280,40360,-910,41270,9969,6214,3755,515,3240,27797,30323,12738,2
5,1,7,9,20,32,28.7,19.3,606507,340016,181617,27173,6643,147801,84874,20547,29518,16548,8839,1322,323,7193,4131,311173,186804,42931,29032,13899,81438,40626,40812,8076,5933,2143,383,1760,38531,31486,23189,0
5,1,5,8,20.5,34.8,27.4,17.4,943035,461910,316953,43263,6669,267021,164172,32566,28958,14184,9733,1328,205,8199,5041,555875,383842,88560,60074,28486,83473,2837,80636,16484,12318,4166,177,3989,33722,31161,20215,0
5,1,7,8,24,30.9,30.3,14.9,787850,482298,215430,23614,6681,185135,90122,30053,26215,16048,7168,786,222,6160,2999,478056,350802,81668,52585,29083,45586,-2820,48406,14906,11579,3327,779,2548,32071,30296,18998,3
5,1,7,8,21.6,26.9,34.6,16.9,751414,341514,296037,54104,6689,235244,113863,26106,28783,13082,11340,2072,256,9011,4362,416240,296079,69530,47454,22076,50631,12286,38345,11794,9365,2429,210,2219,35293,31615,17280,0
5,1,6,5,13.4,36.7,34.9,15,1071335,638943,305123,34710,7182,263231,127269,34896,30701,18310,8744,995,206,7543,3647,568715,401226,91938,62262,29676,75551,9430,66121,16047,12155,3892,558,3334,35441,33009,19832,1
5,1,7,8,27.8,29.4,28.3,14.5,713983,353196,258873,52423,7399,199051,101914,28983,24635,12186,8932,1809,255,6868,3516,410243,291236,76853,54769,22084,42154,15602,26552,12285,10121,2164,274,1890,33394,28775,14049,0
5,1,7,8,23.9,24.4,28.8,22.9,1015289,537164,341229,62224,7832,271173,136896,34099,29775,15753,10007,1825,230,7953,4015,589774,408831,105888,75148,30740,75055,18178,56877,16696,13591,3105,346,2759,35324,30081,20615,0
5,1,2,2,15.3,27.6,36.2,20.9,1473998,788657,325564,32435,7963,285166,359777,44075,33443,17894,7387,736,181,6470,8163,999870,731521,182702,126556,56146,85647,-1873,87520,20380,15646,4734,225,4509,49061,46755,19410,2
5,1,6,5,19.3,34.6,30.1,15.9,1091964,564736,376896,56824,8364,311708,150332,40447,26997,13962,9318,1405,207,7707,3717,670962,465660,117321,82677,34644,87981,3347,84634,20976,15714,5262,469,4793,31987,29633,17658,0
5,1,5,8,21.8,35.5,24.8,17.9,934006,445879,319372,57026,8381,253965,168755,32416,28813,13755,9852,1759,259,7835,5206,694084,492885,127673,90199,37474,73526,15438,58088,18705,15919,2786,238,2548,37107,30962,22797,0
5,1,7,8,19.2,33.5,31.3,15.9,1018687,531780,344226,33242,8650,302334,142681,37103,27456,14333,9278,896,233,8149,3846,619850,452200,106497,72305,34192,61153,-2187,63340,16743,13633,3110,452,2658,37021,33170,23830,2
5,1,6,4,22.2,38.2,25.2,14.4,914491,518416,290126,45611,8968,235547,105949,34640,26400,14966,8375,1317,259,6800,3059,554729,380102,96244,67388,28856,78383,4365,74018,15918,12020,3898,630,3268,34849,31622,22649,0
5,1,1,1,20.6,41.3,25,13.1,930839,543620,293549,46040,9076,238433,93670,37050,25124,14673,7923,1243,245,6435,2528,316385,220921,54345,37324,17021,41119,-4612,45731,11585,6988,4597,498,4099,27310,31614,11157,2
5,1,3,2,9.4,23.6,31.1,35.9,1765095,1164363,324669,32814,9113,282742,276063,56049,31492,20774,5793,585,163,5045,4925,819961,538031,125109,85299,39810,156821,5060,151761,27203,19010,8193,395,7798,30142,28303,19462,0
5,1,4,3,10.5,18.9,28.8,41.9,1469174,856242,312071,24560,9177,278334,300861,47566,30887,18001,6561,516,193,5852,6325,968637,696563,173490,122943,50547,98584,3982,94602,26268,20182,6086,402,5684,36875,34514,16644,7
5,1,6,3,15.8,30,39.2,15,1752207,1051764,483805,50626,10121,423058,216638,55699,31459,18883,8686,909,182,7595,3889,545018,338908,89479,64607,24872,116631,-986,117617,17558,11052,6506,719,5787,31041,30665,20324,6
5,1,5,8,11.9,21.1,24.4,42.6,1305734,771690,295516,37480,10129,247907,238528,47738,27352,16165,6190,785,212,5193,4997,920260,665747,177580,128684,48896,76933,-1810,78743,25076,20683,4393,361,4032,36699,32188,19530,7
5,1,7,9,20.1,35.5,27.9,16.5,1008610,549623,328532,34654,10260,283618,130455,36928,27313,14884,8897,938,278,7680,3533,512775,364179,94740,66362,28378,53856,-1298,55154,13824,10605,3219,616,2603,37093,34340,21189,2
5,1,4,5,17.8,31.1,32.6,18.4,2214863,1231573,659273,63718,11706,583849,324017,67797,32669,18166,9724,940,173,8612,4779,1566857,1104763,274435,195262,79173,187659,35097,152562,36920,30183,6737,845,5892,42439,36602,25893,3
5,1,4,5,12.8,32.2,32.1,22.9,1625615,964507,402536,57411,11855,333270,258572,48835,33288,19750,8243,1176,243,6824,5295,1203555,900726,230820,162085,68735,72009,3834,68175,28067,23241,4826,204,4622,42881,38756,14750,5
5,1,3,2,13.3,27.6,32.3,26.7,2357250,1330413,627229,73005,15258,538966,399608,75007,31427,17737,8362,973,203,7186,5328,2090253,1456793,358780,253094,105686,274680,1509,273171,47862,40703,7159,323,6836,43672,35791,39961,10
5,1,5,8,21.2,30.6,29.2,19,1545709,823951,500184,105678,15774,378732,221574,51095,30252,16126,9789,2068,309,7412,4337,925452,650019,158461,109458,49003,116972,20124,96848,24808,20381,4427,236,4191,37305,31893,23109,6
5,1,5,8,15.3,30.7,30.4,23.6,1878551,1094744,473894,62545,16087,395262,309913,59795,31417,18308,7925,1046,269,6610,5183,1409794,1045678,263990,183464,80526,100126,238,99888,33052,27298,5754,374,5380,42654,38306,18567,6
5,1,5,8,13.8,30.7,35.4,20.1,2466806,1394302,670058,84965,17154,567939,402446,80422,30673,17337,8332,1056,213,7062,5004,1834854,1314868,330655,228905,101750,189331,160,189171,44526,37749,6777,331,6446,41209,34832,29347,3
5,1,5,8,16.8,25.9,33.9,23.5,2667263,1664617,617134,70522,18568,528044,385512,82877,32183,20085,7446,851,224,6371,4652,2495085,1860312,412801,273375,139426,221972,3035,218937,60888,52029,8859,471,8388,40978,35755,26101,11
5,1,2,2,10.3,26.2,34.3,29.2,5193959,3520322,957675,77083,22936,857656,715962,142520,36444,24701,6720,541,161,6018,5024,3093372,2189107,490063,330206,159857,414202,23771,390431,78105,60491,17614,616,16998,39605,36189,22969,8
5,1,2,2,12.2,31.6,35.6,20.7,4772519,2968595,997815,100752,28200,868863,806109,139454,34223,21287,7155,722,202,6230,5780,3486066,2566891,702395,518451,183944,216780,-7359,224139,68682,56604,12078,375,11703,50757,45348,19152,3
5,1,1,1,10.6,29.5,36.4,23.5,5152937,3767116,849024,88709,29000,731315,536797,161771,31853,23287,5248,548,179,4521,3318,2219130,1597038,358714,238599,120115,263378,-3018,266396,66314,49239,17075,396,16679,33464,32434,15972,11
5,1,2,2,13,29.2,35.6,22.2,6537042,3753883,1417256,165397,36445,1215414,1365903,187838,34801,19985,7545,881,194,6471,7272,5177508,3743769,985558,690554,295004,448181,-1572,449753,118388,99022,19366,294,19072,43733,37807,23582,14
5,1,2,2,13.7,25.1,32.5,28.6,8431551,4987996,1962113,327502,52593,1582018,1481442,245706,34316,20301,7986,1333,214,6439,6029,8000249,5683255,1336911,925282,411629,980083,3250,976833,169784,137920,31864,873,30991,47120,41207,31520,7
6,1,8,6,23.4,37,28.2,11.4,245691,108909,92279,19224,2053,71002,44503,8907,27584,12227,10360,2158,230,7971,4996,103794,66513,22831,17741,5090,14450,8684,5766,3193,2042,1151,267,884,32507,32572,6523,0
6,1,8,7,20.5,37.6,28.7,13.3,404804,199853,147804,14890,2600,130314,57147,14287,28334,13988,10345,1042,182,9121,4000,168691,116963,32859,23235,9624,18869,268,18601,5505,3612,1893,337,1556,30643,32382,11954,0
6,1,9,10,19.9,39.9,28.6,11.6,404661,212498,139617,18058,2709,118850,52546,13607,29739,15617,10261,1327,199,8734,3862,240572,169890,40603,28207,12396,30079,1205,28874,5503,3930,1573,232,1341,43717,43229,21532,0
6,1,8,4,20,42,21.1,16.9,282034,128293,116334,25893,2778,87663,37407,10472,26932,12251,11109,2473,265,8371,3572,128246,77082,23042,16754,6288,28122,5017,23105,3887,2725,1162,347,815,32994,28287,28350,0
6,1,9,10,20.9,43.2,23.9,12,307737,128972,132134,30581,2986,98567,46631,11440,26900,11274,11550,2673,261,8616,4076,168869,108783,29633,21574,8059,30453,7495,22958,4436,2919,1517,293,1224,38068,37267,18757,0
6,1,8,6,17.3,39.7,24.7,18.2,365878,185933,130769,26920,3170,100679,49176,13491,27120,13782,9693,1995,235,7463,3645,185433,114659,35067,26341,8726,35707,22627,13080,5308,3680,1628,381,1247,34935,31157,10489,0
6,1,3,2,18.9,42.7,23.9,14.4,466342,245055,153509,25744,3241,124524,67778,15358,30365,15956,9995,1676,211,8108,4413,159423,98980,29142,21166,7976,31301,14043,17258,5049,3252,1797,404,1393,31575,30437,12389,1
6,1,3,2,20.2,37.8,30.3,11.8,572168,292645,199871,26863,3941,169067,79652,19354,29563,15121,10327,1388,204,8736,4116,179740,119451,34713,25090,9623,25576,-2065,27641,5800,3908,1892,394,1498,30990,30566,18452,0
6,1,1,1,17.9,43.9,25,13.2,590755,348181,178141,22300,4197,151644,64433,22745,25973,15308,7832,980,185,6667,2833,224503,151968,43469,31421,12048,29066,1438,27628,6249,4497,1752,174,1578,35926,33793,17508,0
6,1,7,11,16.8,39.6,28.1,15.4,658510,341942,208655,32505,4293,171857,107913,20649,31891,16560,10105,1574,208,8323,5226,360642,249971,68421,49191,19230,42250,8569,33681,9855,7412,2443,448,1995,36595,33725,16883,0
6,1,7,11,17,46.7,23.8,12.5,631060,325933,210559,30568,5633,174358,94568,22800,27678,14295,9235,1341,247,7647,4148,363329,264278,68895,48388,20507,30156,6900,23256,9598,7163,2435,448,1987,37855,36895,11704,1
6,1,6,4,22.8,36.2,28.1,12.9,673015,331455,225835,23252,5847,196736,115725,24354,27635,13610,9273,955,240,8078,4752,328482,218239,63784,44770,19014,46459,-291,46750,10552,7529,3023,501,2522,31130,28986,18537,0
6,1,7,11,18.5,44.3,24.2,13,754710,403722,236918,35957,7160,193801,114070,25582,29502,15781,9261,1406,280,7576,4459,432746,303254,82180,58690,23490,47312,3448,43864,12081,8902,3179,255,2924,35820,34066,15001,2
6,1,7,11,19.3,35.3,31.9,13.4,802465,407479,271163,29742,8046,233375,123823,30650,26182,13295,8847,970,263,7614,4040,440450,312953,85736,59968,25768,41761,1603,40158,13137,10001,3136,671,2465,33527,31292,16291,0
6,1,3,2,16.1,33.7,31.4,18.8,1782625,981614,518335,52421,10919,454995,282676,54534,32688,18000,9505,961,200,8343,5183,1293102,945576,251532,174883,76649,95994,-5037,101031,29600,23603,5997,636,5361,43686,40062,18846,1
6,1,4,3,17.9,35.9,31.3,14.9,2495225,1438623,686963,65696,15254,606013,369639,80411,31031,17891,8543,817,190,7536,4597,1294923,903025,234420,163066,71354,157478,-25456,182934,37778,27355,10423,1914,8509,34277,33011,21499,4
6,1,3,2,14.1,35.3,28.1,22.5,2966408,1668016,748645,71289,17657,659699,549747,92603,32034,18013,8084,770,191,7124,5937,1444915,978945,259959,181336,78623,206011,1797,204214,44283,32881,11402,1390,10012,32629,29772,20397,5
6,1,3,2,9.8,27.8,31.7,30.7,7051666,4109280,1484827,114978,32134,1337715,1457559,186534,37804,22030,7960,616,172,7171,7814,2907152,2060271,499507,337777,161730,347374,-3372,350746,92000,65394,26606,881,25725,31599,31506,13634,8
6,1,3,2,11.8,29.4,28.5,30.2,6538971,3938538,1440211,170722,35310,1234179,1160222,196699,33244,20023,7322,868,180,6274,5898,5010051,3679005,951896,677242,274654,379150,96,379054,109815,91406,18409,464,17945,45623,40249,21123,11
6,1,2,2,13.7,32.6,30.6,23,13915628,8407377,3365360,509711,89759,2765890,2142891,413232,33675,20345,8144,1233,217,6693,5186,10559524,7614705,1829721,1246555,583166,1115098,14543,1100555,233197,182072,51125,630,50495,45282,41822,21795,13
6,1,1,1,10.6,26.8,30.7,31.9,28624737,17881162,5362918,700227,125114,4537577,5380657,657789,43517,27184,8153,1065,190,6898,8180,24612092,17252453,3970503,2685963,1284540,3389136,-1324,3390460,442708,362397,80311,365,79946,55594,47607,42409,51
6,1,6,6,18.6,36.7,26.2,18.4,347734,163183,93336,9767,1542,82027,91215,11469,30319,14228,8138,852,134,7152,7953,175044,107428,30119,22289,7830,37497,0,37497,5513,3566,1947,0,1947,31751,30126,19259,1
6,1,3,2,15.7,36.6,29.2,18.5,424176,208108,124207,11160,2656,110391,91861,15760,26915,13205,7881,708,169,7005,5829,183964,129389,37914,28585,9329,16661,0,16661,5283,3727,1556,0,1556,34822,34717,10708,1
6,1,3,2,14.1,26.5,32.6,26.7,2339358,1217028,424697,36044,9295,379358,697633,55588,42084,21894,7640,648,167,6824,12550,980061,673388,155571,104883,50688,151102,3535,147567,30490,20560,9930,629,9301,32144,32752,15866,7
6,1,4,3,8.8,27.8,31.6,31.8,4622667,1915266,546342,40664,13052,492626,2161059,73981,62485,25889,7385,550,176,6659,29211,2165806,1558688,356400,239221,117179,250718,0,250718,54536,38281,16255,0,16255,39713,40717,15424,19
6,1,2,2,9.3,27.1,36.4,27.1,5854191,3653045,1101966,87118,24135,990713,1099180,155727,37593,23458,7076,559,155,6362,7058,1960491,1301827,343077,241825,101252,315587,10487,305100,52504,35842,16662,583,16079,37340,36321,18975,20
6,1,3,2,8.4,25.3,36.6,29.8,7596202,4141763,1472093,112385,30236,1329472,1982346,183080,41491,22623,8041,614,165,7262,10828,5696835,4211663,1230084,877001,353083,255088,-329,255417,117932,95620,22312,439,21873,48306,44046,11677,13
6,1,3,2,10.9,30.9,35.9,22.4,6402397,3569879,1473075,143154,42178,1287743,1359443,169521,37768,21059,8690,844,249,7596,8019,4079017,3001097,776266,543694,232572,301654,-69,301723,96586,77704,18882,101,18781,42232,38622,16065,7
6,1,2,2,9.4,27.3,37.3,26,10735004,5931517,2599012,294896,56985,2247131,2204475,299366,35859,19814,8682,985,190,7506,7364,7858787,5795149,1556315,1099609,456706,507323,6184,501139,167958,139233,28725,662,28063,46790,41622,17858,20
6,1,2,2,13.5,26.4,25.2,34.9,21341492,7405497,2708576,199013,59748,2449815,11227419,327667,65132,22601,8266,607,182,7477,34265,7751079,5301096,1053556,676066,377490,1396427,41647,1354780,176891,123692,53199,243,52956,43818,42857,25583,61
6,1,1,1,11.4,27.2,29.9,31.5,74286685,45067146,12678820,1432527,462147,10784146,16540719,1787691,41555,25210,7092,801,259,6032,9253,46968596,34328085,7164269,4699091,2465178,5476242,4107,5472135,1005533,741259,264274,382,263892,46710,46311,20736,360
6,1,1,1,19,28.2,25,27.8,100313162,57025967,21611611,3312286,694427,17604898,21675584,2571532,39009,22176,8404,1288,270,6846,8429,69648351,50672602,10853137,7247149,3605988,8122612,117378,8005234,1468645,1054545,414100,2063,412037,47424,48052,19428,290
6,1,9,10,23.8,45.9,20.6,9.7,191195,107360,48361,8183,1090,39088,35474,5092,37548,21084,9497,1607,214,7676,6967,111759,45772,13395,10409,2986,52592,44386,8206,2110,1397,713,217,496,52966,32764,16544,0
6,1,8,7,18.5,42.6,23.2,15.6,281429,158786,76604,11500,1261,63843,46039,9082,30988,17484,8435,1266,139,7030,5069,159328,114521,29326,22121,7205,15481,-1,15482,4143,2901,1242,217,1025,38457,39476,15104,0
6,1,6,6,24.6,41.7,21.5,12.2,444515,267386,125115,9798,1606,113711,52014,14930,29773,17909,8380,656,108,7616,3484,252233,181089,47149,36073,11076,23995,-168,24163,6285,4940,1345,163,1182,40133,36658,20442,2
6,1,2,2,18.5,33.9,24.6,23,461691,299448,80158,8377,1682,70099,82085,15504,29779,19314,5170,540,108,4521,5294,393220,273248,82979,68273,14706,36993,8676,28317,7030,5510,1520,142,1378,55935,49591,20549,1
6,1,8,7,23.1,42.8,21.8,12.4,301019,164750,98763,10883,1695,86185,37506,10128,29721,16267,9751,1075,167,8510,3703,120108,81657,23471,18214,5257,14980,1433,13547,3865,2704,1161,251,910,31076,30199,14887,0
6,1,9,10,22.6,41.6,21.9,13.9,317484,178865,101094,12049,1797,87248,37525,10284,30872,17393,9830,1172,175,8484,3649,153968,79429,22959,17786,5173,51580,16530,35050,4218,2802,1416,474,942,36503,28347,37208,0
6,1,7,11,29.5,39.3,21.5,9.8,247053,117587,85197,17177,1832,66188,44269,7657,32265,15357,11127,2243,239,8644,5782,125921,65688,19692,15594,4098,40541,31822,8719,2862,2164,698,178,520,43998,30355,16767,0
6,1,7,9,24.7,39.3,22.5,13.4,338140,191109,105225,22051,2166,81008,41806,11975,28237,15959,8787,1841,181,6765,3491,194645,103144,33002,26389,6613,58499,39590,18909,5065,3806,1259,250,1009,38429,27100,18740,0
6,1,6,6,20.9,42.4,23.8,13,501060,296796,147372,14884,2264,130224,56892,16350,30646,18153,9014,910,138,7965,3480,249522,140639,38202,29881,8321,70681,-380,71061,5267,3892,1375,170,1205,47375,36135,58972,1
6,1,6,6,20.1,43.7,23.1,13.1,460107,269807,131425,16156,2266,113003,58875,15148,30374,17811,8676,1067,150,7460,3887,289204,175519,44595,32528,12067,69090,1442,67648,6626,5409,1217,154,1063,43647,32449,63639,0
6,1,6,6,20.6,41.3,24.1,14,504236,269626,149488,19069,2502,127917,85122,16936,29773,15920,8827,1126,148,7553,5026,251259,167475,44611,34713,9898,39173,11556,27617,6027,4512,1515,241,1274,41689,37118,21677,0
6,1,1,1,17.8,36.3,26.6,19.3,965968,680507,147155,14789,2689,129677,138306,23588,40952,28850,6239,627,114,5498,5863,1324354,955601,228416,166552,61864,140337,9557,130780,19768,16344,3424,112,3312,66995,58468,39487,2
6,1,6,6,16.5,44.7,24.6,14.2,725052,393031,212854,19012,2795,191047,119167,24425,29685,16091,8715,778,114,7822,4879,320669,192967,53411,41150,12261,74291,15306,58985,8596,6021,2575,333,2242,37304,32049,26309,0
6,1,9,10,23,44.8,20.3,12,313983,166434,110538,13015,2852,94671,37011,11516,27265,14452,9599,1130,248,8221,3214,131634,74475,22927,18325,4602,34232,17565,16667,4043,2520,1523,677,846,32558,29554,19701,0
6,1,3,2,18.2,42.3,31.1,8.5,606320,366223,166300,20034,2962,143304,73797,22370,27104,16371,7434,896,132,6406,3299,214954,136052,45019,35599,9420,33883,1628,32255,5414,3680,1734,212,1522,39703,36971,21193,0
6,1,3,2,14.2,46.6,26.5,12.8,701761,403054,201208,23428,3316,174464,97499,22754,30841,17714,8843,1030,146,7667,4285,241324,156627,43991,33420,10571,40706,6863,33843,8052,5308,2744,367,2377,29971,29508,14238,2
6,1,7,8,23.6,40.6,24.4,11.4,701528,427684,185280,29867,3558,151855,88564,20835,33671,20527,8893,1434,171,7288,4251,429016,197357,54151,41677,12474,177508,20857,156651,8446,6416,2030,396,1634,50795,30760,95870,0
6,1,2,2,17.1,37.5,25.3,20.1,961690,690841,162429,21921,3628,136880,108420,24097,39909,28669,6741,910,151,5680,4499,747364,535910,128321,91759,36562,83133,438,82695,14721,12159,2562,95,2467,50769,44075,33520,0
6,1,2,2,21.2,37.9,25.1,15.8,851942,528723,187296,23909,3672,159715,135923,22797,37371,23193,8216,1049,161,7006,5962,375485,230816,63001,46782,16219,81668,19902,61766,9421,6361,3060,340,2720,39856,36286,22708,0
6,1,6,6,20.4,42.6,23.9,13.1,695476,413897,187850,21294,3725,162831,93729,25741,27018,16079,7298,827,145,6326,3641,414786,291226,90469,73407,17062,33091,-1362,34453,10795,8961,1834,367,1467,38424,32499,23485,0
6,1,6,6,21,40.7,22.5,15.8,1033550,626689,247284,26022,3738,217524,159577,31590,32718,19838,7828,824,118,6886,5052,463887,312494,81174,61492,19682,70219,12636,57583,12452,9316,3136,555,2581,37254,33544,22310,0
6,1,2,2,17.4,42.3,26.8,13.5,960124,546158,221212,29259,3817,188136,192754,26774,35860,20399,8262,1093,143,7027,7199,491986,369638,87132,65263,21869,35216,-7480,42696,11679,8335,3344,574,2770,42126,44348,15414,6
6,1,7,11,24.8,42.2,21.5,11.4,600008,320599,205250,28910,3889,172451,74159,20768,28891,15437,9883,1392,187,8304,3571,297813,157013,46747,36756,9991,94053,53908,40145,8640,5780,2860,848,2012,34469,27165,19953,0
6,1,6,6,20.6,39,25,15.4,647956,370333,199277,26810,3938,168529,78346,20889,31019,17729,9540,1283,189,8068,3751,333450,210441,56705,42393,14312,66304,25858,40446,9800,7015,2785,662,2123,34026,29999,19051,0
6,1,6,6,26,38.4,22.7,12.9,1034069,584101,314485,44731,4503,265251,135483,33822,30574,17270,9298,1323,133,7843,4006,467090,299340,81020,61611,19409,86730,16447,70283,11954,8905,3049,602,2447,39074,33615,28722,3
6,1,6,4,26.4,42.5,20.8,10.3,839012,560665,184015,24810,4722,154483,94332,23176,36202,24192,7940,1071,204,6666,4070,330109,191053,46121,33608,12513,92935,7549,85386,6701,4829,1872,60,1812,49263,39564,47123,0
6,1,1,1,15.8,44.5,25.7,14,860863,612969,166423,21959,4793,139671,81471,21784,39518,28138,7640,1008,220,6412,3740,683588,464169,128395,99796,28599,91024,3349,87675,10128,8040,2088,45,2043,67495,57732,42915,0
6,1,2,2,22.5,38.8,23.8,15,1147911,728706,265781,41213,5759,218809,153424,33353,34417,21848,7969,1236,173,6560,4600,1096460,825796,206945,156624,50321,63719,7477,56242,17871,14691,3180,134,3046,61354,56211,18464,1
6,1,1,1,18.3,39.1,30.5,12.1,1168105,730851,252675,40188,5842,206645,184579,39505,29569,18500,6396,1017,148,5231,4672,776495,539712,145555,112179,33376,91228,3571,87657,16214,11885,4329,36,4293,47890,45411,20419,1
6,1,6,6,26.1,39.3,23.3,11.3,1372726,787976,403401,56122,5854,341425,181349,41795,32844,18853,9652,1343,140,8169,4339,600270,372272,102073,79746,22327,125925,30956,94969,16711,12243,4468,805,3663,35921,30407,25927,0
6,1,6,5,15,33.1,32.6,19.4,1264005,740821,336427,51502,6043,278882,186757,39371,32105,18816,8545,1308,153,7083,4744,727992,465598,132288,103913,28375,130106,14546,115560,18787,14234,4553,530,4023,38750,32710,28725,1
6,1,6,5,19.7,44.2,22.2,13.9,884212,467556,303752,50627,6531,246594,112904,27476,32181,17017,11055,1843,238,8975,4109,381521,220534,60268,45294,14974,100719,53865,46854,10648,7527,3121,369,2752,35830,29299,17025,0
6,1,6,3,23.4,41.1,23.3,12.2,1376803,714836,487358,64758,6537,416063,174609,47155,29197,15159,10335,1373,139,8823,3703,554691,377974,109673,87594,22079,67044,1116,65928,16030,11016,5014,723,4291,34603,34311,15364,2
6,1,2,2,18.7,39.4,26.5,15.5,1374295,796337,387067,45347,6681,335039,190891,41233,33330,19313,9387,1100,162,8126,4630,717138,517067,121801,88220,33581,78270,-2316,80586,18259,13764,4495,386,4109,39276,37567,19612,0
6,1,2,2,24.2,41.7,22,12.1,2065342,1367614,409513,47948,6721,354844,288215,58210,35481,23494,7035,824,115,6096,4951,939366,608634,141831,103351,38480,188901,53208,135693,21931,14886,7045,1043,6002,42833,40886,22608,3
6,1,2,2,22.4,40.8,24.7,12.2,2027680,1284851,480395,62393,6924,411078,262434,61826,32797,20782,7770,1009,112,6649,4245,901813,581255,141579,103678,37901,178979,26350,152629,23282,16637,6645,741,5904,38734,34937,25852,1
6,1,1,1,11.8,35.4,30.5,22.3,2222894,1614806,324521,38270,7120,279131,283567,52376,42441,30831,6196,731,136,5329,5414,1989165,1467292,376745,284998,91747,145128,-176,145304,30942,24927,6015,57,5958,64287,58864,24388,3
6,1,4,5,11.8,26.8,25.2,36.2,1492059,852700,331754,42294,7363,282097,307605,47053,31710,18122,7051,899,156,5995,6537,997538,669574,175330,133527,41803,152634,6281,146353,25107,19578,5529,288,5241,39731,34200,27925,7
6,1,1,1,15.8,37.3,30.5,16.4,1594668,1084832,337290,55351,8053,273886,172546,45052,35396,24080,7487,1229,179,6079,3830,1116158,785272,201540,150883,50657,129346,1856,127490,21750,15987,5763,18,5745,51318,49119,22191,3
6,1,5,8,12.5,36.6,33.2,17.7,1935037,1223841,341724,39129,8548,294047,369472,52243,37039,23426,6541,749,164,5628,7072,1687969,1174254,444754,337671,107083,68961,-3486,72447,29128,25787,3341,422,2919,57950,45537,24819,1
6,1,4,5,20.2,48.9,20.2,10.6,1939640,1167259,450866,64524,8955,377387,321515,54135,35830,21562,8329,1192,165,6971,5939,1726062,1293527,279109,197355,81754,153426,-621,154047,33334,27868,5466,100,5366,51781,46416,28708,3
6,1,2,2,21.5,43.5,22.3,12.7,2731545,1728819,588720,88697,10129,489894,414006,73504,37162,23520,8009,1207,138,6665,5632,2087129,1515384,305478,206787,98691,266267,180,266087,43322,33858,9464,222,9242,48177,44757,28791,6
6,1,3,2,23.9,39.7,20.1,16.3,3872661,2663319,677046,74301,10771,591974,532296,97011,39920,27454,6979,766,111,6102,5487,2836499,1896072,441790,323370,118420,498637,22821,475816,49694,39770,9924,345,9579,57079,47676,49673,1
6,1,3,2,21.7,39.6,24.3,14.4,4316108,2911586,796477,101162,12205,683110,608045,111593,38677,26091,7137,907,109,6121,5449,3533123,2659975,539361,367827,171534,333787,10785,323002,68533,56728,11805,141,11664,51554,46890,27692,6
6,1,4,5,23.5,42.4,20.5,13.5,2910566,1691845,813850,122258,12553,679039,404871,83430,34886,20279,9755,1465,150,8139,4853,1308454,899688,236864,180144,56720,171902,5023,166879,36413,26581,9832,1148,8684,35934,33847,19217,2
6,1,2,2,11.2,28.7,34.5,25.7,4669126,2981792,847438,84156,13937,749345,839896,120023,38902,24844,7061,701,116,6243,6998,2917614,2114736,574567,416952,157615,228311,-1053,229364,66056,52796,13260,404,12856,44169,40055,17841,13
6,1,2,2,11.6,33.9,26.9,27.6,4511956,3424751,617716,69707,14922,533087,469489,109996,41019,31135,5616,634,136,4846,4268,2431410,1796276,418715,302292,116423,216419,2626,213793,50818,38828,11990,215,11775,47845,46262,18157,8
6,1,2,2,14.7,40.4,27.5,17.4,4525652,3263725,793701,88115,17757,687829,468226,130160,34770,25075,6098,677,136,5284,3597,1360492,851482,212554,158542,54012,296456,-489,296945,37908,24435,13473,365,13108,35889,34847,22654,4
6,1,3,2,15.3,37.1,27.5,20.1,5032572,2847373,1307253,146726,18702,1141825,877946,132004,38124,21570,9903,1112,142,8650,6651,3416462,2341205,591381,436365,155016,483876,42433,441443,76381,62894,13487,737,12750,44729,37225,34623,6
6,1,3,2,18,36.2,25.9,19.9,4176404,2604596,1074318,149663,20360,904295,497490,122629,34057,21240,8761,1220,166,7374,4057,2522452,1658120,427527,326437,101090,436805,7736,429069,60288,45422,14866,954,13912,41840,36505,30842,5
6,1,3,2,14.4,34,27.3,24.3,5318238,3172570,1268977,193964,23452,1051561,876691,154594,34401,20522,8208,1255,152,6802,5671,3766558,2644441,636689,466492,170197,485428,15321,470107,94428,72559,21869,381,21488,39888,36445,21878,3
6,1,3,2,13.9,33.9,30.5,21.7,6950079,4383465,1447295,168166,26489,1252640,1119319,193813,35860,22617,7467,868,137,6463,5775,5130085,3681600,928257,689233,239024,520228,3006,517222,108662,88128,20534,782,19752,47211,41776,26186,7
6,1,2,2,13,28.9,26.2,31.8,10033726,6790604,1405984,169960,27296,1208728,1837138,224375,44719,30265,6266,757,122,5387,8188,9134100,6604345,1287047,860070,426977,1242708,3434,1239274,177271,141314,35957,549,35408,51526,46735,35000,52
6,1,1,1,10.5,25.9,31.1,32.5,11077112,7561210,1682267,128593,27463,1526211,1833635,236780,46782,31933,7105,543,116,6446,7744,5288424,3394942,767048,552866,214182,1126434,2732,1123702,118624,82977,35647,512,35135,44581,40914,31982,22
6,1,2,2,13.5,33.2,29.4,24,10485395,6104468,2110113,310356,36758,1762999,2270814,256997,40800,23753,8211,1208,143,6860,8836,7657243,5315993,1259497,908884,350613,1081753,7292,1074461,164810,128772,36038,512,35526,46461,41282,30244,12
6,1,1,1,14.1,23,26.4,36.5,15111718,9154765,2661636,494502,56769,2110365,3295317,360661,41900,25383,7380,1371,157,5851,9137,13888269,9710821,2166204,1520788,645416,2011244,0,2011244,247365,196983,50382,0,50382,56145,49298,39920,13
6,1,1,1,15.1,31.4,28.3,25.2,18520809,12136588,3279499,356450,60944,2862105,3104722,434034,42671,27962,7556,821,140,6594,7153,13703826,9411349,1912074,1295453,616621,2380403,4920,2375483,266137,206282,59855,51,59804,51492,45624,39721,54
6,1,2,2,9.8,27.2,28.6,34.5,18631247,12151853,3077848,456460,66721,2554667,3401546,441158,42233,27545,6977,1035,151,5791,7710,16760354,12136448,2790689,2029819,760870,1833217,186,1833031,332022,270498,61524,381,61143,50480,44867,29979,47
6,1,8,7,34.4,38.2,21.3,6.1,33897,18351,9324,1934,415,6975,6222,1394,24316,13164,6689,1387,298,5004,4463,14537,7433,2035,1374,661,5069,3929,1140,456,315,141,65,76,31879,23597,15000,0
6,1,8,7,24.7,25.3,28.6,21.5,143200,62842,57957,11187,1222,45548,22401,4874,29380,12893,11891,2295,251,9345,4596,62362,37414,9674,6707,2967,15274,9449,5825,1996,1408,588,97,491,31243,26572,11864,0
6,1,9,10,15.5,37.8,30.6,16.2,232591,121374,79954,8868,1298,69788,31263,7985,29128,15200,10013,1111,163,8740,3915,92503,62882,17188,12397,4791,12433,874,11559,2785,1876,909,167,742,33215,33519,15578,1
6,1,9,10,18.6,35.6,28.5,17.3,219045,113893,75358,9187,1404,64767,29794,8443,25944,13490,8926,1088,166,7671,3529,105889,71981,18942,13441,5501,14966,979,13987,3145,2187,958,223,735,33669,32913,19030,0
6,1,1,1,26.9,35.5,27.3,10.3,209183,108193,76404,11232,1613,63559,24586,8715,24003,12415,8767,1289,185,7293,2821,56076,35497,9511,6469,3042,11068,-748,11816,2312,1169,1143,268,875,24254,30365,13504,0
6,1,9,10,14.8,36.1,30.9,18.1,317412,167230,113300,11959,1714,99627,36882,10182,31174,16424,11127,1175,168,9785,3622,111361,66335,17054,11561,5493,27972,5589,22383,4144,2381,1763,320,1443,26873,27860,15511,0
6,1,9,8,17.9,34.5,31.2,16.4,321903,183741,97492,10830,1787,84875,40670,10432,30857,17613,9345,1038,171,8136,3899,77792,40352,10571,7131,3440,26869,7556,19313,2793,1435,1358,448,910,27852,28120,21223,0
6,1,8,7,30.2,36.5,18.4,14.9,252152,123373,90078,15255,1797,73026,38701,9584,26310,12873,9399,1592,188,7620,4038,106349,78906,18621,12201,6420,8822,-50,8872,3667,2598,1069,156,913,29002,30372,9717,0
6,1,9,8,20,33,33.9,13.1,242949,113903,96875,12937,2034,81904,32171,10308,23569,11050,9398,1255,197,7946,3121,111349,79616,21627,15230,6397,10106,884,9222,3508,2620,888,348,540,31741,30388,17078,1
6,1,8,5,21.1,38.9,26.7,13.2,342914,171994,126977,15734,2047,109196,43943,13133,26111,13096,9669,1198,156,8315,3346,88304,61001,15318,10471,4847,11985,-3464,15449,3682,2181,1501,511,990,23983,27969,15605,0
6,1,3,2,19.3,38.6,31.6,10.6,315082,168902,111748,13638,2187,95923,34432,12150,25933,13901,9197,1122,180,7895,2834,128463,97226,21260,14375,6885,9977,-4172,14149,3565,2455,1110,280,830,36035,39603,17047,0
6,1,7,9,19.8,33.7,25.6,21,306877,149226,114548,13439,2216,98893,43103,10768,28499,13858,10638,1248,206,9184,4003,126242,82392,21181,14654,6527,22669,6581,16088,4092,2973,1119,302,817,30851,27713,19692,0
6,1,8,7,18.6,37.5,30.1,13.8,353094,181918,131317,14103,2228,114986,39859,12724,27750,14297,10320,1108,175,9037,3133,154044,109539,25872,18068,7804,18633,-615,19248,4275,2794,1481,361,1120,36034,39205,17186,0
6,1,8,7,19.8,42.3,26.8,11,430103,239808,142118,16825,2256,123037,48177,16531,26018,14507,8597,1018,136,7443,2914,163447,105809,28950,20253,8697,28688,5663,23025,5128,3235,1893,586,1307,31873,32708,17617,0
6,1,7,9,31.8,30.1,25.3,12.9,307029,155068,115918,24000,2339,89579,36043,11291,27192,13734,10266,2126,207,7934,3192,138181,77267,21256,14955,6301,39658,14904,24754,4549,2848,1701,496,1205,30376,27130,20543,0
6,1,8,7,24.1,36.8,30.5,8.7,336687,194026,105738,12334,2355,91049,36923,14327,23500,13543,7380,861,164,6355,2577,96785,66454,19145,14058,5087,11186,-1364,12550,3432,2295,1137,347,790,28201,28956,15886,0
6,1,9,10,24.6,35.9,28.2,11.2,412890,216581,145572,16362,2363,126847,50737,14906,27700,14530,9766,1098,159,8510,3404,177839,107944,27728,18966,8762,42167,20249,21918,5830,3925,1905,538,1367,30504,27502,16034,0
6,1,8,7,24.3,35.8,25,15,306135,147872,121075,18790,2375,99910,37188,12169,25157,12152,9949,1544,195,8210,3056,97826,67572,16797,11240,5557,13457,-985,14442,3605,2109,1496,307,1189,27136,32040,12146,0
6,1,7,9,19,37,30,14,379475,189641,139084,16764,2415,119905,50750,12516,30319,15152,11112,1339,193,9580,4055,166330,106540,27750,19014,8736,32040,7047,24993,5328,3460,1868,317,1551,31218,30792,16114,0
6,1,9,10,19.8,45,24.8,10.3,384849,192123,145612,19526,2657,123429,47114,15374,25032,12497,9471,1270,173,8028,3065,133641,82697,22101,15440,6661,28843,-1947,30790,4957,3058,1899,599,1300,26960,27043,23685,0
6,1,6,6,17.4,34.9,32.7,15,521884,283992,169073,15519,2824,150730,68819,17890,29172,15874,9451,867,158,8425,3847,195802,141066,35337,24334,11003,19399,-1493,20892,6703,4515,2188,239,1949,29211,31244,10719,0
6,1,9,8,21.1,34.9,30.8,13.3,509294,285347,168168,17651,2891,147626,55779,16696,30504,17091,10072,1057,173,8842,3341,150116,103888,26104,17895,8209,20124,-1801,21925,5143,3387,1756,300,1456,29188,30673,15058,0
6,1,8,6,18.3,36.8,28.8,16.1,542452,291601,174398,22933,2932,148533,76453,19481,27845,14968,8952,1177,151,7625,3924,242966,169959,42832,29321,13511,30175,-4572,34747,8008,5599,2409,443,1966,30340,30355,17674,0
6,1,7,9,29.1,34.6,26.2,10.1,375123,201385,126976,23579,2955,100442,46762,15317,24491,13148,8290,1539,193,6558,3053,171420,92262,22582,15107,7475,56576,31286,25290,4821,3369,1452,428,1024,35557,27386,24697,0
6,1,9,8,15.9,37.3,32.9,13.9,486989,264741,161491,19816,2962,138713,60757,16850,28901,15712,9584,1176,176,8232,3606,218882,161238,39979,26892,13087,17665,-2125,19790,6504,4705,1799,401,1398,33653,34270,14156,0
6,1,1,1,21.3,29.5,32,17.1,307170,166365,94567,21650,3175,69742,46238,10580,29033,15724,8938,2046,300,6592,4370,484513,386662,69345,35556,33789,28506,19459,9047,13203,11923,1280,82,1198,36697,32430,7552,0
6,1,7,9,16.7,29.9,37.1,16.3,614807,321552,212690,22895,3241,186554,80565,21418,28705,15013,9930,1069,151,8710,3762,261849,190384,50108,34819,15289,21357,-3179,24536,8496,6415,2081,509,1572,30820,29678,15608,1
6,1,6,6,22.6,30.9,34.1,12.3,589074,343730,177731,22937,3308,151486,67613,19389,30382,17728,9167,1183,171,7813,3487,296573,154992,38774,26448,12326,102807,6222,96585,7163,5142,2021,414,1607,41403,30142,60103,0
6,1,6,6,21.7,38.3,27.9,12.1,541862,288288,188070,25400,3481,159189,65504,23255,23301,12397,8087,1092,150,6845,2817,239141,166701,42719,28592,14127,29721,-3877,33598,8407,5966,2441,569,1872,28445,27942,17948,0
6,1,7,9,25.5,36.5,26.2,11.8,508374,272411,161966,20290,3556,138120,73997,17495,29058,15571,9258,1160,203,7895,4230,300700,196355,47315,30356,16959,57030,16174,40856,8806,6494,2312,495,1817,34147,30236,22485,0
6,1,7,9,24.9,37.4,25,12.6,588480,316481,183155,27688,3684,151783,88844,20611,28552,15355,8886,1343,179,7364,4311,289498,189146,46375,31391,14984,53977,49,53928,8033,5891,2142,436,1706,36039,32108,31611,0
6,1,8,6,20.9,40.9,26.7,11.5,524812,263695,191654,14901,3731,173022,69463,19623,26745,13438,9767,759,190,8817,3540,239509,168666,43918,29805,14113,26925,109,26816,7270,5591,1679,265,1414,32945,30167,18965,0
6,1,2,2,20.7,35.2,30.8,13.3,807634,440113,276061,29803,3917,242341,91460,27392,29484,16067,10078,1088,143,8847,3339,346161,226765,56718,38488,18230,62678,281,62397,11526,8414,3112,539,2573,30033,26951,24251,0
6,1,7,8,22.3,30.1,34.6,13,673562,368406,224077,16254,3935,203888,81079,23268,28948,15833,9630,699,169,8763,3485,267281,185838,46453,31295,15158,34990,2640,32350,7695,5940,1755,396,1359,34734,31286,23804,0
6,1,6,4,22.4,33.7,29.4,14.5,612692,328497,208337,22815,4046,181476,75858,22026,27817,14914,9459,1036,184,8239,3444,301589,207404,52710,35389,17321,41475,662,40813,9461,6634,2827,598,2229,31877,31264,18310,0
6,1,7,9,21.8,32.8,31.4,14.1,958784,562872,262863,32977,4103,225783,133049,29730,32250,18933,8842,1109,138,7594,4475,685990,429647,102406,69814,32592,153937,2222,151715,16525,13589,2936,593,2343,41512,31617,64752,1
6,1,7,8,21.2,29,31.7,18.1,680172,352815,223402,28608,4186,190608,103955,21608,31478,16328,10339,1324,194,8821,4811,471683,332426,82612,54975,27637,56645,5400,51245,12885,10428,2457,277,2180,36607,31878,23507,0
6,1,7,9,20.9,33.5,29.7,15.9,520727,252021,190477,26165,4213,160099,78229,19040,27349,13236,10004,1374,221,8409,4109,222790,164285,39292,25838,13454,19213,-268,19481,7341,5224,2117,453,1664,30349,31448,11707,0
6,1,6,6,20.6,37.1,30.3,11.9,655376,414347,166055,17267,4213,144575,74974,22845,28688,18137,7269,756,184,6329,3282,213503,150894,39153,27421,11732,23456,-1868,25324,7406,4993,2413,512,1901,28828,30221,13321,0
6,1,6,6,22.1,37.4,27.6,12.9,695090,332426,259541,35789,4373,219379,103123,26672,26061,12463,9731,1342,164,8225,3866,396519,295543,66308,42882,23426,34668,-5704,40372,11802,8909,2893,481,2412,33598,33174,16738,0
6,1,7,9,21.8,33.3,32.6,12.3,657400,346945,225548,22344,4472,198732,84907,25353,25930,13685,8896,881,176,7839,3349,316667,228235,58180,39529,18651,30252,1008,29244,9578,7712,1866,447,1419,33062,29595,20609,0
6,1,6,6,24.7,41,23.6,10.7,490183,203580,234729,46919,4549,183261,51874,19076,25696,10672,12305,2460,238,9607,2719,195102,122923,32267,22246,10021,39912,10234,29678,6774,4291,2483,455,2028,28802,28647,14634,0
6,1,7,9,20,32,28.7,19.3,645692,374668,185266,28167,4808,152291,85758,20480,31528,18294,9046,1375,235,7436,4187,330260,185983,42784,27851,14933,101493,57200,44293,8119,5790,2329,368,1961,40677,32121,22587,0
6,1,2,2,23.6,36,26.1,14.3,752778,396488,241873,42940,4825,194108,114417,28264,26634,14028,8558,1519,171,6868,4048,379894,243500,65974,47119,18855,70420,34965,35455,10126,7119,3007,548,2459,37517,34204,14418,0
6,1,5,8,20.5,34.8,27.4,17.4,998787,493734,319770,44250,5046,270474,185283,32413,30814,15233,9865,1365,156,8345,5716,590312,397026,89106,57959,31147,104180,3120,101060,16362,12290,4072,168,3904,36078,32305,25886,0
6,1,6,4,21.7,33.2,30.5,14.7,749357,427054,217889,22701,5076,190112,104414,27290,27459,15649,7984,832,186,6966,3826,462916,327218,75772,49733,26039,59926,1109,58817,13293,9643,3650,619,3031,34824,33933,19405,0
6,1,1,1,19.5,31.5,32.9,16.1,840608,508087,239664,27231,5100,207333,92857,28745,29244,17676,8338,947,177,7213,3230,293425,194064,48883,33509,15374,50478,5277,45201,9745,6198,3547,507,3040,30110,31311,14869,3
6,1,2,2,21.5,30.7,34.5,13.3,849149,476864,273715,42977,5231,225507,98570,29284,28997,16284,9347,1468,179,7701,3366,393544,258321,70256,49398,20858,64967,1319,63648,11477,8326,3151,462,2689,34290,31026,23670,0
6,1,7,8,24,30.9,30.3,14.9,854802,528564,223164,24307,5236,193621,103074,29774,28710,17753,7495,816,176,6503,3462,505827,364223,83669,51005,32664,57935,-3455,61390,15302,11735,3567,777,2790,33056,31037,22004,0
6,1,6,5,13.4,36.7,34.9,15,1116792,659975,313823,35688,5363,272772,142994,34859,32037,18933,9003,1024,154,7825,4102,570345,407582,91700,60020,31680,71063,904,70159,16165,12179,3986,533,3453,35283,33466,20318,1
6,1,7,8,21.6,26.9,34.6,16.9,808036,376923,306981,55772,5527,245682,124132,25846,31263,14583,11877,2158,214,9506,4803,445402,298996,69447,45709,23738,76959,32494,44465,11977,9263,2714,217,2497,37188,32279,17807,0
6,1,7,8,27.8,29.4,28.3,14.5,720780,348396,267024,54950,5840,206234,105360,28515,25277,12218,9364,1927,205,7232,3695,411300,290979,76005,52899,23106,44316,8909,35407,12276,9942,2334,273,2061,33504,29268,17180,0
6,1,7,8,23.9,24.4,28.8,22.9,1067272,546982,352820,64916,6236,281668,167470,33794,31582,16186,10440,1921,185,8335,4956,594250,417943,106120,73282,32838,70187,7978,62209,16659,13352,3307,349,2958,35671,31302,21031,2
6,1,5,8,21.8,35.5,24.8,17.9,992958,474835,330168,60133,6554,263481,187955,32050,30982,14815,10302,1876,204,8221,5864,713318,497962,126014,86203,39811,89342,18501,70841,18527,15587,2940,243,2697,38502,31947,26267,0
6,1,7,8,19.2,33.5,31.3,15.9,1077178,565111,355482,35211,6560,313711,156585,37269,28903,15163,9538,945,176,8417,4201,632090,456059,108027,71385,36642,68004,2051,65953,17929,13712,4217,449,3768,35255,33260,17503,3
6,1,6,5,19.3,34.6,30.1,15.9,1109889,560140,385695,58524,6826,320345,164054,40430,27452,13855,9540,1448,169,7923,4058,666661,468039,115725,79348,36377,82897,-7285,90182,20696,15469,5227,454,4773,32212,30257,18894,0
6,1,2,2,15.3,27.6,36.2,20.9,1435265,815097,345093,33737,6959,304397,275075,44707,32104,18232,7719,755,156,6809,6153,1006442,727311,184017,125788,58229,95114,-1439,96553,19902,15376,4526,221,4305,50570,47302,22428,4
6,1,1,1,20.6,41.3,25,13.1,973059,564219,303376,48371,7150,247855,105464,36742,26484,15356,8257,1317,195,6746,2870,317939,217319,51821,34037,17784,48799,-3309,52108,11414,6817,4597,499,4098,27855,31879,12715,3
6,1,6,4,22.2,38.2,25.2,14.4,972718,557165,301515,48738,7203,245574,114038,34472,28218,16163,8747,1414,209,7124,3308,581605,386014,95285,64547,30738,100306,12431,87875,16020,11917,4103,628,3475,36305,32392,25288,0
6,1,4,3,10.5,18.9,28.8,41.9,1586401,909052,337492,25924,7270,304298,339857,48348,32812,18802,6980,536,150,6294,7029,1019354,723585,179514,125390,54124,116255,5248,111007,27220,20883,6337,397,5940,37449,34649,18688,3
6,1,7,9,20.1,35.5,27.9,16.5,1060737,582453,330399,35363,7394,287642,147885,36610,28974,15910,9025,966,202,7857,4039,531063,366709,93043,62604,30439,71311,4787,66524,13728,10493,3235,615,2620,38685,34948,25391,1
6,1,3,2,9.4,23.6,31.1,35.9,1882411,1244356,341175,34344,7692,299139,296880,57308,32847,21713,5953,599,134,5220,5180,858177,555267,125568,82036,43532,177342,2449,174893,27413,19024,8389,383,8006,31305,29188,21845,0
6,1,5,8,11.9,21.1,24.4,42.6,1388013,813872,316063,39136,8029,268898,258078,47721,29086,17055,6623,820,168,5635,5408,954293,686684,182050,130078,51972,85559,-2922,88481,26031,21251,4780,354,4426,36660,32313,19991,9
6,1,6,3,15.8,30,39.2,15,1802648,1064344,498550,53602,8321,436627,239754,55432,32520,19201,8994,967,150,7877,4325,564628,346394,90171,63661,26510,128063,25,128038,17690,11201,6489,708,5781,31918,30925,22148,10
6,1,4,5,17.8,31.1,32.6,18.4,2241791,1238099,675734,66703,9240,599791,327958,67903,33015,18233,9951,982,136,8833,4830,1562529,1136867,275751,189971,85780,149911,-10302,160213,37669,30689,6980,829,6151,41481,37045,26047,1
6,1,4,5,12.8,32.2,32.1,22.9,1680293,998119,410086,60846,9465,339775,272088,48306,34784,20662,8489,1260,196,7034,5633,1227601,910211,232207,159027,73180,85183,6264,78919,27492,22618,4874,196,4678,44653,40243,16870,1
6,1,5,8,15.3,30.7,30.4,23.6,1983918,1159599,480844,64312,10826,405706,343475,59591,33292,19459,8069,1079,182,6808,5764,1507199,1111386,275493,185775,89718,120320,-90,120410,34274,28023,6251,363,5888,43975,39660,20450,5
6,1,5,8,21.2,30.6,29.2,19,1590366,851165,513261,108126,12629,392506,225940,50442,31529,16874,10175,2144,250,7781,4479,938511,648176,156801,105176,51625,133534,15255,118279,25179,20076,5103,229,4874,37274,32286,24267,14
6,1,3,2,13.3,27.6,32.3,26.7,2466303,1358109,657000,77771,13132,566097,451194,75798,32538,17917,8668,1026,173,7468,5953,2092451,1470301,360785,249699,111086,261365,-3187,264552,48339,40245,8094,320,7774,43287,36534,34030,6
6,1,5,8,13.8,30.7,35.4,20.1,2546086,1447455,687992,88587,13571,585834,410639,80626,31579,17953,8533,1099,168,7266,5093,1864361,1344478,328267,219684,108583,191616,170,191446,45709,37561,8148,326,7822,40788,35795,24475,2
6,1,5,8,16.8,25.9,33.9,23.5,2839608,1755819,638293,74235,14778,549280,445496,84010,33801,20900,7598,884,176,6538,5303,2596168,1934180,420270,265037,155233,241718,3505,238213,62465,52915,9550,459,9091,41562,36553,26203,16
6,1,2,2,10.3,26.2,34.3,29.2,5431519,3671236,1006450,80995,17702,907753,753833,144147,37680,25469,6982,562,123,6297,5230,3177731,2248933,495487,323100,172387,433311,3247,430064,79506,61223,18283,597,17686,39968,36733,24317,13
6,1,1,1,10.6,29.5,36.4,23.5,5451216,3971845,896870,92908,23855,780107,582501,163977,33244,24222,5469,567,145,4757,3552,2325787,1658825,363967,232388,131579,302995,-512,303507,68165,50235,17930,389,17541,34120,33021,17303,17
6,1,2,2,12.2,31.6,35.6,20.7,4884492,2962702,1035820,106969,24947,903904,885970,139936,34905,21172,7402,764,178,6459,6331,3306590,2444123,633765,454704,179061,228702,-5961,234663,65271,52898,12373,367,12006,50659,46204,19545,1
6,1,2,2,13,29.2,35.6,22.2,6546512,3756880,1496403,175117,30672,1290614,1293229,190928,34288,19677,7838,917,161,6760,6773,5202313,3779849,1000928,688625,312303,421536,-261,421797,120611,99128,21483,288,21195,43133,38131,19901,8
6,1,2,2,13.7,25.1,32.5,28.6,9122274,5374909,2026560,343665,40690,1642205,1720805,248055,36775,21668,8170,1385,164,6620,6937,8335760,5746144,1340161,909435,430726,1249455,-126,1249581,171234,137412,33822,870,32952,48681,41817,37921,9
7,1,8,6,23.4,37,28.2,11.4,244151,108535,94877,18909,1419,74549,40739,8852,27581,12261,10718,2136,160,8422,4602,103937,68425,20956,15770,5186,14556,8124,6432,3210,2094,1116,257,859,32379,32677,7488,1
7,1,8,7,20.5,37.6,28.7,13.3,417327,210972,148149,14654,1638,131857,58206,14245,29296,14810,10400,1029,115,9256,4086,174820,121334,31683,21965,9718,21803,257,21546,5525,3693,1832,317,1515,31642,32855,14222,0
7,1,9,10,19.9,39.9,28.6,11.6,433709,234260,147133,17382,1812,127939,52316,13561,31982,17275,10850,1282,134,9434,3858,252987,181065,39696,27138,12558,32226,1124,31102,5513,4069,1444,225,1219,45889,44499,25514,0
7,1,9,10,20.9,43.2,23.9,12,308039,130509,131479,29641,2110,99728,46051,11306,27246,11543,11629,2622,187,8821,4073,168603,109877,27813,19954,7859,30913,6704,24209,4155,2932,1223,278,945,40578,37475,25618,0
7,1,8,6,17.3,39.7,24.7,18.2,380057,196224,132386,25727,2120,104539,51447,13428,28303,14613,9859,1916,158,7785,3831,194684,118043,33487,24729,8758,43154,29806,13348,5243,3680,1563,371,1192,37132,32077,11198,0
7,1,3,2,18.9,42.7,23.9,14.4,475689,253286,153253,24972,2398,125883,69150,15360,30969,16490,9977,1626,156,8196,4502,160578,98668,27215,19455,7760,34695,16234,18461,4989,3181,1808,391,1417,32186,31018,13028,0
7,1,8,4,20,42,21.1,16.9,276145,126063,112538,25248,2426,84864,37544,10184,27116,12379,11050,2479,238,8333,3687,125060,76097,21721,15512,6209,27242,4548,22694,3609,2665,944,337,607,34652,28554,37387,0
7,1,1,1,17.9,43.9,25,13.2,612395,365269,182582,22337,2840,157405,64544,22658,27028,16121,8058,986,125,6947,2849,234627,160378,42229,29609,12620,32020,1771,30249,6291,4607,1684,165,1519,37296,34812,19914,0
7,1,3,2,20.2,37.8,30.3,11.8,588218,303821,194835,25886,2864,166085,89562,19313,30457,15731,10088,1340,148,8600,4637,189757,120534,32600,23107,9493,36623,3119,33504,6022,3857,2165,373,1792,31511,31251,18696,0
7,1,7,11,16.8,39.6,28.1,15.4,672442,347688,211852,31755,2944,177153,112902,20360,33028,17077,10405,1560,145,8701,5545,366206,256522,64869,45723,19146,44815,11781,33034,9470,7384,2086,424,1662,38670,34740,19876,1
7,1,6,4,22.8,36.2,28.1,12.9,690016,348079,228463,21891,3582,202990,113474,24186,28530,14392,9446,905,148,8393,4692,352833,227096,60738,41324,19414,64999,5283,59716,10544,7604,2940,469,2471,33463,29865,24167,0
7,1,7,11,17,46.7,23.8,12.5,625478,314955,211391,29587,3691,178113,99132,22587,27692,13944,9359,1310,163,7886,4389,349542,262246,63946,43969,19977,23350,-481,23831,9367,7093,2274,434,1840,37316,36973,12952,0
7,1,7,11,19.3,35.3,31.9,13.4,832200,430094,267351,28074,4120,235157,134755,30480,27303,14111,8771,921,135,7715,4421,457708,323731,81505,55389,26116,52472,6022,46450,13177,10161,3016,646,2370,34735,31860,19599,4
7,1,7,11,18.5,44.3,24.2,13,757455,412337,235700,34174,4695,196831,109418,25152,30115,16394,9371,1359,187,7826,4350,435410,308635,76624,53649,22975,50151,2147,48004,11982,8792,3190,239,2951,36339,35104,16267,2
7,1,3,2,16.1,33.7,31.4,18.8,1795865,990937,518353,50529,8097,459727,286575,54569,32910,18159,9499,926,148,8425,5252,1305879,958611,240335,164324,76011,106933,-3271,110204,29770,23808,5962,616,5346,43866,40264,20614,1
7,1,4,3,17.9,35.9,31.3,14.9,2619743,1546848,693301,64420,12316,616565,379594,80275,32635,19269,8637,802,153,7681,4729,1380849,939955,225737,152717,73020,215157,8880,206277,38058,27776,10282,1784,8498,36283,33841,24274,7
7,1,3,2,14.1,35.3,28.1,22.5,3014212,1695862,753064,69120,12405,671539,565286,92652,32533,18304,8128,746,134,7248,6101,1464324,989694,245323,166824,78499,229307,1003,228304,43807,32603,11204,1320,9884,33427,30356,23098,4
7,1,3,2,9.8,27.8,31.7,30.7,7253460,4248007,1503447,118105,22696,1362646,1502006,190048,38166,22352,7911,621,119,7170,7903,3017308,2128293,480480,316018,164462,408535,122,408413,93226,66218,27008,833,26175,32366,32141,15603,6
7,1,3,2,11.8,29.4,28.5,30.2,6788344,4082888,1413606,168155,26356,1219095,1291850,198597,34182,20559,7118,847,133,6139,6505,5186982,3813488,930132,647405,282727,443362,1689,441673,112767,93057,19710,437,19273,45997,40980,22917,15
7,1,2,2,13.7,32.6,30.6,23,13857580,8322920,3355880,504155,63154,2788571,2178780,413737,33494,20116,8111,1219,153,6740,5266,10467562,7620034,1727693,1151333,576360,1119835,26800,1093035,229435,180322,49113,585,48528,45623,42258,22524,17
7,1,1,1,10.6,26.8,30.7,31.9,30003894,18658845,5336588,690907,85056,4560625,6008461,657668,45622,28371,8114,1051,129,6935,9136,25557836,18139151,3857674,2526000,1331674,3561011,643,3560368,446634,368402,78232,339,77893,57223,49237,45708,44
7,1,6,6,18.6,36.7,26.2,18.4,362377,168468,94118,10302,1075,82741,99791,11608,31218,14513,8108,887,93,7128,8597,186857,109936,30875,22653,8222,46046,0,46046,5375,3596,1779,0,1779,34764,30572,25883,3
7,1,3,2,15.7,36.6,29.2,18.5,434508,220726,125033,11145,1775,112113,88749,15769,27555,13997,7929,707,113,7110,5628,191101,128838,37099,27811,9288,25164,0,25164,5184,3654,1530,0,1530,36864,35259,16447,1
7,1,3,2,14.1,26.5,32.6,26.7,2616336,1403956,409583,36492,6282,366809,802797,57183,45754,24552,7163,638,110,6415,14039,1113539,732398,164963,109655,55308,216178,6325,209853,31848,21620,10228,607,9621,34964,33876,21812,15
7,1,4,3,8.8,27.8,31.6,31.8,5174156,2001765,527017,39644,8197,479176,2645374,74627,69334,26824,7062,531,110,6421,35448,2276886,1605010,365277,243318,121959,306599,0,306599,56240,39675,16565,0,16565,40485,40454,18509,16
7,1,2,2,9.3,27.1,36.4,27.1,6081061,3821746,1097702,87915,17461,992326,1161613,158205,38438,24157,6938,556,110,6272,7342,2062499,1355854,353842,246501,107341,352803,-2432,355235,53544,36667,16877,588,16289,38520,36978,21808,14
7,1,3,2,8.4,25.3,36.6,29.8,8084727,4421640,1447995,117053,20154,1310788,2215092,189789,42599,23298,7629,617,106,6907,11671,6177730,4462359,1333266,945915,387351,382105,-445,382550,119508,97475,22033,417,21616,51693,45780,17698,22
7,1,3,2,10.9,30.9,35.9,22.4,6429988,3624304,1441968,148037,30056,1263875,1363716,171755,37437,21102,8395,862,175,7359,7940,4130940,3008839,780162,540633,239529,341939,-82,342021,96974,78217,18757,97,18660,42598,38468,18329,19
7,1,2,2,9.4,27.3,37.3,26,11020858,6106004,2560677,296598,38368,2225711,2354177,303467,36316,20121,8438,977,126,7334,7758,8060165,5895771,1591483,1116576,474907,572911,-1015,573926,167753,139160,28593,657,27936,48048,42367,20544,21
7,1,2,2,13.5,26.4,25.2,34.9,23781957,7784184,2724992,199388,41041,2484563,13272781,332556,71513,23407,8194,600,123,7471,39911,7918765,5559037,1102126,700649,401477,1257602,55183,1202419,183066,127165,55901,245,55656,43256,43715,21604,65
7,1,1,1,11.4,27.2,29.9,31.5,76058237,45895041,12340640,1456132,314661,10569847,17822556,1816837,41863,25261,6792,801,173,5818,9810,48187022,35754521,7400775,4802271,2598504,5031726,9508,5022218,1031392,759338,272054,379,271675,46720,47086,18486,363
7,1,1,1,19,28.2,25,27.8,103042056,56852668,20878267,3314004,485668,17078595,25311121,2607800,39513,21801,8006,1271,186,6549,9706,71375326,52647782,11167363,7381463,3785900,7560181,189977,7370204,1510755,1080636,430119,2096,428023,47245,48719,17219,336
7,1,9,10,23.8,45.9,20.6,9.7,190447,107089,50792,8760,685,41347,32566,4999,38097,21422,10160,1752,137,8271,6515,108708,40631,11144,8500,2644,56933,46636,10297,2004,1288,716,217,499,54246,31546,20635,0
7,1,8,7,18.5,42.6,23.2,15.6,287524,160265,80745,12163,945,67637,46514,9074,31687,17662,8899,1340,104,7454,5126,159025,113036,29166,21972,7194,16823,4402,12421,4206,2852,1354,217,1137,37809,39634,10924,1
7,1,8,7,23.1,42.8,21.8,12.4,300636,165288,97365,10557,1167,85641,37983,10046,29926,16453,9692,1051,116,8525,3781,119048,79594,23036,17928,5108,16418,1471,14947,3770,2637,1133,246,887,31578,30184,16851,0
7,1,6,6,24.6,41.7,21.5,12.2,450991,263201,126765,9985,1170,115610,61025,14854,30362,17719,8534,672,79,7783,4108,257506,185364,48561,37330,11231,23581,-1098,24679,6368,4994,1374,166,1208,40437,37117,20430,0
7,1,9,10,22.6,41.6,21.9,13.9,330188,186265,100169,12520,1228,86421,43754,10246,32226,18179,9776,1222,120,8435,4270,154616,77226,22432,17410,5022,54958,25336,29622,4169,2697,1472,486,986,37087,28634,30043,0
7,1,2,2,18.5,33.9,24.6,23,488046,316087,78893,8351,1270,69272,93066,15463,31562,20442,5102,540,82,4480,6019,395641,271965,78294,63932,14362,45382,11872,33510,7036,5449,1587,138,1449,56231,49911,23126,2
7,1,7,11,29.5,39.3,21.5,9.8,286967,154294,86471,16334,1531,68606,46202,7577,37873,20363,11412,2156,202,9055,6098,160663,62495,17517,13594,3923,80651,68024,12627,2694,1945,749,173,576,59637,32131,21922,1
7,1,7,9,24.7,39.3,22.5,13.4,373977,223130,106781,22409,1616,82756,44066,12211,30626,18273,8745,1835,132,6777,3609,229477,108317,34616,27752,6864,86544,64542,22002,4909,3789,1120,244,876,46746,28587,25116,1
7,1,6,6,20.1,43.7,23.1,13.1,498623,295644,137529,15555,1651,120323,65450,15101,33019,19578,9107,1030,109,7968,4334,316157,185028,46439,33721,12718,84690,3021,81669,6779,5534,1245,158,1087,46638,33435,75132,0
7,1,6,6,20.9,42.4,23.8,13,498715,287251,150091,15010,1662,133419,61373,16265,30662,17661,9228,923,102,8203,3773,238863,141199,38033,29650,8383,59631,1522,58109,5275,3856,1419,169,1250,45282,36618,46487,0
7,1,6,6,20.6,41.3,24.1,14,537441,283495,148857,18759,1873,128225,105089,16872,31854,16803,8823,1112,111,7600,6229,278810,189468,47722,36398,11324,41620,14002,27618,6264,4723,1541,252,1289,44510,40116,21426,0
7,1,9,10,23,44.8,20.3,12,335211,181065,114887,12805,1924,100158,39259,11499,29151,15746,9991,1114,167,8710,3414,141535,77165,22846,18096,4750,41524,24867,16657,4064,2521,1543,613,930,34827,30609,17911,0
7,1,1,1,17.8,36.3,26.6,19.3,1020110,702942,147423,16908,1984,128531,169745,23837,42795,29490,6185,709,83,5392,7121,1339673,965425,235382,173564,61818,138866,6235,132631,19639,16122,3517,106,3411,68215,59882,38883,0
7,1,6,6,16.5,44.7,24.6,14.2,742428,403520,214594,19550,2132,192912,124314,24326,30520,16588,8822,804,88,7930,5110,330630,197163,53521,41203,12318,79946,19997,59949,8435,5882,2553,335,2218,39197,33520,27028,1
7,1,3,2,18.2,42.3,31.1,8.5,612367,370400,167996,19607,2290,146099,73971,22379,27363,16551,7507,876,102,6528,3305,218438,136078,45471,35915,9556,36889,1361,35528,5359,3613,1746,208,1538,40761,37663,23100,0
7,1,3,2,14.2,46.6,26.5,12.8,736060,430167,207324,23174,2434,181716,98569,22525,32677,19097,9204,1029,108,8067,4376,249718,155934,44062,33392,10670,49722,12351,37371,8042,5247,2795,361,2434,31052,29719,15354,0
7,1,2,2,21.2,37.9,25.1,15.8,865187,538270,192347,24701,2593,165053,134570,22670,38164,23744,8485,1090,114,7281,5936,380990,231375,61523,45087,16436,88092,27718,60374,9240,6349,2891,333,2558,41233,36443,23602,1
7,1,7,8,23.6,40.6,24.4,11.4,683025,383338,190821,30309,2604,157908,108866,20495,33326,18704,9311,1479,127,7705,5312,385440,206150,56195,43126,13069,123095,36608,86487,8750,6588,2162,393,1769,44050,31292,48890,0
7,1,6,6,20.4,42.6,23.9,13.1,715708,435547,186105,21342,2646,162117,94056,25632,27922,16992,7261,833,103,6325,3669,433900,301853,90168,72483,17685,41879,5818,36061,10670,8923,1747,372,1375,40665,33829,26226,0
7,1,2,2,17.1,37.5,25.3,20.1,975594,704858,166616,23512,2704,140400,104120,24146,40404,29192,6900,974,112,5815,4312,768981,552252,133314,95785,37529,83415,-1214,84629,14898,12238,2660,89,2571,51616,45126,32917,0
7,1,7,11,24.8,42.2,21.5,11.4,613802,320685,211001,29014,2715,179272,82116,20572,29837,15588,10257,1410,132,8714,3992,299964,163174,46938,36543,10395,89852,49490,40362,8403,5676,2727,787,1940,35697,28748,20805,0
7,1,6,6,21,40.7,22.5,15.8,1083164,663901,251910,26885,2740,222285,167353,31448,34443,21111,8010,855,87,7068,5322,503223,331694,84508,63631,20877,87021,24539,62482,12560,9467,3093,542,2551,40066,35037,24493,0
7,1,6,6,20.6,39,25,15.4,689348,389330,208556,28227,2800,177529,91462,20919,32953,18611,9970,1349,134,8486,4372,346567,216165,57809,43094,14715,72593,34312,38281,9671,6962,2709,648,2061,35836,31049,18574,0
7,1,6,4,26.4,42.5,20.8,10.3,894530,608127,182930,23989,3080,155861,103473,23067,38780,26364,7930,1040,134,6757,4486,362155,207503,48967,35506,13461,105685,6105,99580,6873,4963,1910,55,1855,52692,41810,53682,0
7,1,1,1,15.8,44.5,25.7,14,891282,632077,172872,22952,3184,146736,86333,21638,41191,29211,7989,1061,147,6781,3990,734026,496965,136884,106505,30379,100177,2586,97591,10604,8475,2129,46,2083,69222,58639,46851,0
7,1,6,6,26,38.4,22.7,12.9,1057439,588565,324250,45141,3205,275904,144624,33751,31331,17438,9607,1337,95,8175,4285,476044,296186,79822,60482,19340,100036,28029,72007,11799,8831,2968,577,2391,40346,33539,30116,0
7,1,2,2,17.4,42.3,26.8,13.5,954588,550187,229005,30194,3451,195360,175396,27022,35326,20361,8475,1117,128,7230,6491,493020,373541,88299,65758,22541,31180,-8325,39505,11797,8263,3534,580,2954,41792,45206,13373,1
7,1,2,2,22.5,38.8,23.8,15,1160954,728713,277513,43134,4214,230165,154728,33331,34831,21863,8326,1294,126,6905,4642,1088432,817151,205119,155570,49549,66162,6325,59837,18009,14532,3477,130,3347,60438,56231,17878,1
7,1,6,6,26.1,39.3,23.3,11.3,1452774,844555,409162,56723,4224,348215,199057,41588,34933,20308,9838,1364,102,8373,4786,643385,386992,103184,80062,23122,153209,46028,107181,16545,12251,4294,802,3492,38887,31589,30693,0
7,1,1,1,18.3,39.1,30.5,12.1,1189656,754926,265429,48205,4654,212570,169301,41489,28674,18196,6398,1162,112,5124,4081,781103,535122,146927,113931,32996,99054,1582,97472,16370,11996,4374,37,4337,47716,44608,22475,1
7,1,6,5,15,33.1,32.6,19.4,1274767,745881,342176,52704,4688,284784,186710,39337,32406,18961,8699,1340,119,7240,4746,734751,472156,130808,101961,28847,131787,24258,107529,18639,14133,4506,538,3968,39420,33408,27099,1
7,1,2,2,24.2,41.7,22,12.1,2232969,1480483,419618,50219,4876,364523,332868,58672,38059,25233,7152,856,83,6213,5673,1007519,641600,150601,110029,40572,215318,57965,157353,22472,15350,7122,1046,6076,44834,41798,25897,3
7,1,6,5,19.7,44.2,22.2,13.9,933639,509254,309428,48826,4896,255706,114957,27377,34103,18602,11302,1783,179,9340,4199,433205,234180,63449,47582,15867,135576,88514,47062,10713,7795,2918,362,2556,40437,30042,18412,0
7,1,6,3,23.4,41.1,23.3,12.2,1389484,718631,496769,64887,4918,426964,174084,46709,29748,15385,10635,1389,105,9141,3727,562394,379979,107330,84995,22335,75085,1045,74040,16324,10913,5411,703,4708,34452,34819,15726,3
7,1,2,2,18.7,39.4,26.5,15.5,1414797,813461,404573,46498,4960,353115,196763,40905,34587,19887,9891,1137,121,8633,4810,719314,503350,121541,88662,32879,94423,-2001,96424,17776,13330,4446,387,4059,40465,37761,23756,3
7,1,2,2,22.4,40.8,24.7,12.2,2135690,1364958,476346,65432,5150,405764,294386,61984,34456,22021,7685,1056,83,6546,4749,923146,586129,144015,105868,38147,193002,43799,149203,23444,16598,6846,734,6112,39377,35313,24411,1
7,1,1,1,11.8,35.4,30.5,22.3,2306690,1683502,323246,40111,5206,277929,299942,52432,43994,32108,6165,765,99,5301,5721,2188196,1593422,402651,304649,98002,192123,-274,192397,31693,25574,6119,58,6061,69044,62306,31743,1
7,1,4,5,11.8,26.8,25.2,36.2,1522678,888144,327955,43615,5392,278948,306579,47090,32335,18861,6964,926,115,5924,6510,1003323,662349,172649,131557,41092,168325,11797,156528,24910,19124,5786,291,5495,40278,34634,28486,11
7,1,1,1,15.8,37.3,30.5,16.4,1658644,1139411,340608,56207,5556,278845,178625,44728,37083,25474,7615,1257,124,6234,3994,1194043,794371,208639,158283,50356,191033,1771,189262,21020,15739,5281,16,5265,56805,50472,35947,1
7,1,5,8,12.5,36.6,33.2,17.7,1975591,1242430,357632,41210,5924,310498,375529,54123,36502,22956,6608,761,109,5737,6938,1669657,1160656,436186,328945,107241,72815,-3855,76670,28529,25172,3357,417,2940,58525,46109,26078,0
7,1,4,5,20.2,48.9,20.2,10.6,2118134,1247096,456049,64259,6247,385543,414989,53545,39558,23291,8517,1200,117,7200,7750,1836884,1382308,299201,211825,87376,155375,-3344,158719,33900,28488,5412,97,5315,54185,48522,29862,13
7,1,2,2,21.5,43.5,22.3,12.7,2919444,1834220,596506,89534,7022,499950,488718,73783,39568,24860,8085,1213,95,6776,6624,2274051,1649537,335997,229186,106811,288517,-1710,290227,44220,34971,9249,210,9039,51426,47169,32108,12
7,1,3,2,23.9,39.7,20.1,16.3,4092218,2716039,677820,76283,7665,593872,698359,97177,42111,27949,6975,785,79,6111,7186,2976070,2074748,477599,349167,128432,423723,19829,403894,51046,40643,10403,335,10068,58302,51048,40117,8
7,1,3,2,21.7,39.6,24.3,14.4,4595809,3097304,806305,106938,8800,690567,692200,111720,41137,27724,7217,957,79,6181,6196,3830158,2843208,588696,405275,183421,398254,7024,391230,70754,58298,12456,145,12311,54133,48770,31779,19
7,1,4,5,23.5,42.4,20.5,13.5,3056989,1812781,837659,123418,8964,705277,406549,83464,36626,21719,10036,1479,107,8450,4871,1376769,911825,236136,178028,58108,228808,17236,211572,36251,26494,9757,1136,8621,37979,34416,24541,3
7,1,2,2,11.6,33.9,26.9,27.6,4773106,3599685,631256,73378,10661,547217,542165,112203,42540,32082,5626,654,95,4877,4832,2519817,1829359,432839,314390,118449,257619,2603,255016,51257,39085,12172,211,11961,49160,46805,21321,10
7,1,2,2,11.2,28.7,34.5,25.7,4782584,3072628,875582,88908,11094,775580,834374,123130,38842,24954,7111,722,90,6299,6776,2965829,2104056,585033,427988,157045,276740,1895,274845,65834,52060,13774,403,13371,45050,40416,20555,11
7,1,2,2,14.7,40.4,27.5,17.4,4705017,3363254,821048,93996,12755,714297,520715,131843,35687,25510,6227,713,97,5418,3950,1442884,910609,222393,163533,58860,309882,-771,310653,39003,25327,13676,350,13326,36994,35954,23312,2
7,1,3,2,15.3,37.1,27.5,20.1,5294245,2954627,1365685,153656,13395,1198634,973933,132057,40091,22374,10342,1164,101,9077,7375,3538469,2383631,598026,440428,157598,556812,51547,505265,75703,62210,13493,713,12780,46741,38316,39536,3
7,1,3,2,18,36.2,25.9,19.9,4306991,2668384,1111697,155431,14544,941722,526910,123637,34836,21582,8992,1257,118,7617,4262,2471966,1613927,419563,322232,97331,438476,5873,432603,60275,45397,14878,928,13950,41011,35551,31011,2
7,1,3,2,14.4,34,27.3,24.3,5436464,3239136,1296882,202130,17809,1076943,900446,155244,35019,20865,8354,1302,115,6937,5800,3867363,2759814,656506,479393,177113,451043,16414,434629,95352,73803,21549,376,21173,40559,37394,20528,6
7,1,3,2,13.9,33.9,30.5,21.7,7363776,4634021,1496146,176120,19442,1300584,1233609,194506,37859,23825,7692,905,100,6687,6342,5402154,3862399,968597,720583,248014,571158,6753,564405,110879,89916,20963,769,20194,48721,42956,27949,11
7,1,2,2,13,28.9,26.2,31.8,11381559,7471001,1435921,173310,19757,1242854,2474637,227197,50096,32883,6320,763,87,5470,10892,9887175,7037365,1399955,944662,455293,1449855,1847,1448008,183412,145323,38089,535,37554,53907,48426,38558,57
7,1,1,1,10.5,25.9,31.1,32.5,12013098,7959890,1732544,136388,20816,1575340,2320664,239139,50235,33286,7245,570,87,6588,9704,5665844,3586492,801039,576885,224154,1278313,1505,1276808,123201,84846,38355,511,37844,45989,42271,33739,32
7,1,2,2,13.5,33.2,29.4,24,10877797,6192033,2158612,323311,28764,1806537,2527152,257364,42266,24059,8387,1256,112,7019,9819,7723116,5310285,1274110,924125,349985,1138721,11442,1127279,165564,127853,37711,501,37210,46647,41534,30295,16
7,1,1,1,14.1,23,26.4,36.5,16652385,9645479,2733939,505701,42613,2185625,4272967,370080,44997,26063,7387,1366,115,5906,11546,14072717,9820886,2207354,1558711,648643,2044477,0,2044477,254012,200884,53128,0,53128,55402,48888,38482,20
7,1,1,1,15.1,31.4,28.3,25.2,19436832,12546646,3299872,375822,45973,2878077,3590314,434559,44728,28872,7594,865,106,6623,8262,14055129,9512369,1953064,1329107,623957,2589696,1665,2588031,269404,206909,62495,51,62444,52171,45974,41446,47
7,1,2,2,9.8,27.2,28.6,34.5,19350106,12691638,3127156,481020,48415,2597721,3531312,442980,43682,28651,7059,1086,109,5864,7972,17856255,12853451,2893327,2088122,805205,2109477,159,2109318,337357,274782,62575,365,62210,52930,46777,33906,51
7,1,8,7,34.4,38.2,21.3,6.1,35407,20234,8502,1908,295,6299,6671,1403,25237,14422,6060,1360,210,4490,4755,17681,8163,2062,1368,694,7456,6528,928,439,296,143,65,78,40276,27578,11897,0
7,1,8,7,24.7,25.3,28.6,21.5,151238,69409,56901,11078,992,44831,24928,4785,31607,14506,11892,2315,207,9369,5210,69961,39346,9934,6869,3065,20681,14475,6206,1956,1359,597,102,495,35767,28952,12537,0
7,1,9,10,15.5,37.8,30.6,16.2,237780,126025,79428,9051,1040,69337,32327,7903,30087,15946,10050,1145,132,8774,4090,94725,62692,17533,12715,4818,14500,2537,11963,2766,1862,904,165,739,34246,33669,16188,0
7,1,9,10,18.6,35.6,28.5,17.3,228755,122150,77027,9463,1182,66382,29578,8422,27162,14504,9146,1124,140,7882,3512,111468,74344,19835,14193,5642,17289,2444,14845,3210,2241,969,215,754,34725,33174,19688,0
7,1,1,1,26.9,35.5,27.3,10.3,216776,116021,78159,11149,1254,65756,22596,8644,25078,13422,9042,1290,145,7607,2614,62891,37641,10442,7167,3275,14808,2268,12540,2208,1164,1044,264,780,28483,32338,16077,0
7,1,9,10,14.8,36.1,30.9,18.1,320823,168380,114584,11920,1366,101298,37859,10078,31834,16708,11370,1183,136,10051,3757,100615,65863,17405,11924,5481,17347,-2567,19914,3985,2319,1666,314,1352,25248,28401,14729,0
7,1,8,7,30.2,36.5,18.4,14.9,251651,123974,90037,15365,1495,73177,37640,9459,26604,13106,9519,1624,158,7736,3979,103731,76299,18280,12011,6269,9152,428,8724,3543,2452,1091,152,939,29278,31117,9291,0
7,1,9,8,17.9,34.5,31.2,16.4,327218,186753,96012,10711,1502,83799,44453,10401,31460,17955,9231,1030,144,8057,4274,74408,43073,11351,7757,3594,19984,-4913,24897,2791,1473,1318,435,883,26660,29242,28196,0
7,1,8,5,21.1,38.9,26.7,13.2,349521,181993,123698,15843,1704,106151,43830,12931,27030,14074,9566,1225,132,8209,3390,96194,59159,15487,10752,4735,21548,4874,16674,3580,2078,1502,503,999,26870,28469,16691,0
7,1,3,2,19.3,38.6,31.6,10.6,328020,181345,112675,13781,1744,97150,34000,11993,27351,15121,9395,1149,145,8101,2835,133810,99344,21790,14768,7022,12676,-3129,15805,3506,2445,1061,270,791,38166,40631,19981,0
7,1,8,7,18.6,37.5,30.1,13.8,377049,200098,136343,14512,1780,120051,40608,12666,29769,15798,10764,1146,141,9478,3206,171093,113313,26861,18633,8228,30919,10432,20487,4198,2818,1380,348,1032,40756,40210,19852,1
7,1,9,8,20,33,33.9,13.1,265600,124570,108326,13125,1788,93413,32704,10411,25511,11965,10405,1261,172,8973,3141,196740,149767,35877,23935,11942,11096,2072,9024,4754,3871,883,330,553,41384,38689,16318,1
7,1,8,7,19.8,42.3,26.8,11,464027,273750,141818,16960,1814,123044,48459,16342,28395,16751,8678,1038,111,7529,2965,188178,105449,28497,19819,8678,54232,28527,25705,5067,3152,1915,565,1350,37138,33455,19041,1
7,1,7,9,19.8,33.7,25.6,21,302791,141027,114327,13699,1856,98772,47437,10599,28568,13306,10787,1292,175,9319,4476,121232,84332,21816,15165,6651,15084,-1928,17012,4023,2948,1075,296,779,30135,28607,21838,1
7,1,7,9,31.8,30.1,25.3,12.9,324841,172476,113759,24438,1907,87414,38606,11150,29134,15469,10203,2192,171,7840,3462,143736,79801,21902,15434,6468,42033,16992,25041,4632,2818,1814,489,1325,31031,28318,18899,0
7,1,7,9,19,37,30,14,394605,201730,141627,17518,1932,122177,51248,12391,31846,16280,11430,1414,156,9860,4136,165551,108401,29197,20187,9010,27953,-4957,32910,5388,3613,1775,312,1463,30726,30003,22495,0
7,1,8,7,24.3,35.8,25,15,307070,149723,120755,19355,1982,99418,36592,12074,25432,12400,10001,1603,164,8234,3031,98709,64446,16415,11201,5214,17848,3770,14078,3469,2048,1421,289,1132,28455,31468,12436,0
7,1,8,7,24.1,36.8,30.5,8.7,343917,200830,105163,12679,1985,90499,37924,14338,23986,14007,7335,884,138,6312,2645,94703,64901,18999,13992,5007,10803,-1807,12610,3417,2298,1119,341,778,27715,28242,16208,0
7,1,9,10,24.6,35.9,28.2,11.2,402572,205110,146732,16336,1995,128401,50730,14830,27146,13831,9894,1102,135,8658,3421,163580,115033,29451,20158,9293,19096,-4869,23965,5756,3895,1861,523,1338,28419,29534,17911,0
7,1,9,10,19.8,45,24.8,10.3,407235,209370,143968,19506,2212,122250,53897,15073,27018,13890,9551,1294,147,8111,3576,144370,84510,22609,15796,6813,37251,3309,33942,4969,3015,1954,579,1375,29054,28030,24685,0
7,1,1,1,21.3,29.5,32,17.1,308940,159290,94592,22422,2314,69856,55058,10430,29620,15272,9069,2150,222,6698,5279,472549,385580,72977,38061,34916,13992,2187,11805,12843,11621,1222,82,1140,36794,33180,10355,0
7,1,7,9,29.1,34.6,26.2,10.1,394175,213437,131391,23955,2405,105031,49347,15040,26208,14191,8736,1593,160,6983,3281,183548,95397,23362,15787,7575,64789,38691,26098,4717,3262,1455,433,1022,38912,29245,25536,0
7,1,9,8,15.9,37.3,32.9,13.9,527657,296806,161114,19748,2406,138960,69737,16553,31877,17931,9733,1193,145,8395,4213,240979,167214,42669,29283,13386,31096,10798,20298,6392,4687,1705,385,1320,37700,35676,15377,0
7,1,6,6,17.4,34.9,32.7,15,521991,286234,168515,15875,2447,150193,67242,18042,28932,15865,9340,880,136,8325,3727,197212,138187,34648,23927,10721,24377,-212,24589,6399,4312,2087,227,1860,30819,32047,13220,0
7,1,8,6,18.3,36.8,28.8,16.1,561802,309336,174407,23836,2456,148115,78059,19442,28896,15911,8971,1226,126,7618,4015,262235,171354,44892,31342,13550,45989,10979,35010,7927,5573,2354,424,1930,33081,30747,18140,1
7,1,9,8,21.1,34.9,30.8,13.3,546569,321572,168991,17476,2531,148984,56006,16532,33061,19451,10222,1057,153,9012,3388,180577,120440,29548,19922,9626,30589,2382,28207,5260,3556,1704,290,1414,34330,33870,19948,1
7,1,7,9,16.7,29.9,37.1,16.3,652373,352264,215028,23072,2591,189365,85081,21496,30349,16387,10003,1073,121,8809,3958,287588,196799,52064,36264,15800,38725,11511,27214,8538,6511,2027,492,1535,33683,30226,17729,1
7,1,6,6,22.6,30.9,34.1,12.3,582818,332611,178589,22912,2615,153062,71618,19149,30436,17370,9326,1197,137,7993,3740,274643,151890,38793,26738,12055,83960,1399,82561,7064,5067,1997,395,1602,38879,29976,51536,1
7,1,7,9,25.5,36.5,26.2,11.8,519806,282508,163824,20932,2849,140043,73474,17497,29708,16146,9363,1196,163,8004,4199,307911,197467,48282,31323,16959,62162,20930,41232,8720,6401,2319,485,1834,35311,30849,22482,0
7,1,8,6,20.9,40.9,26.7,11.5,546329,277755,190375,14620,2880,172875,78199,19606,27865,14167,9710,746,147,8817,3989,250014,173487,46184,31379,14805,30343,516,29827,7332,5666,1666,255,1411,34099,30619,21139,1
7,1,6,6,21.7,38.3,27.9,12.1,583929,327400,190900,26050,2907,161943,65629,23194,25176,14116,8231,1123,125,6982,2830,263359,163613,42707,28770,13937,57039,17323,39716,8030,5718,2312,550,1762,32797,28614,22540,1
7,1,7,8,21.2,29,31.7,18.1,674479,360790,226957,29443,3124,194390,86732,21620,31197,16688,10498,1362,144,8991,4012,490353,343254,87026,58262,28764,60073,1001,59072,12987,10642,2345,268,2077,37757,32255,28441,0
7,1,6,4,22.4,33.7,29.4,14.5,629083,343657,208602,23561,3146,181895,76824,21904,28720,15689,9523,1076,144,8304,3507,304422,207392,53246,36053,17193,43784,-382,44166,9338,6597,2741,598,2143,32600,31437,20609,0
7,1,7,8,22.3,30.1,34.6,13,707440,404978,221695,16815,3150,201730,80767,23300,30362,17381,9515,722,135,8658,3466,291932,198362,50250,34107,16143,43320,5872,37448,7975,6223,1752,388,1364,36606,31876,27455,1
7,1,2,2,20.7,35.2,30.8,13.3,855779,487569,274462,30891,3167,240404,93748,27413,31218,17786,10012,1127,116,8770,3420,372885,226624,57202,39105,18097,89059,23607,65452,11359,8175,3184,512,2672,32827,27722,24496,0
7,1,6,6,20.6,37.1,30.3,11.9,683978,425810,170181,18066,3205,148910,87987,22906,29860,18589,7430,789,140,6501,3841,231793,162939,41640,28924,12716,27214,-2117,29331,7715,5288,2427,501,1926,30044,30813,15229,0
7,1,7,9,24.9,37.4,25,12.6,642118,361824,181337,27841,3228,150268,98957,20612,31153,17554,8798,1351,157,7290,4801,328953,193379,47134,32190,14944,88440,21309,67131,7869,5747,2122,425,1697,41804,33649,39559,0
7,1,7,9,21.8,32.8,31.4,14.1,1019165,596873,262609,34311,3344,224954,159683,29714,34299,20087,8838,1155,113,7571,5374,731793,455915,107378,72417,34961,168500,25311,143189,16448,13562,2886,579,2307,44491,33617,62067,0
7,1,7,9,21.8,33.3,32.6,12.3,682373,371003,228260,22514,3429,202317,83110,25351,26917,14635,9004,888,135,7981,3278,333951,234093,60824,41714,19110,39034,1854,37180,10087,7753,2334,432,1902,33107,30194,19548,0
7,1,7,9,20.9,33.5,29.7,15.9,556803,285103,189335,26516,3555,159264,82365,18973,29347,15027,9979,1398,187,8394,4341,250557,173655,42357,28084,14273,34545,10819,23726,7426,5244,2182,447,1735,33741,33115,13675,0
7,1,6,6,22.1,37.4,27.6,12.9,731061,365172,260049,36298,3733,220018,105840,26331,27764,13869,9876,1379,142,8356,4020,432301,291878,67108,44171,22937,73315,6227,67088,11753,8533,3220,466,2754,36782,34206,24360,1
7,1,6,6,24.7,41,23.6,10.7,484857,191140,238744,48104,3782,186858,54973,18920,25627,10103,12619,2542,200,9876,2906,180625,123105,32633,22636,9997,24887,-2871,27758,6417,4263,2154,447,1707,28148,28878,16261,0
7,1,7,8,24,30.9,30.3,14.9,883587,561434,225075,25928,3874,195273,97078,30301,29160,18529,7428,856,128,6444,3204,541676,383445,90328,56224,34104,67903,-434,68337,15848,12270,3578,773,2805,34179,31251,24363,2
7,1,6,4,21.7,33.2,30.5,14.7,788769,463305,217798,23167,4024,190607,107666,27329,28862,16953,7969,848,147,6975,3940,533257,369719,89334,60248,29086,74204,4721,69483,13944,10402,3542,607,2935,38243,35543,23674,1
7,1,2,2,23.6,36,26.1,14.3,752730,387371,242867,43427,4058,195382,122492,28336,26564,13671,8571,1533,143,6895,4323,364784,251762,68681,49236,19445,44341,333,44008,9961,7012,2949,551,2398,36621,35904,18352,0
7,1,1,1,19.5,31.5,32.9,16.1,868786,528674,242036,27309,4153,210574,98076,28532,30450,18529,8483,957,146,7380,3437,299005,197919,49986,34366,15620,51100,725,50375,9622,6162,3460,497,2963,31075,32119,17001,3
7,1,7,9,20,32,28.7,19.3,683841,392635,185645,28599,4189,152857,105561,20383,33550,19263,9108,1403,206,7499,5179,341519,196595,45213,29670,15543,99711,53469,46242,8373,5855,2518,350,2168,40788,33577,21329,0
7,1,5,8,20.5,34.8,27.4,17.4,1034276,518288,319010,45373,4252,269385,196978,32175,32145,16108,9915,1410,132,8372,6122,625687,418661,94404,62120,32284,112622,3159,109463,16401,12171,4230,155,4075,38149,34398,26862,0
7,1,2,2,21.5,30.7,34.5,13.3,869577,498123,276718,43599,4283,228836,94736,29022,29963,17164,9535,1502,148,7885,3264,396528,252458,70130,49975,20155,73940,7175,66765,11048,7875,3173,430,2743,35891,32058,24340,0
7,1,6,5,13.4,36.7,34.9,15,1170158,718700,307884,36891,4334,266659,143574,34837,33590,20630,8838,1059,124,7654,4121,611548,417255,96456,64027,32429,97837,9403,88434,16267,12168,4099,506,3593,37594,34291,24613,0
7,1,7,8,21.6,26.9,34.6,16.9,763293,338225,300179,56054,4480,239645,124889,25613,29801,13205,11720,2188,175,9356,4876,403082,303295,70926,46944,23982,28861,-21146,50007,11780,9087,2693,221,2472,34217,33377,20229,0
7,1,7,8,19.2,33.5,31.3,15.9,1125595,612657,353920,37425,4830,311665,159018,37201,30257,16469,9514,1006,130,8378,4275,666926,473241,113432,75521,37911,80253,4156,76097,18378,14181,4197,442,3755,36289,33371,20266,3
7,1,7,8,27.8,29.4,28.3,14.5,767951,374204,265554,55382,5004,205168,128193,28404,27037,13174,9349,1950,176,7223,4513,443265,300154,77847,54396,23451,65264,22067,43197,11986,9772,2214,270,1944,36982,30716,22221,0
7,1,7,8,23.9,24.4,28.8,22.9,1107447,595820,359406,66122,5270,288014,152221,33988,32583,17530,10574,1945,155,8474,4479,653270,440925,110108,76353,33755,102237,31588,70649,16562,13111,3451,351,3100,39444,33630,22790,0
7,1,5,8,21.8,35.5,24.8,17.9,1013224,494471,323585,61424,5526,256635,195168,30788,32910,16061,10510,1995,179,8336,6339,738279,523279,132035,90741,41294,82965,12704,70261,18336,15476,2860,242,2618,40264,33812,26838,0
7,1,2,2,15.3,27.6,36.2,20.9,1480387,844390,341910,35731,5536,300643,294087,45231,32729,18668,7559,790,122,6647,6502,1023503,742210,189740,129631,60109,91553,-1251,92804,20113,15409,4704,213,4491,50888,48167,20664,1
7,1,6,5,19.3,34.6,30.1,15.9,1136289,594879,380658,59836,5594,315228,160752,40086,28346,14840,9496,1493,140,7864,4010,702629,481522,120629,83287,37342,100478,773,99705,20580,15451,5129,436,4693,34141,31164,21245,0
7,1,4,3,10.5,18.9,28.8,41.9,1709543,985245,334603,27086,5884,301633,389695,50182,34067,19633,6668,540,117,6011,7766,1116039,784826,191860,134199,57661,139353,-1172,140525,28314,21836,6478,386,6092,39417,35942,23067,5
7,1,6,4,22.2,38.2,25.2,14.4,1022875,596812,305341,50781,5980,248580,120722,34426,29712,17336,8869,1475,174,7221,3507,613285,402674,98605,66812,31793,112006,7647,104359,16166,11895,4271,625,3646,37937,33852,28623,0
7,1,1,1,20.6,41.3,25,13.1,1000489,597307,301471,49883,6055,245533,101711,36543,27378,16345,8250,1365,166,6719,2783,333848,216240,52487,34759,17728,65121,1601,63520,11370,6632,4738,496,4242,29362,32606,14974,3
7,1,7,9,20.1,35.5,27.9,16.5,1083825,613716,327216,35618,6187,285411,142893,36416,29762,16853,8986,978,170,7838,3924,552385,367565,94659,64526,30133,90161,10578,79583,13599,10363,3236,612,2624,40620,35469,30329,1
7,1,5,8,11.9,21.1,24.4,42.6,1440080,858212,305924,40422,6514,258988,275944,48808,29505,17583,6268,828,133,5306,5654,1001074,710975,188750,135205,53545,101349,-3323,104672,26867,21968,4899,341,4558,37260,32364,22964,14
7,1,3,2,9.4,23.6,31.1,35.9,1989923,1318991,333272,35292,6531,291449,337660,58083,34260,22709,5738,608,112,5018,5813,889124,571352,130260,85327,44933,187512,4043,183469,27915,19378,8537,366,8171,31851,29485,22454,0
7,1,6,3,15.8,30,39.2,15,1794570,1053126,498404,54733,6810,436861,243040,54996,32631,19149,9063,995,124,7944,4419,566673,354314,92642,65533,27109,119717,1656,118061,17733,11251,6482,692,5790,31956,31492,20391,8
7,1,4,5,12.8,32.2,32.1,22.9,1708324,1026132,411062,61563,7674,341825,271130,48211,35434,21284,8526,1277,159,7090,5624,1222237,902832,236270,163104,73166,83135,11406,71729,26789,22223,4566,186,4380,45625,40626,16376,4
7,1,4,5,17.8,31.1,32.6,18.4,2337713,1318191,670534,69575,7902,593057,348988,68326,34214,19293,9814,1018,116,8680,5108,1665458,1186920,297601,208806,88795,180937,22397,158540,38121,30977,7144,809,6335,43689,38316,25026,3
7,1,5,8,15.3,30.7,30.4,23.6,2128497,1249039,483713,66461,9095,408157,395745,59595,35716,20959,8117,1115,153,6849,6641,1656725,1212589,300087,203078,97009,144049,-1154,145203,35675,29207,6468,348,6120,46439,41517,23726,2
7,1,5,8,21.2,30.6,29.2,19,1696383,921648,510959,109684,10364,390911,263776,50012,33920,18429,10217,2193,207,7816,5274,998822,651974,159454,107494,51960,187394,48524,138870,24404,19511,4893,219,4674,40929,33416,29711,11
7,1,3,2,13.3,27.6,32.3,26.7,2626386,1457388,657998,80591,10377,567030,511000,76444,34357,19065,8608,1054,136,7418,6685,2233459,1552476,382415,264371,118044,298568,-2370,300938,49034,41071,7963,313,7650,45549,37800,39338,4
7,1,5,8,13.8,30.7,35.4,20.1,2731425,1557941,681136,88274,11175,581687,492348,80253,34035,19413,8487,1100,139,7248,6135,1933453,1390516,344635,232161,112474,198302,774,197528,45260,37597,7663,317,7346,42719,36985,26889,1
7,1,5,8,16.8,25.9,33.9,23.5,2938488,1861426,648598,75898,11958,560742,428464,84785,34658,21955,7650,895,141,6614,5054,2737539,2027415,452147,289659,162488,257977,4771,253206,64514,54726,9788,447,9341,42433,37047,27107,11
7,1,2,2,10.3,26.2,34.3,29.2,5756012,3923138,1012036,83280,14638,914118,820838,145784,39483,26911,6942,571,100,6270,5631,3404435,2348647,527680,346870,180810,528108,14645,513463,81045,62562,18483,574,17909,42007,37541,28671,10
7,1,1,1,10.6,29.5,36.4,23.5,5799375,4240533,917717,97011,19256,801450,641125,166356,34861,25491,5517,583,116,4818,3854,2527081,1768228,396946,256597,140349,361907,2789,359118,70560,52452,18108,377,17731,35815,33711,20254,12
7,1,2,2,12.2,31.6,35.6,20.7,4838254,3017742,1031051,110960,20484,899607,789461,139890,34586,21572,7370,793,146,6431,5643,3338171,2438513,650576,464249,186327,249082,-7830,256912,65213,52331,12882,358,12524,51189,46598,20514,5
7,1,2,2,13,29.2,35.6,22.2,6714400,3808081,1496876,186339,25725,1284812,1409443,193447,34709,19685,7738,963,133,6642,7286,5260624,3796323,1020302,702664,317638,443999,-639,444638,120864,98501,22363,280,22083,43525,38541,20135,4
7,1,2,2,13.7,25.1,32.5,28.6,9154415,5341719,1992844,351839,34394,1606611,1819852,247881,36931,21550,8040,1419,139,6481,7342,8382824,5797959,1365635,932683,432952,1219230,1411,1217819,169210,135708,33502,864,32638,49541,42724,37313,6
8,1,8,6,23.4,37,28.2,11.4,267355,128824,95429,18604,981,75844,43102,8752,30548,14719,10904,2126,112,8666,4925,112571,59295,18320,13675,4645,34956,30008,4948,3107,1997,1110,263,847,36231,29692,5842,0
8,1,8,7,20.5,37.6,28.7,13.3,421236,215063,147705,15075,1228,131402,58468,14210,29644,15135,10394,1061,86,9247,4115,182552,126660,32859,22880,9979,23033,2947,20086,5517,3696,1821,321,1500,33089,34269,13391,0
8,1,9,10,19.9,39.9,28.6,11.6,454274,252341,150812,17282,1271,132259,51121,13396,33911,18837,11258,1290,95,9873,3816,261651,183680,40690,27768,12922,37281,5647,31634,5494,4042,1452,228,1224,47625,45443,25845,0
8,1,8,6,17.3,39.7,24.7,18.2,410358,228106,132142,25851,1433,104858,50110,13376,30679,17053,9879,1933,107,7839,3746,226818,120664,34438,25414,9024,71716,58342,13374,5381,3782,1599,378,1221,42152,31905,10953,0
8,1,9,10,20.9,43.2,23.9,12,336963,156714,133542,28844,1554,103144,46707,11150,30221,14055,11977,2587,139,9251,4189,193071,109202,27456,19733,7723,56413,37020,19393,4030,2841,1189,283,906,47908,38438,21405,0
8,1,3,2,18.9,42.7,23.9,14.4,494249,263136,161100,24622,1907,134571,70013,15248,32414,17257,10565,1615,125,8825,4592,173034,98792,26792,19255,7537,47450,32092,15358,4825,3017,1808,399,1409,35862,32745,10900,1
8,1,1,1,17.9,43.9,25,13.2,617036,366184,187170,22196,1999,162975,63682,22503,27420,16273,8318,986,89,7242,2830,247151,169257,43765,30616,13149,34129,5619,28510,6505,4680,1825,168,1657,37994,36166,17206,0
8,1,3,2,20.2,37.8,30.3,11.8,614085,334316,198011,25895,2014,170102,81758,19302,31815,17320,10259,1342,104,8813,4236,238566,133606,38847,28224,10623,66113,34334,31779,6103,4085,2018,379,1639,39090,32706,19389,0
8,1,7,11,16.8,39.6,28.1,15.4,682230,359262,216160,31456,2054,182650,106808,20105,33933,17869,10752,1565,102,9085,5313,402154,271346,69984,49626,20358,60824,26134,34690,9585,7506,2079,431,1648,41957,36151,21050,0
8,1,8,4,20,42,21.1,16.9,283985,137473,110355,24191,2077,84087,36157,10019,28345,13721,11015,2415,207,8393,3609,136426,71045,20813,15015,5798,44568,25716,18852,3575,2546,1029,341,688,38161,27905,27401,1
8,1,6,4,22.8,36.2,28.1,12.9,695106,356430,229387,21753,2636,204998,109289,24183,28744,14739,9485,900,109,8477,4519,376846,237598,63339,43470,19869,75909,18126,57783,10619,7759,2860,473,2387,35488,30622,24207,0
8,1,7,11,17,46.7,23.8,12.5,633486,321246,210773,29427,2729,178617,101467,22176,28566,14486,9505,1327,123,8055,4576,355855,260391,64202,44389,19813,31262,12110,19152,9286,6975,2311,442,1869,38322,37332,10247,0
8,1,7,11,19.3,35.3,31.9,13.4,849716,455702,267242,27865,2908,236469,126772,30220,28118,15079,8843,922,96,7825,4195,481256,320409,82636,57072,25564,78211,30675,47536,13263,10236,3027,653,2374,36286,31302,20024,3
8,1,7,11,18.5,44.3,24.2,13,785058,429092,241913,35310,3321,203282,114053,25118,31255,17083,9631,1406,132,8093,4541,459793,322091,79310,55693,23617,58392,9782,48610,11987,8851,3136,242,2894,38358,36390,16797,1
8,1,3,2,16.1,33.7,31.4,18.8,1822526,1022719,524515,49806,6128,468581,275292,54528,33424,18756,9619,913,112,8593,5049,1370411,986541,249945,172080,77865,133925,25422,108503,30599,24641,5958,625,5333,44786,40037,20346,2
8,1,4,3,17.9,35.9,31.3,14.9,2759231,1665546,716119,64884,6889,644346,377566,80674,34202,20645,8877,804,85,7987,4680,1520410,977882,237817,162137,75680,304711,97697,207014,38702,28310,10392,1804,8588,39285,34542,24105,4
8,1,3,2,14.1,35.3,28.1,22.5,3027710,1709324,766314,67115,9284,689915,552072,92688,32666,18442,8268,724,100,7443,5956,1511249,1006172,252724,174245,78479,252353,24362,227991,43306,31949,11357,1335,10022,34897,31493,22749,4
8,1,3,2,9.8,27.8,31.7,30.7,7441318,4385815,1572417,123562,15802,1433053,1483086,194736,38212,22522,8075,635,81,7359,7616,3234413,2239598,510208,338056,172152,484607,26002,458605,96471,68352,28119,846,27273,33527,32766,16815,10
8,1,3,2,11.8,29.4,28.5,30.2,6883076,4186339,1441179,172381,17711,1251087,1255558,200752,34286,20853,7179,859,88,6232,6254,5352379,3878581,964260,676136,288124,509538,17845,491693,114332,94115,20217,443,19774,46814,41211,24866,12
8,1,2,2,13.7,32.6,30.6,23,14036932,8322534,3410436,511307,45157,2853972,2303962,413929,33911,20106,8239,1235,109,6895,5566,10567728,7669227,1778243,1196375,581868,1120258,35280,1084978,228792,180155,48637,594,48043,46189,42570,22583,33
8,1,1,1,10.6,26.8,30.7,31.9,29641690,18468215,5465674,703745,61486,4700443,5707801,658727,44998,28036,8297,1068,93,7136,8665,25683264,18239023,3998148,2652558,1345590,3446093,10607,3435486,448365,369581,78784,343,78441,57282,49351,43797,54
8,1,6,6,18.6,36.7,26.2,18.4,355927,157159,95458,10481,618,84359,103310,11519,30899,13643,8287,910,54,7323,8969,182198,114107,32215,23835,8380,35876,0,35876,5430,3632,1798,0,1798,33554,31417,19953,1
8,1,3,2,15.7,36.6,29.2,18.5,428786,214410,123859,10994,1200,111665,90517,15883,26997,13499,7798,692,76,7030,5699,195511,133860,39408,29747,9661,22243,0,22243,5362,3775,1587,0,1587,36462,35460,14016,0
8,1,3,2,14.1,26.5,32.6,26.7,2699385,1458790,432111,39264,4548,388299,808484,59179,45614,24650,7302,663,77,6561,13662,1229235,794417,181159,122691,58468,253659,4721,248938,33975,23035,10940,610,10330,36181,34487,24099,13
8,1,4,3,8.8,27.8,31.6,31.8,4941002,1974498,552826,41625,5982,505219,2413678,75914,65087,26010,7282,548,79,6655,31795,2295772,1623506,373416,253187,120229,298850,0,298850,57961,40542,17419,0,17419,39609,40045,17157,18
8,1,2,2,9.3,27.1,36.4,27.1,6104008,3794730,1155013,92945,14072,1047996,1154265,160421,38050,23655,7200,579,88,6533,7195,1988922,1341400,360195,255516,104679,287327,1575,285752,53710,36356,17354,590,16764,37031,36896,17046,17
8,1,3,2,8.4,25.3,36.6,29.8,8145456,4434612,1510847,121920,15721,1373206,2199997,192735,42262,23009,7839,633,82,7125,11415,6264725,4565714,1353085,967477,385608,345926,-1002,346928,121664,98659,23005,419,22586,51492,46278,15360,11
8,1,3,2,10.9,30.9,35.9,22.4,6521655,3680166,1485086,153040,21066,1310980,1356403,174626,37346,21075,8504,876,121,7507,7767,4229494,3080377,805636,563975,241661,343481,-69,343550,98845,79440,19405,97,19308,42789,38776,17793,16
8,1,2,2,9.4,27.3,37.3,26,11018592,6086946,2623623,306916,28288,2288419,2308023,306767,35918,19842,8552,1000,92,7460,7524,8195083,6028387,1651729,1172838,478891,514967,3802,511165,171517,142577,28940,663,28277,47780,42282,18077,20
8,1,2,2,13.5,26.4,25.2,34.9,23486915,7825079,2814712,196366,29241,2589105,12847124,339483,69184,23050,8291,578,86,7627,37843,8141056,5977176,1182669,767837,414832,981211,58389,922822,190509,131666,58843,248,58595,42733,45397,15749,86
8,1,1,1,11.4,27.2,29.9,31.5,75124572,45730988,12588584,1518152,219886,10850546,16805000,1840561,40816,24846,6840,825,119,5895,9130,48815836,37119267,7848111,5182006,2666105,3848458,9858,3838600,1064594,776829,287765,382,287383,45854,47783,13357,420
8,1,1,1,19,28.2,25,27.8,103429133,59304606,21352036,3447246,336030,17568760,22772491,2643934,39119,22430,8076,1304,127,6645,8613,75174928,54584695,11841281,7953822,3887459,8748952,190130,8558822,1564249,1105174,459075,2107,456968,48058,49390,18730,392
8,1,9,10,23.8,45.9,20.6,9.7,204776,121383,51092,8485,381,42226,32301,4934,41503,24601,10355,1720,77,8558,6547,123643,40307,11320,8621,2699,72016,62072,9944,1986,1266,720,218,502,62257,31838,19809,0
8,1,8,7,18.5,42.6,23.2,15.6,284026,156863,83730,11980,643,71107,43433,8964,31685,17499,9341,1336,72,7933,4845,153411,106239,28375,21538,6837,18797,5410,13387,3913,2756,1157,214,943,39205,38548,14196,0
8,1,8,7,23.1,42.8,21.8,12.4,301734,163168,100527,10321,707,89499,38039,9981,30231,16348,10072,1034,71,8967,3811,126712,83888,24311,18897,5414,18513,1308,17205,3836,2670,1166,242,924,33032,31419,18620,0
8,1,9,10,22.6,41.6,21.9,13.9,344965,201331,102704,12143,756,89805,40930,10255,33639,19632,10015,1184,74,8757,3991,165923,78321,23572,18430,5142,64030,38517,25513,4150,2689,1461,480,981,39981,29126,26007,0
8,1,6,6,24.6,41.7,21.5,12.2,453551,271812,128020,9665,808,117547,53719,14812,30621,18351,8643,653,55,7936,3627,284045,195971,50858,38938,11920,37216,-712,37928,6652,5254,1398,161,1237,42701,37299,30661,0
8,1,2,2,18.5,33.9,24.6,23,500073,318896,85252,8358,890,76004,95925,15448,32371,20643,5519,541,58,4920,6210,422585,285238,86989,71936,15053,50358,14615,35743,7268,5622,1646,135,1511,58143,50736,23655,4
8,1,7,11,29.5,39.3,21.5,9.8,293255,164111,87822,15771,912,71139,41322,7498,39111,21887,11713,2103,122,9488,5511,171971,68499,20523,16258,4265,82949,72322,10627,2915,2096,819,175,644,58995,32681,16502,0
8,1,6,6,20.1,43.7,23.1,13.1,501959,307320,138139,15273,1009,121857,56500,14849,33804,20696,9303,1029,68,8206,3805,327665,175991,44655,32536,12119,107019,7872,99147,6451,5220,1231,154,1077,50793,33715,92058,0
8,1,7,9,24.7,39.3,22.5,13.4,377501,223900,108892,21219,1044,86629,44709,11908,31701,18802,9144,1782,88,7275,3755,231756,112154,36764,29576,7188,82838,63980,18858,5005,3909,1096,242,854,46305,28691,22082,0
8,1,6,6,20.9,42.4,23.8,13,496540,283454,153713,14875,1088,137750,59373,16132,30780,17571,9528,922,67,8539,3680,238341,139690,38176,30059,8117,60475,6358,54117,5195,3782,1413,165,1248,45879,36935,43363,1
8,1,6,6,20.6,41.3,24.1,14,555685,308497,151999,18466,1208,132325,95189,16671,33332,18505,9118,1108,72,7937,5710,291519,158854,44501,34912,9589,88164,24676,63488,5823,4281,1542,246,1296,50063,37107,48988,0
8,1,9,10,23,44.8,20.3,12,350072,194036,116973,12245,1232,103496,39063,11454,30563,16940,10212,1069,108,9036,3410,150338,78793,23970,19168,4802,47575,31007,16568,4073,2562,1511,600,911,36911,30754,18187,0
8,1,1,1,17.8,36.3,26.6,19.3,1023178,723640,148316,16699,1302,130315,151222,23524,43495,30762,6305,710,55,5540,6428,1406916,990758,244855,180944,63911,171303,6151,165152,19697,16014,3683,103,3580,71428,61868,46132,2
8,1,6,6,16.5,44.7,24.6,14.2,757747,417076,217908,19052,1377,197479,122763,24261,31233,17191,8982,785,57,8140,5060,352028,199482,53905,41410,12495,98641,41791,56850,8380,5847,2533,326,2207,42008,34117,25759,1
8,1,3,2,18.2,42.3,31.1,8.5,628124,380779,172891,18998,1415,152478,74454,22280,28192,17091,7760,853,64,6844,3342,227071,144485,47785,37556,10229,34801,1857,32944,5647,3834,1813,202,1611,40211,37685,20449,0
8,1,3,2,14.2,46.6,26.5,12.8,759029,444912,216592,23444,1545,191603,97525,22449,33811,19819,9648,1044,69,8535,4344,272148,156216,44328,33565,10763,71604,29665,41939,8044,5194,2850,354,2496,33832,30076,16802,2
8,1,2,2,21.2,37.9,25.1,15.8,881393,559784,195167,23455,1595,170117,126442,22420,39313,24968,8705,1046,71,7588,5640,348285,203636,54515,39697,14818,90134,37923,52211,9038,6085,2953,327,2626,38536,33465,19882,0
8,1,2,2,17.1,37.5,25.3,20.1,1003551,722929,174275,22678,1615,149982,106347,24632,40742,29349,7075,921,66,6089,4317,816986,594860,142473,101728,40745,79653,-2280,81933,15462,12613,2849,88,2761,52838,47162,29675,1
8,1,6,6,20.4,42.6,23.9,13.1,731966,442748,192018,20450,1651,169917,97200,25676,28508,17244,7479,796,64,6618,3786,438287,300549,90003,72747,17256,47735,11453,36282,10326,8511,1815,364,1451,42445,35313,25005,0
8,1,7,11,24.8,42.2,21.5,11.4,623004,329576,219219,28548,1741,188930,74209,20507,30380,16071,10690,1392,85,9213,3619,314966,164454,48630,38215,10415,101882,56773,45109,8425,5630,2795,774,2021,37385,29210,22320,1
8,1,7,8,23.6,40.6,24.4,11.4,645867,357787,194753,29370,1755,163628,93327,20496,31512,17456,9502,1433,86,7983,4553,371845,211379,58450,44963,13487,102016,50713,51303,8632,6574,2058,387,1671,43078,32154,30702,0
8,1,6,6,21,40.7,22.5,15.8,1151389,720556,260116,25681,1779,232656,170717,31299,36787,23022,8311,821,57,7433,5454,552757,343254,89481,67946,21535,120022,47696,72326,12884,9606,3278,532,2746,42903,35733,26339,1
8,1,6,6,20.6,39,25,15.4,708626,416161,215738,27601,1815,186322,76727,20919,33875,19894,10313,1319,87,8907,3668,369602,217236,58965,44178,14787,93401,53620,39781,9691,6927,2764,638,2126,38139,31361,18712,0
8,1,1,1,15.8,44.5,25.7,14,898764,630880,175729,22528,1937,151264,92155,21615,41581,29187,8130,1042,90,6998,4263,775763,532159,149355,116176,33179,94249,2738,91511,10865,8663,2202,46,2156,71400,61429,42445,1
8,1,6,6,26,38.4,22.7,12.9,1049095,578667,330774,44115,1954,284705,139654,33834,31007,17103,9776,1304,58,8415,4128,489985,295554,81695,62123,19572,112736,47160,65576,11899,8901,2998,566,2432,41179,33205,26964,0
8,1,2,2,17.4,42.3,26.8,13.5,971112,555509,233493,29915,2029,201549,182110,27092,35845,20505,8619,1104,75,7439,6722,509772,379611,89892,67127,22765,40269,-5427,45696,11535,8023,3512,567,2945,44193,47315,15516,1
8,1,2,2,22.5,38.8,23.8,15,1166974,737921,279976,41867,2438,235671,149077,33376,34964,22109,8389,1254,73,7061,4467,1130247,839334,212615,160853,51762,78298,6009,72289,18301,14691,3610,128,3482,61759,57133,20761,0
8,1,6,6,26.1,39.3,23.3,11.3,1440974,835864,419270,54422,2738,362110,185840,41290,34899,20244,10154,1318,66,8770,4501,622787,366440,102269,80361,21908,154078,52486,101592,16242,11999,4243,792,3451,38344,30539,29438,0
8,1,1,1,18.3,39.1,30.5,12.1,1215948,757187,282843,49075,2853,230915,175918,43435,27995,17433,6512,1130,66,5316,4050,780725,548696,158485,124052,34433,73544,1962,71582,17162,12389,4773,36,4737,45491,44289,15111,3
8,1,6,4,26.4,42.5,20.8,10.3,954044,666506,188506,23549,2860,162097,99032,23191,41139,28740,8128,1015,123,6990,4270,385938,209746,50557,36943,13614,125635,5067,120568,6970,4949,2021,55,1966,55371,42381,61327,0
8,1,6,5,15,33.1,32.6,19.4,1273874,741846,345781,51654,3010,291117,186247,39112,32570,18967,8841,1321,77,7443,4762,741733,478603,135507,106640,28867,127623,36806,90817,18778,14253,4525,527,3998,39500,33579,22716,0
8,1,6,5,19.7,44.2,22.2,13.9,968733,538448,316333,47162,3079,266092,113952,26935,35966,19991,11744,1751,114,9879,4231,464277,232588,64466,48654,15812,167223,119268,47955,10689,7634,3055,361,2694,43435,30467,17801,0
8,1,6,3,23.4,41.1,23.3,12.2,1416752,738507,502454,63540,3137,435777,175791,46445,30504,15901,10818,1368,68,9383,3785,573432,382693,110515,88070,22445,80224,2904,77320,16613,11050,5563,688,4875,34517,34633,15861,3
8,1,2,2,24.2,41.7,22,12.1,2306747,1540367,438135,49138,3149,385848,328245,59308,38894,25972,7387,829,53,6506,5535,1001777,624397,148142,109206,38936,229238,58588,170650,22261,15005,7256,1024,6232,45001,41613,27383,1
8,1,2,2,18.7,39.4,26.5,15.5,1423044,791086,419621,45452,3165,371004,212337,40665,34994,19454,10319,1118,78,9123,5222,708314,484628,119471,87683,31788,104215,1086,103129,17462,12887,4575,377,4198,40563,37606,24566,5
8,1,1,1,11.8,35.4,30.5,22.3,2296438,1675350,338215,37887,3387,296941,282873,52646,43620,31823,6424,720,64,5640,5373,2320474,1691310,448404,343178,105226,180760,-328,181088,32991,26765,6226,56,6170,70337,63191,29350,7
8,1,2,2,22.4,40.8,24.7,12.2,2256480,1461073,494831,62780,3390,428661,300576,62284,36229,23458,7945,1008,54,6882,4826,968791,581965,146245,108419,37826,240581,73029,167552,23525,16440,7085,723,6362,41181,35399,26336,1
8,1,4,5,11.8,26.8,25.2,36.2,1560682,914297,335177,43558,3402,288217,311208,47313,32986,19324,7084,921,72,6092,6578,1064496,690279,180520,137872,42648,193697,29120,164577,25289,19170,6119,284,5835,42093,36008,28205,11
8,1,1,1,15.8,37.3,30.5,16.4,1736960,1213866,349871,53789,3562,292520,173223,43578,39859,27855,8029,1234,82,6713,3975,1286437,794544,217846,167414,50432,274047,2217,271830,20486,15331,5155,15,5140,62796,51826,52885,1
8,1,4,5,20.2,48.9,20.2,10.6,2069957,1255886,462223,62881,3661,395681,351848,53550,38655,23453,8632,1174,68,7389,6570,1856975,1406860,306273,217441,88832,143842,-3505,147347,33948,28402,5546,96,5450,54701,49534,27036,4
8,1,5,8,12.5,36.6,33.2,17.7,1924205,1172871,372125,38081,3910,330134,379209,52832,36421,22200,7044,721,74,6249,7178,1576343,1098486,407704,307824,99880,70153,-1496,71649,27284,23939,3345,405,2940,57775,45887,24370,1
8,1,2,2,21.5,43.5,22.3,12.7,2888460,1818077,615523,87206,4479,523838,454860,73886,39093,24607,8331,1180,61,7090,6156,2300393,1682911,348908,240291,108617,268574,-2086,270660,44383,35052,9331,209,9122,51830,48012,29671,4
8,1,3,2,23.9,39.7,20.1,16.3,4208166,2711188,701651,74433,5022,622196,795327,97254,43270,27877,7215,765,52,6398,8178,3117537,2295766,524714,383420,141294,297057,18732,278325,53396,42564,10832,330,10502,58385,53937,26502,10
8,1,4,5,23.5,42.4,20.5,13.5,3132830,1856459,869096,118881,5540,744675,407275,83408,37560,22258,10420,1425,66,8928,4883,1422181,931206,245922,186815,59107,245053,24476,220577,36760,26662,10098,1117,8981,38688,34926,24560,1
8,1,3,2,21.7,39.6,24.3,14.4,4714128,3248981,849577,106426,5807,737344,615570,112684,41835,28833,7539,944,52,6543,5463,4215862,3137179,628034,424163,203871,450649,6334,444315,73122,60182,12940,142,12798,57655,52128,34718,15
8,1,2,2,11.6,33.9,26.9,27.6,4938326,3745669,652090,71237,6900,573953,540567,114572,43102,32693,5692,622,60,5010,4718,2815620,2055657,486324,351197,135127,273639,2252,271387,55405,42184,13221,206,13015,50819,48731,20852,8
8,1,2,2,11.2,28.7,34.5,25.7,4784650,3053198,921815,88474,7939,825402,809637,123965,38597,24630,7436,714,64,6658,6531,2940502,2059258,577825,425035,152790,303419,3639,299780,66066,51871,14195,396,13799,44509,39700,21725,7
8,1,2,2,14.7,40.4,27.5,17.4,4778635,3455442,848037,89086,8088,750863,475156,134029,35654,25781,6327,665,60,5602,3545,1493299,965489,238396,175492,62904,289414,242,289172,40209,26297,13912,341,13571,37138,36715,21308,2
8,1,3,2,15.3,37.1,27.5,20.1,5303844,2976783,1429327,147952,8710,1272665,897734,132359,40072,22490,10799,1118,66,9615,6783,3624616,2391542,611445,451372,160073,621629,53133,568496,75234,61722,13512,699,12813,48178,38747,44369,7
8,1,3,2,18,36.2,25.9,19.9,4314259,2634836,1153814,152748,10598,990468,525609,125443,34392,21004,9198,1218,84,7896,4190,2389277,1608701,422405,325471,96934,358171,10488,347683,60200,44760,15440,910,14530,39689,35941,23929,4
8,1,3,2,14.4,34,27.3,24.3,5497761,3269732,1331503,200478,11145,1119880,896526,156061,35228,20952,8532,1285,71,7176,5745,3934399,2835425,677636,494174,183462,421338,20666,400672,96622,74487,22135,366,21769,40719,38066,18406,8
8,1,3,2,13.9,33.9,30.5,21.7,7488666,4785229,1544937,172865,12493,1359579,1158500,195506,38304,24476,7902,884,64,6954,5926,5702460,3993338,1019105,759007,260098,690017,13537,676480,113515,91736,21779,753,21026,50235,43531,32173,15
8,1,2,2,13,28.9,26.2,31.8,11527548,8196697,1486672,171752,12571,1302349,1844179,231418,49813,35419,6424,742,54,5628,7969,10725523,7277924,1452133,977966,474167,1995466,3602,1991864,188591,148394,40197,526,39671,56872,49045,50210,59
8,1,1,1,10.5,25.9,31.1,32.5,12127735,8152460,1811251,133919,13880,1663452,2164024,242074,50099,33678,7482,553,57,6872,8940,5926183,3770629,845052,607398,237654,1310502,8381,1302121,126713,86607,40106,502,39604,46769,43537,32879,43
8,1,2,2,13.5,33.2,29.4,24,11205430,6786043,2224653,322364,19775,1882514,2194734,255255,43899,26585,8715,1263,77,7375,8598,8382000,5184390,1272219,927412,344807,1925391,17576,1907815,163162,124455,38707,491,38216,51372,41657,49922,22
8,1,1,1,14.1,23,26.4,36.5,16688056,9729263,2843110,502338,27391,2313381,4115683,379125,44017,25662,7499,1325,72,6102,10856,14120343,9987958,2265992,1603754,662238,1866393,0,1866393,261006,204527,56479,0,56479,54100,48834,33046,16
8,1,1,1,15.1,31.4,28.3,25.2,19453497,12514515,3426715,370312,29049,3027354,3512267,435197,44700,28756,7874,851,67,6956,8071,14007210,9559127,1987336,1355148,632188,2460747,3605,2457142,273331,208206,65125,51,65074,51246,45912,37759,59
8,1,2,2,9.8,27.2,28.6,34.5,19596352,12791190,3233183,464693,30614,2737876,3571979,444451,44091,28780,7275,1046,69,6160,8037,18608292,13423026,3070078,2217421,852657,2115188,2133,2113055,343591,280435,63156,356,62800,54158,47865,33647,60
8,1,8,7,34.4,38.2,21.3,6.1,33001,17229,8814,1814,264,6736,6958,1413,23355,12193,6238,1284,187,4767,4924,13378,5925,1726,1177,549,5727,5095,632,401,250,151,67,84,33362,23700,7524,0
8,1,8,7,24.7,25.3,28.6,21.5,161912,77367,59576,11175,810,47591,24969,4677,34619,16542,12738,2389,173,10176,5339,81172,38081,10079,7072,3007,33012,26112,6900,1968,1348,620,107,513,41246,28250,13450,0
8,1,9,10,15.5,37.8,30.6,16.2,244425,130962,81666,8831,821,72014,31797,7878,31026,16624,10366,1121,104,9141,4036,100725,65203,18142,13242,4900,17380,5697,11683,2810,1904,906,163,743,35845,34245,15724,0
8,1,9,10,18.6,35.6,28.5,17.3,240776,135059,77391,9398,962,67031,28326,8455,28477,15974,9153,1112,114,7928,3350,128452,86330,22680,16224,6456,19442,5993,13449,3434,2405,1029,212,817,37406,35896,16461,1
8,1,1,1,26.9,35.5,27.3,10.3,218938,116606,79341,10927,1002,67412,22991,8495,25773,13726,9340,1286,118,7935,2706,62261,34943,9817,7047,2770,17501,5863,11638,2190,1095,1095,262,833,28430,31911,13971,0
8,1,8,7,30.2,36.5,18.4,14.9,248020,119076,92105,15106,1179,75820,36839,9343,26546,12745,9858,1617,126,8115,3943,95581,65903,16736,11431,5305,12942,3469,9473,3285,2185,1100,151,949,29096,30162,9982,0
8,1,9,10,14.8,36.1,30.9,18.1,339672,185340,116523,11420,1188,103915,37809,9939,34176,18648,11724,1149,120,10455,3804,112470,67066,17277,11899,5378,28127,9494,18633,3964,2271,1693,310,1383,28373,29531,13473,0
8,1,9,8,17.9,34.5,31.2,16.4,346565,199922,100396,10851,1199,88346,46247,10322,33575,19369,9726,1051,116,8559,4480,81299,39884,10705,7489,3216,30710,7043,23667,2741,1393,1348,431,917,29660,28632,25809,0
8,1,8,5,21.1,38.9,26.7,13.2,364513,196414,125097,15975,1284,107838,43002,12850,28367,15285,9735,1243,100,8392,3346,114334,62964,15730,10874,4856,35640,21154,14486,3574,2084,1490,497,993,31990,30213,14588,0
8,1,3,2,19.3,38.6,31.6,10.6,339078,189742,115940,13731,1310,100899,33396,12009,28235,15800,9654,1143,109,8402,2781,140580,99989,21717,14853,6864,18874,2178,16696,3517,2431,1086,265,821,39972,41131,20336,0
8,1,8,7,18.6,37.5,30.1,13.8,399855,222460,136834,14188,1348,121298,40561,12576,31795,17689,10881,1128,107,9645,3225,196340,114903,27062,18856,8206,54375,35207,19168,4178,2763,1415,341,1074,46994,41586,17847,0
8,1,8,7,19.8,42.3,26.8,11,524840,332308,144805,17002,1426,126377,47727,16233,32332,20471,8920,1047,88,7785,2940,249374,108374,29142,20434,8708,111858,86992,24866,5115,3161,1954,557,1397,48753,34285,17800,0
8,1,7,9,19.8,33.7,25.6,21,311024,148201,116421,13338,1496,101587,46402,10575,29411,14014,11009,1261,141,9606,4388,134923,88150,22597,15911,6686,24176,7917,16259,4024,2954,1070,293,777,33530,29841,20925,0
8,1,7,9,19,37,30,14,411389,215495,145593,17304,1517,126772,50301,12378,33235,17410,11762,1398,123,10242,4064,171433,102689,27999,19810,8189,40745,7801,32944,5066,3344,1722,309,1413,33840,30708,23315,0
8,1,8,7,24.1,36.8,30.5,8.7,368792,223808,109340,12563,1529,95248,35644,14292,25804,15660,7650,879,107,6664,2494,101875,66432,19909,14914,4995,15534,4104,11430,3509,2332,1177,335,842,29032,28487,13575,0
8,1,9,8,20,33,33.9,13.1,286844,147051,106944,12855,1561,92528,32849,10317,27803,14253,10366,1246,151,8968,3184,364118,281469,62286,38869,23417,20363,11433,8930,6715,5791,924,326,598,54225,48605,14933,0
8,1,8,7,24.3,35.8,25,15,315157,158452,122723,19001,1603,102119,33982,11953,26366,13256,10267,1590,134,8543,2843,111265,59021,15767,11079,4688,36477,25943,10534,3344,1956,1388,286,1102,33273,30174,9559,0
8,1,7,9,31.8,30.1,25.3,12.9,381448,223757,120792,23879,1651,95262,36899,11052,34514,20246,10929,2161,149,8619,3339,189364,80010,22210,15913,6297,87144,64106,23038,4849,2797,2052,485,1567,39052,28606,14702,1
8,1,9,10,24.6,35.9,28.2,11.2,419220,220541,148044,16154,1694,130196,50635,14710,28499,14993,10064,1098,115,8851,3442,177943,113623,29043,20029,9014,35277,12957,22320,5661,3752,1909,516,1393,31433,30283,16023,0
8,1,9,10,19.8,45,24.8,10.3,429814,228841,146773,19440,1732,125601,54200,14856,28932,15404,9880,1309,117,8455,3648,160849,84475,22384,15799,6585,53990,24709,29281,4935,2954,1981,573,1408,32594,28597,20796,0
8,1,6,6,17.4,34.9,32.7,15,529454,293175,168845,15488,1755,151602,67434,17955,29488,16328,9404,863,98,8443,3756,198127,137691,35041,24626,10415,25395,2810,22585,6415,4322,2093,223,1870,30885,31858,12078,0
8,1,1,1,21.3,29.5,32,17.1,365040,222625,96492,23003,1827,71662,45923,10448,34939,21308,9235,2202,175,6859,4395,513706,364219,67710,36616,31094,81777,68212,13565,12412,11148,1264,86,1178,41388,32671,11515,0
8,1,9,8,15.9,37.3,32.9,13.9,549458,324048,164070,19335,1878,142857,61340,16487,33327,19655,9951,1173,114,8665,3721,255474,157161,40250,28197,12053,58063,36201,21862,6319,4506,1813,379,1434,40429,34878,15245,0
8,1,8,6,18.3,36.8,28.8,16.1,605039,352643,178537,23086,1891,153560,73859,19207,31501,18360,9295,1202,98,7995,3845,299375,168085,44900,31850,13050,86390,54395,31995,7895,5465,2430,417,2013,37920,30757,15894,0
8,1,9,8,21.1,34.9,30.8,13.3,573621,345828,169851,17024,1979,150848,57942,16421,34932,21060,10344,1037,121,9186,3529,176105,113568,28311,19757,8554,34226,11198,23028,5084,3464,1620,286,1334,34639,32785,17262,0
8,1,7,9,16.7,29.9,37.1,16.3,682171,378495,217722,23252,2039,192431,85954,21521,31698,17587,10117,1080,95,8942,3994,310275,198680,52956,37671,15285,58639,33268,25371,8584,6464,2120,486,1634,36146,30736,15527,1
8,1,7,9,29.1,34.6,26.2,10.1,442595,260875,129747,24497,2068,103182,51973,14960,29585,17438,8673,1637,138,6897,3474,239729,104969,25405,17063,8342,109355,83103,26252,4792,3408,1384,435,949,50027,30801,27663,0
8,1,6,6,22.6,30.9,34.1,12.3,593733,335461,186348,23306,2078,160964,71924,19117,31058,17548,9748,1219,109,8420,3762,269948,156740,39801,27853,11948,73407,9905,63502,6990,5047,1943,390,1553,38619,31056,40890,1
8,1,8,6,20.9,40.9,26.7,11.5,548370,283937,193959,14669,2201,177089,70474,19497,28126,14563,9948,752,113,9083,3615,259402,181737,46996,32272,14724,30669,2314,28355,7558,5822,1736,251,1485,34322,31216,19094,2
8,1,6,6,21.7,38.3,27.9,12.1,639735,381456,193092,25315,2250,165527,65187,23264,27499,16397,8300,1088,97,7115,2802,312118,169957,44068,30028,14040,98093,60500,37593,8168,5888,2280,540,1740,38212,28865,21605,0
8,1,2,2,20.7,35.2,30.8,13.3,906158,531136,285130,31453,2413,251264,89892,27519,32928,19301,10361,1143,88,9131,3267,406000,226575,57074,39572,17502,122351,65608,56743,11228,8013,3215,505,2710,36160,28276,20938,0
8,1,7,9,25.5,36.5,26.2,11.8,519712,276873,164488,21050,2476,140962,78351,17376,29910,15934,9466,1211,142,8112,4509,303357,191604,46255,30629,15626,65498,26585,38913,8625,6195,2430,482,1948,35172,30929,19976,0
8,1,7,9,20.9,33.5,29.7,15.9,579255,313476,188567,26088,2484,159995,77212,18757,30882,16712,10053,1391,132,8530,4116,272892,175456,42246,28377,13869,55190,31371,23819,7436,5231,2205,441,1764,36699,33542,13503,0
8,1,6,6,20.6,37.1,30.3,11.9,706472,452213,173462,17703,2513,153246,80797,23199,30453,19493,7477,763,108,6606,3483,243724,168353,43436,30571,12865,31935,6636,25299,7717,5332,2385,494,1891,31583,31574,13379,1
8,1,7,8,21.2,29,31.7,18.1,666840,346770,233862,29054,2516,202292,86208,21540,30958,16099,10857,1349,117,9391,4002,495189,348992,86644,59268,27376,59553,9610,49943,13137,10807,2330,265,2065,37694,32293,24185,1
8,1,7,9,21.8,32.8,31.4,14.1,999502,593215,269623,33001,2521,234101,136664,29506,33875,20105,9138,1118,85,7934,4632,725240,454471,108308,74412,33896,162461,72742,89719,16088,13152,2936,570,2366,45080,34555,37920,1
8,1,7,8,22.3,30.1,34.6,13,701849,403434,220320,15855,2540,201925,78095,23370,30032,17263,9427,678,109,8640,3342,304866,207253,50646,34685,15961,46967,7333,39634,7959,6210,1749,386,1363,38305,33374,29079,1
8,1,6,4,22.4,33.7,29.4,14.5,637334,348412,214033,23192,2541,188300,74889,21992,28980,15843,9732,1055,116,8562,3405,314293,210489,53704,36872,16832,50100,11299,38801,9417,6666,2751,593,2158,33375,31577,17980,0
8,1,7,9,24.9,37.4,25,12.6,664380,394485,184039,27349,2551,154139,85856,20457,32477,19284,8996,1337,125,7535,4197,362417,193380,46575,32085,14490,122462,53687,68775,7847,5636,2211,418,1793,46185,34312,38358,0
8,1,7,9,21.8,33.3,32.6,12.3,683611,370072,229965,22411,2807,204747,83574,25468,26842,14531,9030,880,110,8039,3282,334788,234212,60183,41647,18536,40393,4315,36078,10004,7671,2333,428,1905,33465,30532,18939,0
8,1,6,4,21.7,33.2,30.5,14.7,803803,470635,225321,22500,2828,199993,107847,27749,28967,16960,8120,811,102,7207,3887,569260,403012,91989,61637,30352,74259,9017,65242,14248,10667,3581,599,2982,39954,37781,21879,4
8,1,6,6,22.1,37.4,27.6,12.9,767207,401728,263380,35438,2847,225095,102099,26061,29439,15415,10106,1360,109,8637,3918,480206,298920,67993,45400,22593,113293,43627,69666,11806,8565,3241,459,2782,40675,34900,25042,0
8,1,6,6,24.7,41,23.6,10.7,496729,207727,236651,47037,3174,186440,52351,18803,26418,11048,12586,2502,169,9915,2784,201985,123795,32521,22845,9676,45669,21567,24102,6267,4125,2142,445,1697,32230,30011,14203,0
8,1,7,8,24,30.9,30.3,14.9,877752,552039,229580,24578,3192,201810,96133,30678,28612,17995,7484,801,104,6578,3134,546557,388427,89227,56678,32549,68903,4416,64487,15983,12456,3527,759,2768,34196,31184,23297,1
8,1,2,2,21.5,30.7,34.5,13.3,877834,509546,275606,43442,3223,228941,92682,28881,30395,17643,9543,1504,112,7927,3209,409169,253282,70569,50607,19962,85318,22494,62824,11087,7805,3282,422,2860,36905,32451,21966,1
8,1,5,8,20.5,34.8,27.4,17.4,1056188,550164,323942,45429,3254,275259,182082,32111,32892,17133,10088,1415,101,8572,5670,662801,413556,92105,61239,30866,157140,24486,132654,16443,12010,4433,154,4279,40309,34434,31001,1
8,1,6,5,13.4,36.7,34.9,15,1189930,737944,316593,35882,3268,277443,135393,34716,34276,21257,9120,1034,94,7992,3900,633984,423894,96099,64159,31940,113991,26475,87516,16592,12293,4299,499,3800,38210,34483,23031,1
8,1,1,1,19.5,31.5,32.9,16.1,887628,544192,243901,27475,3318,213108,99535,28355,31304,19192,8602,969,117,7516,3510,317305,197673,50135,34940,15195,69497,22822,46675,9724,6110,3614,494,3120,32631,32352,14960,3
8,1,2,2,23.6,36,26.1,14.3,771190,414821,242742,43726,3342,195674,113627,27994,27548,14818,8671,1562,119,6990,4059,403692,258711,70917,51096,19821,74064,30483,43581,9971,7062,2909,554,2355,40487,36634,18506,0
8,1,7,8,19.2,33.5,31.3,15.9,1152591,628615,364267,36208,3653,324406,159709,37274,30922,16865,9773,971,98,8703,4285,678905,476207,113923,76955,36968,88775,11258,77517,18363,14259,4104,436,3668,36971,33397,21133,1
8,1,7,8,21.6,26.9,34.6,16.9,852913,432098,301586,56259,3859,241468,119229,25181,33871,17160,11977,2234,153,9589,4735,499512,313043,72166,48292,23874,114303,64247,50056,11612,8953,2659,227,2432,43017,34965,20582,0
8,1,7,9,20,32,28.7,19.3,716309,426102,191026,29162,3915,157949,99181,20345,35208,20944,9389,1433,192,7764,4875,366845,197959,45439,29896,15543,123447,83278,40169,8374,5768,2606,346,2260,43808,34320,17774,0
8,1,7,8,27.8,29.4,28.3,14.5,763600,390102,265109,53982,3961,207166,108389,27906,27363,13979,9500,1934,142,7424,3884,470205,293459,79085,56532,22553,97661,56491,41170,11795,9549,2246,277,1969,39865,30732,20909,0
8,1,6,5,19.3,34.6,30.1,15.9,1153330,606158,390010,58444,4366,327200,157162,39942,28875,15176,9764,1463,109,8192,3935,725944,488763,123986,86999,36987,113195,13031,100164,20575,15446,5129,432,4697,35283,31643,21325,0
8,1,7,8,23.9,24.4,28.8,22.9,1139145,607381,370163,66764,4411,298988,161601,33974,33530,17878,10895,1965,130,8800,4757,667787,427569,108836,76485,32351,131382,59968,71414,16458,12916,3542,358,3184,40575,33104,22429,3
8,1,1,1,20.6,41.3,25,13.1,1031238,616256,317680,49789,4424,263467,97302,36451,28291,16906,8715,1366,121,7228,2669,358256,219743,51999,34703,17296,86514,17059,69455,11235,6545,4690,493,4197,31887,33574,16549,2
8,1,2,2,15.3,27.6,36.2,20.9,1480476,828272,354430,36638,4490,313302,297774,45489,32546,18208,7792,805,99,6887,6546,990139,727812,187585,129057,58528,74742,-146,74888,20166,15300,4866,210,4656,49099,47569,16084,5
8,1,5,8,21.8,35.5,24.8,17.9,1011462,495773,326332,62338,4588,259406,189357,30737,32907,16130,10617,2028,149,8440,6161,739502,505941,131925,92263,39662,101636,29355,72281,18419,15414,3005,248,2757,40149,32823,26217,1
8,1,4,3,10.5,18.9,28.8,41.9,1733190,1030454,340235,26791,4633,308811,362501,51385,33729,20054,6621,521,90,6010,7055,1191680,823178,205704,146219,59485,162798,5810,156988,29295,22485,6810,383,6427,40679,36610,24426,8
8,1,6,4,22.2,38.2,25.2,14.4,1055834,619962,315278,50907,4896,259475,120594,34403,30690,18021,9164,1480,142,7542,3505,639823,400401,96847,66024,30823,142575,39876,102699,16136,11733,4403,620,3783,39652,34126,27148,0
8,1,3,2,9.4,23.6,31.1,35.9,2033724,1372762,341280,35605,4934,300741,319682,59095,34414,23230,5775,603,83,5089,5410,926290,588098,132763,87952,44811,205429,16087,189342,28592,19744,8848,359,8489,32397,29786,22304,2
8,1,6,3,15.8,30,39.2,15,1778523,1042287,508608,54051,5203,449354,227628,54830,32437,19009,9276,986,95,8195,4152,559938,356723,95327,68652,26675,107888,6290,101598,17549,11203,6346,681,5665,31907,31842,17934,10
8,1,5,8,11.9,21.1,24.4,42.6,1465692,885916,312114,41330,5232,265552,267662,49076,29866,18052,6360,842,107,5411,5454,1042998,724377,201015,147257,53758,117606,14702,102904,27185,22205,4980,337,4643,38367,32622,22163,17
8,1,7,9,20.1,35.5,27.9,16.5,1089728,604851,333981,35284,5523,293174,150896,36158,30138,16728,9237,976,153,8108,4173,559220,371266,93725,64233,29492,94229,16322,77907,13480,10148,3332,611,2721,41485,36585,28632,0
8,1,4,5,17.8,31.1,32.6,18.4,2402137,1373484,691633,68729,5991,616913,337020,68862,34883,19945,10044,998,87,8959,4894,1745591,1195726,299729,212545,87184,250136,71460,178676,38038,30778,7260,796,6464,45891,38850,27642,0
8,1,4,5,12.8,32.2,32.1,22.9,1690749,1000402,413476,61932,6220,345324,276871,48289,35013,20717,8563,1283,129,7151,5734,1238145,913028,239492,166787,72705,85625,16007,69618,27081,22256,4825,186,4639,45720,41024,15007,2
8,1,3,2,13.3,27.6,32.3,26.7,2618801,1459230,666234,81166,8096,576972,493337,76614,34182,19047,8696,1059,106,7531,6439,2271481,1568380,393784,276863,116921,309317,9771,299546,49254,41242,8012,309,7703,46118,38029,38887,11
8,1,5,8,15.3,30.7,30.4,23.6,2113481,1268359,498246,66316,8204,423726,346876,59791,35348,21213,8333,1109,137,7087,5801,1729473,1259476,302666,205678,96988,167331,23475,143856,36204,29584,6620,345,6275,47770,42573,22925,2
8,1,5,8,21.2,30.6,29.2,19,1678259,921988,516781,109508,8567,398706,239490,49651,33801,18569,10408,2206,173,8030,4823,1007341,648966,159446,108995,50451,198929,60893,138036,24159,19228,4931,225,4706,41696,33751,29332,2
8,1,5,8,13.8,30.7,35.4,20.1,2757915,1612934,696766,88122,9066,599578,448215,80236,34373,20102,8684,1098,113,7473,5586,1960479,1409729,348889,237305,111584,201861,5260,196601,45931,37936,7995,311,7684,42683,37161,25586,3
8,1,5,8,16.8,25.9,33.9,23.5,2960763,1868453,660899,75527,9548,575824,431411,84961,34848,21992,7779,889,112,6778,5078,2742073,2021085,443828,287198,156630,277160,13793,263367,64455,54581,9874,441,9433,42542,37029,27920,14
8,1,2,2,10.3,26.2,34.3,29.2,5896756,4043848,1043019,84063,11164,947792,809889,147291,40035,27455,7081,571,76,6435,5499,3590305,2432353,538840,357557,181283,619112,38021,581091,82668,63463,19205,568,18637,43430,38327,31179,9
8,1,1,1,10.6,29.5,36.4,23.5,5883358,4310815,955051,98291,14719,842041,617492,168314,34955,25612,5674,584,87,5003,3669,2592626,1823464,399785,260003,139782,369377,19771,349606,72455,53638,18817,374,18443,35783,33996,18956,19
8,1,2,2,12.2,31.6,35.6,20.7,4838137,3013305,1055211,114480,16138,924593,769621,140260,34494,21484,7523,816,115,6592,5487,3540856,2603485,693219,492434,200785,244152,-2930,247082,66990,53816,13174,351,12823,52856,48378,19269,4
8,1,2,2,13,29.2,35.6,22.2,6735981,3779351,1552904,192236,20135,1340533,1403726,196051,34358,19277,7921,981,103,6838,7160,5205159,3816004,1008222,698460,309762,380933,1372,379561,121322,98291,23031,275,22756,42904,38824,16680,8
8,1,2,2,13.7,25.1,32.5,28.6,9026092,5366795,2047333,353126,27167,1667040,1611964,246127,36672,21805,8318,1435,110,6773,6549,8596707,5864527,1413629,981107,432522,1318551,19774,1298777,169427,134921,34506,858,33648,50740,43466,38599,8
9,1,8,6,23.4,37,28.2,11.4,247040,109327,96640,17659,679,78302,41073,8587,28769,12732,11254,2056,79,9119,4783,94171,60342,19100,14514,4586,14729,10237,4492,3190,2026,1164,263,901,29521,29784,4986,0
9,1,8,7,20.5,37.6,28.7,13.3,424163,214022,150272,14219,733,135320,59869,14070,30147,15211,10680,1011,52,9618,4255,183992,128661,33283,23691,9592,22048,3353,18695,5416,3603,1813,320,1493,33972,35709,12522,0
9,1,9,10,19.9,39.9,28.6,11.6,466347,255006,155819,16872,744,138203,55522,13318,35016,19147,11700,1267,56,10377,4169,258457,179316,41197,28710,12487,37944,4629,33315,5299,3885,1414,227,1187,48775,46156,28067,0
9,1,8,4,20,42,21.1,16.9,264797,119065,108610,22785,792,85033,37122,9819,26968,12126,11061,2321,81,8660,3781,116559,69437,21612,16110,5502,25510,10190,15320,3566,2506,1060,340,720,32686,27708,21278,0
9,1,8,6,17.3,39.7,24.7,18.2,401896,216263,134221,24974,853,108394,51412,13253,30325,16318,10128,1884,64,8179,3879,219430,126967,36567,27173,9394,55896,42983,12913,5258,3699,1559,378,1181,41733,34325,10934,0
9,1,9,10,20.9,43.2,23.9,12,312819,129596,133819,27835,884,105100,49404,10951,28565,11834,12220,2542,81,9597,4511,173163,118544,30804,22597,8207,23815,9839,13976,4243,3043,1200,283,917,40811,38956,15241,0
9,1,3,2,18.9,42.7,23.9,14.4,485789,254913,161099,24473,1080,135546,69777,15048,32283,16940,10706,1626,72,9008,4637,159232,100388,28249,20799,7450,30595,18543,12052,4861,3006,1855,398,1457,32757,33396,8272,0
9,1,1,1,17.9,43.9,25,13.2,636539,375975,192507,21455,1113,169939,68057,22533,28249,16686,8543,952,49,7542,3020,256094,177871,46379,33266,13113,31844,2883,28961,6490,4728,1762,167,1595,39460,37621,18157,0
9,1,3,2,20.2,37.8,30.3,11.8,619602,336316,199655,25269,1114,173272,83631,20282,30549,16582,9844,1246,55,8543,4123,239038,139792,41929,31261,10668,57317,26403,30914,6097,4061,2036,378,1658,39206,34423,18645,1
9,1,7,11,16.8,39.6,28.1,15.4,703891,369189,222779,30867,1117,190795,111923,19975,35239,18483,11153,1545,56,9552,5603,413565,285904,75221,54377,20844,52440,18127,34313,9742,7684,2058,430,1628,42452,37208,21077,5
9,1,6,4,22.8,36.2,28.1,12.9,740466,381868,240781,22466,1522,216793,117817,24129,30688,15826,9979,931,63,8985,4883,403395,250055,67080,47031,20049,86260,17941,68319,10768,7890,2878,472,2406,37462,31693,28395,1
9,1,7,11,17,46.7,23.8,12.5,645118,314451,216039,27351,1548,187140,114628,21931,29416,14338,9851,1247,71,8533,5227,347360,267831,66591,46791,19800,12938,-5433,18371,9241,6897,2344,441,1903,37589,38833,9654,1
9,1,7,11,19.3,35.3,31.9,13.4,886782,461865,284043,28403,1752,253888,140874,30200,29364,15294,9405,940,58,8407,4665,482271,322795,85298,60018,25280,74178,29341,44837,13155,10079,3076,652,2424,36661,32026,18497,2
9,1,7,11,18.5,44.3,24.2,13,809571,439186,253046,34799,1825,216422,117339,24865,32559,17663,10177,1400,73,8704,4719,473317,336107,84421,60203,24218,52789,4164,48625,12052,8946,3106,242,2864,39273,37571,16978,0
9,1,3,2,16.1,33.7,31.4,18.8,1898242,1056908,541051,48519,3861,488671,300283,54461,34855,19407,9935,891,71,8973,5514,1432657,1042665,267635,187437,80198,122357,11923,110434,30947,25044,5903,624,5279,46294,41633,20919,3
9,1,4,3,17.9,35.9,31.3,14.9,2846479,1725004,740577,64528,3975,672074,380898,81041,35124,21286,9138,796,49,8293,4700,1587493,1032278,253693,175455,78238,301522,100967,200555,39274,28838,10436,1800,8636,40421,35796,23223,6
9,1,3,2,14.1,35.3,28.1,22.5,3167783,1750431,798115,67486,5924,724705,619237,92983,34068,18825,8583,726,64,7794,6660,1537357,1046700,267678,187825,79853,222979,5831,217148,43987,32583,11404,1333,10071,34950,32124,21562,2
9,1,3,2,9.8,27.8,31.7,30.7,7875234,4602407,1670285,126945,9254,1534086,1602542,199064,39561,23120,8391,638,46,7706,8050,3430467,2368668,548311,368769,179542,513488,3654,509834,99837,70747,29090,845,28245,34361,33481,18050,12
9,1,3,2,11.8,29.4,28.5,30.2,7170655,4325118,1517662,175408,10397,1331857,1327875,202803,35358,21327,7483,865,51,6567,6548,5568471,4062552,1030431,732895,297536,475488,5439,470049,118663,97380,21283,443,20840,46927,41719,22555,28
9,1,2,2,13.7,32.6,30.6,23,14354642,8519211,3577079,501589,25632,3049858,2258352,414314,34647,20562,8634,1211,62,7361,5451,10828502,7897513,1861393,1271344,590049,1069596,18091,1051505,231064,181911,49153,593,48560,46864,43414,21654,17
9,1,1,1,10.6,26.8,30.7,31.9,30853003,19075348,5671335,695702,36975,4938658,6106320,659544,46779,28922,8599,1055,56,7488,9258,26377901,18782726,4174832,2813485,1361347,3420343,3644,3416699,453374,371068,82306,342,81964,58181,50618,41685,58
9,1,6,6,18.6,36.7,26.2,18.4,365578,153440,100559,10663,521,89375,111579,11644,31396,13178,8636,916,45,7676,9583,177695,115142,32125,23716,8409,30428,0,30428,5415,3620,1795,0,1795,32815,31807,16952,0
9,1,3,2,15.7,36.6,29.2,18.5,464363,227660,133034,11141,606,121287,103669,16006,29012,14223,8312,696,38,7578,6477,197821,135816,38630,28936,9694,23375,0,23375,5416,3731,1685,0,1685,36525,36402,13872,1
9,1,2,2,9.3,27.1,36.4,27.1,6429035,3938940,1238116,92678,1910,1143528,1251979,162768,39498,24200,7607,569,12,7026,7692,2084730,1405386,366259,257937,108322,313085,-11851,324936,55261,37246,18015,589,17426,37725,37733,18647,26
9,1,3,2,14.1,26.5,32.6,26.7,2995901,1594042,475879,41856,2174,431849,925980,61203,48950,26045,7775,684,36,7056,15130,1349576,831073,185344,124481,60863,333159,10981,322178,35293,23637,11656,609,11047,38239,35160,29164,19
9,1,4,3,8.8,27.8,31.6,31.8,5477252,2085487,592373,41849,2677,547847,2799392,76492,71606,27264,7744,547,35,7162,36597,2425799,1723599,386244,260255,125989,315956,0,315956,60201,42072,18129,0,18129,40295,40968,17428,20
9,1,3,2,8.4,25.3,36.6,29.8,8548867,4502032,1612347,122096,8187,1482064,2434488,194628,43924,23131,8284,627,42,7615,12508,6374815,4693675,1356396,962835,393561,324744,241,324503,123104,99174,23930,418,23512,51784,47328,13802,9
9,1,3,2,10.9,30.9,35.9,22.4,6929572,3893469,1578583,153687,12126,1412770,1457520,178221,38882,21846,8857,862,68,7927,8178,4487884,3286487,837666,581234,256432,363731,-56,363787,102764,82356,20408,97,20311,43672,39906,17911,13
9,1,2,2,9.4,27.3,37.3,26,11526767,6265658,2780514,303252,14174,2463088,2480595,308103,37412,20336,9025,984,46,7994,8051,8416128,6228313,1637864,1151779,486085,549951,-4920,554871,174216,143876,30340,661,29679,48309,43289,18696,22
9,1,2,2,13.5,26.4,25.2,34.9,27008941,8874112,2997314,188029,14409,2794876,15137515,348216,77564,25485,8608,540,41,8026,43472,9100116,6382310,1237388,792470,444918,1480418,41009,1439409,200956,139118,61838,248,61590,45284,45877,23371,88
9,1,1,1,11.4,27.2,29.9,31.5,80769503,48712240,13327667,1527377,119299,11680991,18729596,1866837,43265,26093,7139,818,64,6257,10033,52241816,39440786,8068013,5267498,2800515,4733017,11926,4721091,1107989,801388,306601,381,306220,47150,49216,15417,456
9,1,1,1,19,28.2,25,27.8,112309408,64268108,22253616,3471701,124560,18657355,25787684,2674754,41989,24028,8320,1298,47,6975,9641,80551062,57736661,12047481,7992770,4054711,10766920,172003,10594917,1632572,1138804,493768,2104,491664,49340,50699,21549,396
9,1,9,10,23.8,45.9,20.6,9.7,164190,78671,49667,7941,259,41467,35852,4854,33826,16207,10232,1636,53,8543,7386,81404,39338,11403,8836,2567,30663,21517,9146,1963,1229,734,217,517,41469,32008,17691,0
9,1,8,7,18.5,42.6,23.2,15.6,293411,161632,83588,12224,444,70920,48191,8765,33475,18441,9537,1395,51,8091,5498,157685,109814,30182,23048,7134,17689,3380,14309,3984,2858,1126,213,913,39580,38423,15673,0
9,1,9,10,22.6,41.6,21.9,13.9,333607,187278,102247,12895,473,88879,44082,10140,32900,18469,10084,1272,47,8765,4347,148626,77828,24180,19226,4954,46618,16261,30357,4030,2602,1428,478,950,36880,29911,31955,0
9,1,8,7,23.1,42.8,21.8,12.4,309777,169853,100752,10278,474,90000,39172,9946,31146,17078,10130,1033,48,9049,3938,132700,87361,25862,20283,5579,19477,-1059,20536,3892,2729,1163,241,922,34096,32012,22273,0
9,1,2,2,18.5,33.9,24.6,23,511053,327158,84580,8045,476,76059,99315,15368,33254,21288,5504,523,31,4949,6462,411804,271422,86844,72955,13889,53538,11466,42072,7125,5435,1690,135,1555,57797,49940,27056,1
9,1,7,11,29.5,39.3,21.5,9.8,247490,123271,82431,15039,500,66892,41788,7440,33265,16569,11079,2021,67,8991,5617,130972,66183,20916,16831,4085,43873,34291,9582,2930,2069,861,175,686,44700,31988,13968,0
9,1,6,6,24.6,41.7,21.5,12.2,467969,282407,127813,10257,522,117034,57749,14870,31471,18992,8595,690,35,7870,3884,274241,182886,50147,39346,10801,41208,-698,41906,6305,4896,1409,161,1248,43496,37354,33579,0
9,1,6,6,20.1,43.7,23.1,13.1,518105,325146,136026,14687,611,120728,56933,14819,34962,21941,9179,991,41,8147,3842,345941,181090,47796,35581,12215,117055,7070,109985,6363,5181,1182,154,1028,54368,34953,106989,0
9,1,6,6,20.9,42.4,23.8,13,513009,302806,148511,14373,658,133480,61692,15991,32081,18936,9287,899,41,8347,3858,273493,173531,45958,35693,10265,54004,5738,48266,5541,4139,1402,165,1237,49358,41926,39019,0
9,1,7,9,24.7,39.3,22.5,13.4,329352,182673,105058,20043,679,84336,41621,11819,27866,15456,8889,1696,57,7136,3522,188893,111397,35918,28569,7349,41578,23002,18576,5020,3803,1217,242,975,37628,29292,19052,0
9,1,6,6,20.6,41.3,24.1,14,577920,335768,149642,17693,735,131214,92510,16411,35215,20460,9118,1078,45,7995,5637,316088,157367,44843,35534,9309,113878,25510,88368,5659,4084,1575,245,1330,55856,38533,66442,0
9,1,9,10,23,44.8,20.3,12,336963,179084,115837,11888,842,103107,42042,11527,29232,15536,10049,1031,73,8945,3647,135733,79619,24462,19638,4824,31652,15851,15801,3957,2501,1456,598,858,34302,31835,18416,0
9,1,1,1,17.8,36.3,26.6,19.3,1090413,782485,152577,16897,910,134770,155351,23322,46755,33551,6542,725,39,5779,6661,1492186,1029748,259933,193507,66426,202505,6397,196108,20231,16355,3876,103,3773,73757,62962,51977,2
9,1,3,2,18.2,42.3,31.1,8.5,631385,385314,171732,18232,921,152579,74339,22331,28274,17255,7690,816,41,6833,3329,240625,155473,51150,40140,11010,34002,304,33698,5760,3887,1873,201,1672,41775,39998,20154,0
9,1,6,6,16.5,44.7,24.6,14.2,773165,432695,217615,19285,924,197406,122855,24122,32052,17938,9021,799,38,8184,5093,363602,205245,56795,44049,12746,101562,40713,60849,8264,5810,2454,325,2129,43998,35326,28581,0
9,1,6,6,20.4,42.6,23.9,13.1,746945,458703,188524,20705,1002,166817,99718,25724,29037,17832,7329,805,39,6485,3876,442829,303730,94842,77379,17463,44257,5523,38734,10337,8488,1849,363,1486,42839,35783,26066,0
9,1,7,8,23.6,40.6,24.4,11.4,607318,311889,189941,28874,1038,160029,105488,20474,29663,15233,9277,1410,51,7816,5152,321692,206849,58580,45747,12833,56263,19755,36508,8452,6291,2161,385,1776,38061,32880,20556,0
9,1,3,2,14.2,46.6,26.5,12.8,758109,450796,214996,23356,1052,190588,92317,22556,33610,19986,9532,1035,47,8450,4093,278126,156732,46978,36341,10637,74416,29346,45070,8201,5189,3012,353,2659,33914,30205,16950,0
9,1,2,2,21.2,37.9,25.1,15.8,902832,565067,197200,23338,1095,172767,140565,22305,40477,25334,8841,1046,49,7746,6302,347549,217625,58066,42388,15678,71858,19281,52577,8930,5979,2951,326,2625,38919,36398,20029,1
9,1,7,11,24.8,42.2,21.5,11.4,569454,278522,213972,27235,1105,185632,76960,20428,27876,13634,10474,1333,54,9087,3767,260524,160980,49835,39851,9984,49709,5969,43740,8321,5521,2800,770,2030,31309,29158,21547,0
9,1,6,6,20.6,39,25,15.4,674483,381583,212865,26455,1129,185281,80035,20764,32483,18377,10252,1274,54,8923,3855,329891,220327,61344,46467,14877,48220,2577,45643,9678,6931,2747,635,2112,34087,31789,21611,0
9,1,2,2,17.1,37.5,25.3,20.1,1087258,796505,177805,22869,1157,153779,112948,25187,43167,31624,7059,908,46,6105,4484,941665,676124,164478,118901,45577,101063,-4433,105496,16361,13547,2814,87,2727,57555,49910,38686,0
9,1,6,6,21,40.7,22.5,15.8,1200834,766500,264820,27014,1212,236594,169514,31450,38182,24372,8420,859,39,7523,5390,565715,356274,93629,71465,22164,115812,34342,81470,12900,9659,3241,531,2710,43854,36885,30063,0
9,1,1,1,15.8,44.5,25.7,14,935388,669327,173499,22229,1290,149980,92562,21523,43460,31098,8061,1033,60,6968,4301,802516,542188,158875,126008,32867,101453,-58,101511,10488,8327,2161,46,2115,76518,65112,47996,0
9,1,6,6,26,38.4,22.7,12.9,1048793,585706,321663,42286,1356,278021,141424,33763,31063,17348,9527,1252,40,8234,4189,497471,307794,84382,64334,20048,105295,38645,66650,11951,8984,2967,564,2403,41626,34260,27736,0
9,1,2,2,17.4,42.3,26.8,13.5,1002656,570293,242390,30263,1378,210749,189973,27066,37045,21070,8956,1118,51,7786,7019,511872,376439,90194,67873,22321,45239,-5838,51077,10972,7511,3461,565,2896,46653,50118,17637,1
9,1,2,2,22.5,38.8,23.8,15,1190271,760396,271844,39759,1750,230335,158031,33136,35921,22948,8204,1200,53,6951,4769,1259311,954585,239419,180687,58732,65307,-935,66242,19371,15596,3775,128,3647,65010,61207,18163,0
9,1,6,6,26.1,39.3,23.3,11.3,1432755,832610,407955,52756,1787,353412,192190,41121,34842,20248,9921,1283,43,8594,4674,610933,366865,106160,84474,21686,137908,40357,97551,16266,11822,4444,789,3655,37559,31032,26690,0
9,1,6,5,19.7,44.2,22.2,13.9,895377,473160,310457,45247,1923,263287,111760,26653,33594,17753,11648,1698,72,9878,4193,404143,237106,67054,50923,16131,99983,50564,49419,10708,7643,3065,361,2704,37742,31023,18276,1
9,1,6,5,15,33.1,32.6,19.4,1308393,766795,344810,50435,1993,292382,196788,39126,33440,19598,8813,1289,51,7473,5030,764878,485606,142644,113717,28927,136628,29421,107207,18784,14259,4525,526,3999,40720,34056,26808,0
9,1,1,1,18.3,39.1,30.5,12.1,1279814,798125,302987,48996,2036,251955,178702,44447,28794,17957,6817,1102,46,5669,4021,756612,520514,161536,130035,31501,74562,2205,72357,16582,11579,5003,35,4968,45629,44953,14565,0
9,1,6,3,23.4,41.1,23.3,12.2,1437343,767469,496765,62928,2054,431783,173109,46353,31009,16557,10717,1358,44,9315,3735,586857,392695,113163,89555,23608,80999,2048,78951,16920,11252,5668,686,4982,34684,34900,15847,1
9,1,2,2,18.7,39.4,26.5,15.5,1429880,813747,406369,45336,2055,358978,209764,40299,35482,20193,10084,1125,51,8908,5205,741922,508147,127773,94992,32781,106002,205,105797,17691,13164,4527,376,4151,41938,38601,25487,0
9,1,2,2,24.2,41.7,22,12.1,2381671,1604603,445654,49342,2241,394071,331414,59567,39983,26938,7482,828,38,6616,5564,1059249,664324,160404,119410,40994,234521,48180,186341,23120,15521,7599,1020,6579,45815,42802,28324,0
9,1,2,2,22.4,40.8,24.7,12.2,2339601,1515251,504172,65007,2321,436844,320178,62664,37336,24181,8046,1037,37,6971,5109,964508,577147,149126,111870,37256,238235,58645,179590,23684,16415,7269,721,6548,40724,35160,27427,3
9,1,1,1,11.8,35.4,30.5,22.3,2361020,1730078,342244,36659,2366,303219,288698,52732,44774,32809,6490,695,45,5750,5475,2417859,1768378,477845,369373,108472,171636,-27,171663,33240,27078,6162,56,6106,72739,65307,28114,2
9,1,4,5,11.8,26.8,25.2,36.2,1650745,980469,333356,42010,2378,288968,336920,47342,34869,20710,7041,887,50,6104,7117,1100057,692464,184029,141856,42173,223564,28223,195341,25411,19115,6296,283,6013,43291,36226,32486,10
9,1,1,1,15.8,37.3,30.5,16.4,1751153,1224464,349366,53292,2423,293651,177323,43743,40033,27992,7987,1218,55,6713,4054,1306051,822556,232630,180875,51755,250865,1161,249704,20170,15346,4824,15,4809,64752,53601,51924,2
9,1,4,5,20.2,48.9,20.2,10.6,2098943,1289346,455602,60368,2500,392734,353995,53273,39400,24203,8552,1133,47,7372,6645,1937194,1470423,324223,232511,91712,142548,-8475,151023,34192,28617,5575,95,5480,56656,51383,27559,7
9,1,5,8,12.5,36.6,33.2,17.7,1934828,1175616,382460,38469,2512,341479,376752,52852,36608,22244,7236,728,48,6461,7128,1515405,1048627,390494,295712,94782,76284,-2429,78713,26196,22851,3345,404,2941,57849,45890,26764,1
9,1,6,4,26.4,42.5,20.8,10.3,962807,665885,191142,22542,2755,165845,105780,23038,41792,28904,8297,978,120,7199,4592,335833,199915,50885,38196,12689,85033,-2380,87413,6958,4923,2035,55,1980,48266,40608,44148,0
9,1,2,2,21.5,43.5,22.3,12.7,2943729,1861260,613061,86821,3130,523110,469408,73758,39911,25235,8312,1177,42,7092,6364,2336392,1734537,361328,251938,109390,240527,-7198,247725,44000,34568,9432,208,9224,53100,50178,26857,6
9,1,3,2,23.9,39.7,20.1,16.3,4497966,2816875,711490,74362,3657,633471,969601,97901,45944,28773,7267,760,37,6471,9904,3331222,2471053,557397,406551,150846,302772,14974,287798,54913,43761,11152,329,10823,60664,56467,26591,5
9,1,4,5,23.5,42.4,20.5,13.5,3264576,1979692,856366,118220,3917,734229,428518,83665,39020,23662,10236,1413,47,8776,5122,1499291,953818,257517,198256,59261,287956,14532,273424,36944,26738,10206,1114,9092,40583,35673,30073,3
9,1,3,2,21.7,39.6,24.3,14.4,5044158,3502388,840807,102516,4069,734222,700963,113512,44437,30855,7407,903,36,6468,6175,4451959,3242705,653927,445960,207967,555327,6683,548644,74220,60989,13231,142,13089,59983,53169,41916,23
9,1,2,2,11.6,33.9,26.9,27.6,5263034,4002273,674565,72131,4895,597539,586196,117263,44882,34131,5753,615,42,5096,4999,3121818,2292711,546693,397836,148857,282414,422,281992,57782,44264,13518,206,13312,54028,51796,21183,6
9,1,2,2,11.2,28.7,34.5,25.7,5151963,3367281,944601,90776,5198,848627,840081,124916,41243,26956,7562,727,42,6794,6725,3220002,2096946,599419,443099,156320,523637,2102,521535,67154,52663,14491,395,14096,47950,39818,36999,10
9,1,2,2,14.7,40.4,27.5,17.4,5059821,3683795,871813,87341,5519,778953,504213,135579,37320,27171,6430,644,41,5745,3719,1529858,983394,249765,187313,62452,296699,113,296586,41120,26746,14374,340,14034,37205,36768,21133,4
9,1,3,2,15.3,37.1,27.5,20.1,5410783,3104630,1391150,147389,6019,1237742,915003,132302,40897,23466,10515,1114,45,9355,6916,3748055,2448496,637827,476634,161193,661732,25985,635747,75836,62140,13696,696,13000,49423,39403,48904,7
9,1,3,2,18,36.2,25.9,19.9,4457259,2742341,1161370,158710,6158,996502,553548,126954,35109,21601,9148,1250,49,7849,4360,2471147,1695233,444402,344735,99667,331512,9436,322076,60818,45045,15773,905,14868,40632,37634,21662,8
9,1,3,2,14.4,34,27.3,24.3,5596800,3341846,1326884,195184,7691,1124009,928070,156382,35789,21370,8485,1248,49,7188,5935,4037351,2895142,702664,516119,186545,439545,14215,425330,97580,74733,22847,365,22482,41375,38740,18919,15
9,1,3,2,13.9,33.9,30.5,21.7,8087496,5313247,1548143,171319,8573,1368251,1226106,196641,41128,27020,7873,871,44,6958,6235,6258510,4318354,1118987,837420,281567,821169,11164,810005,116398,94086,22312,751,21561,53768,45898,37568,5
9,1,2,2,13,28.9,26.2,31.8,12465861,8772525,1519417,171361,9058,1338998,2173919,235834,52859,37198,6443,727,38,5678,9218,11407528,7667065,1513675,1024645,489030,2226788,-350,2227138,191966,150209,41757,525,41232,59425,51043,54015,72
9,1,1,1,10.5,25.9,31.1,32.5,13987088,9772767,1863922,137156,9816,1716950,2350399,245511,56971,39806,7592,559,40,6993,9573,7569218,4048356,916643,666180,250463,2604219,5287,2598932,131302,89952,41350,501,40849,57647,45006,63623,57
9,1,2,2,13.5,33.2,29.4,24,12138540,7584904,2231118,320019,12886,1898213,2322518,252789,48018,30005,8826,1266,51,7509,9188,9277930,5331269,1310429,953641,356788,2636232,4195,2632037,163364,123952,39412,490,38922,56793,43011,67623,15
9,1,1,1,14.1,23,26.4,36.5,17572554,10417801,2869659,490579,19175,2359905,4285094,384763,45671,27076,7458,1275,50,6133,11137,15044701,10515540,2395245,1689321,705924,2133916,0,2133916,269829,211063,58766,0,58766,55756,49822,36312,19
9,1,1,1,15.1,31.4,28.3,25.2,20051170,12907136,3441605,371133,20072,3050400,3702429,435585,46033,29632,7901,852,46,7003,8500,14327158,9749255,2058156,1422370,635786,2519747,926,2518821,274552,208491,66061,51,66010,52184,46761,38158,65
9,1,2,2,9.8,27.2,28.6,34.5,20208155,13086291,3265726,449234,20450,2796042,3856138,445887,45321,29349,7324,1008,46,6271,8648,19145211,13917048,3265953,2389413,876540,1962210,1826,1960384,350440,285630,64810,355,64455,54632,48724,30415,76
9,1,8,7,34.4,38.2,21.3,6.1,19732,3295,9539,1944,136,7459,6898,1393,14165,2365,6848,1396,98,5355,4952,-511,6750,1923,1326,597,-9184,-9684,500,474,291,183,67,116,-1078,23196,4310,0
9,1,8,7,24.7,25.3,28.6,21.5,120251,34474,58951,10600,389,47962,26826,4610,26085,7478,12788,2299,84,10404,5819,38767,40507,10807,7646,3161,-12547,-20238,7691,2089,1430,659,106,553,18558,28327,13908,0
9,1,9,10,15.5,37.8,30.6,16.2,251140,135237,83696,9152,419,74125,32207,7773,32309,17398,10768,1177,54,9536,4143,102182,66249,18951,14016,4935,16982,5451,11531,2852,1899,953,162,791,35828,34886,14578,0
9,1,1,1,26.9,35.5,27.3,10.3,222369,114763,82489,11366,506,70617,25117,8298,26798,13830,9941,1370,61,8510,3027,56606,35004,10156,7337,2819,11446,1388,10058,2198,1096,1102,260,842,25753,31938,11945,0
9,1,9,10,18.6,35.6,28.5,17.3,240335,131063,80719,10109,529,70081,28553,8383,28669,15634,9629,1206,63,8360,3406,123859,82636,22453,16159,6294,18770,5414,13356,3373,2312,1061,211,850,36721,35742,15713,0
9,1,9,8,17.9,34.5,31.2,16.4,329205,184895,96025,9554,543,85928,48285,10233,32171,18069,9384,934,53,8397,4719,63423,41566,11331,8084,3247,10526,-12692,23218,2775,1442,1333,429,904,22855,28825,25684,0
9,1,8,7,30.2,36.5,18.4,14.9,251405,114862,96588,15098,567,80923,39955,9182,27380,12509,10519,1644,62,8813,4351,89239,61377,16446,11744,4702,11416,1514,9902,3288,2078,1210,150,1060,27141,29537,9342,0
9,1,9,10,14.8,36.1,30.9,18.1,317473,168634,110264,10217,618,99429,38575,9989,31782,16882,11039,1023,62,9954,3862,99034,68419,17843,12546,5297,12772,-3494,16266,3815,2295,1520,309,1211,25959,29812,13432,0
9,1,8,5,21.1,38.9,26.7,13.2,378349,210081,124630,13397,620,110613,43638,12598,30032,16676,9893,1063,49,8780,3464,131294,74606,18202,12549,5653,38486,24216,14270,3781,2270,1511,494,1017,34725,32866,14031,0
9,1,3,2,19.3,38.6,31.6,10.6,346013,191002,120325,13377,672,106276,34686,12051,28712,15849,9985,1110,56,8819,2878,141748,101541,22643,15757,6886,17564,908,16656,3598,2466,1132,264,868,39396,41176,19189,1
9,1,8,7,18.6,37.5,30.1,13.8,406721,227721,138641,13651,680,124310,40359,12601,32277,18072,11002,1083,54,9865,3203,198026,115983,27830,19672,8158,54213,34664,19549,4080,2699,1381,340,1041,48536,42973,18779,0
9,1,8,7,19.8,42.3,26.8,11,560428,361020,147035,14604,686,131745,52373,16211,34571,22270,9070,901,42,8127,3231,275967,115815,30988,22008,8980,129164,106245,22919,5269,3235,2034,555,1479,52376,35801,15496,0
9,1,8,7,24.1,36.8,30.5,8.7,379705,230790,111900,11682,695,99523,37015,14341,26477,16093,7803,815,48,6940,2581,103909,68720,20924,15797,5127,14265,3381,10884,3509,2342,1167,333,834,29612,29342,13050,1
9,1,7,9,19.8,33.7,25.6,21,310991,137333,126188,13541,706,111941,47470,10357,30027,13260,12184,1307,68,10808,4583,122972,87836,22889,16251,6638,12247,-3668,15915,4023,2904,1119,292,827,30567,30247,19244,1
9,1,8,7,24.3,35.8,25,15,317180,153949,128527,19166,764,108597,34704,11822,26830,13022,10872,1621,65,9186,2936,102659,61116,16926,12184,4742,24617,14864,9753,3405,2051,1354,285,1069,30149,29798,9123,3
9,1,7,9,19,37,30,14,411230,213767,146350,17390,830,128130,51113,12306,33417,17371,11893,1413,67,10412,4154,166714,107413,30469,22053,8416,28832,-2502,31334,5109,3326,1783,308,1475,32631,32295,21243,0
9,1,9,8,20,33,33.9,13.1,279723,141030,105773,12923,857,91993,32920,10248,27295,13762,10321,1261,84,8977,3212,305926,235530,52871,34755,18116,17525,8758,8767,5379,4367,1012,324,688,56874,53934,12743,0
9,1,9,10,24.6,35.9,28.2,11.2,411862,211656,148443,15639,858,131946,51763,14695,28027,14403,10102,1064,58,8979,3522,168017,118427,30672,21535,9137,18918,-3090,22008,5843,3955,1888,514,1374,28755,29944,16017,0
9,1,9,10,19.8,45,24.8,10.3,440648,236997,150621,18659,874,131088,53030,14837,29699,15973,10152,1258,59,8835,3574,166170,88389,23455,16768,6687,54326,26047,28279,5000,2979,2021,571,1450,33234,29671,19503,0
9,1,8,6,18.3,36.8,28.8,16.1,635996,374686,185882,23443,899,161540,75428,19148,33215,19568,9708,1224,47,8436,3939,324316,178674,48282,34578,13704,97360,66607,30753,8096,5627,2469,415,2054,40059,31753,14972,0
9,1,6,6,17.4,34.9,32.7,15,543471,296984,177888,16362,921,160605,68599,17852,30443,16636,9965,917,52,8996,3843,203348,143132,37320,26563,10757,22896,1442,21454,6541,4421,2120,222,1898,31088,32375,11303,0
9,1,7,9,31.8,30.1,25.3,12.9,341506,174428,128171,23872,923,103376,38907,11061,30875,15770,11588,2158,83,9346,3517,150166,85022,24166,17576,6590,40978,20308,20670,4996,2915,2081,482,1599,30057,29167,12927,0
9,1,9,8,15.9,37.3,32.9,13.9,576852,339099,172684,19679,931,152074,65069,16529,34899,20515,10447,1191,56,9200,3937,262931,157539,41043,29247,11796,64349,42610,21739,6315,4332,1983,377,1606,41636,36366,13536,0
9,1,9,8,21.1,34.9,30.8,13.3,582304,347074,177015,16376,981,159658,58215,16277,35775,21323,10875,1006,60,9809,3577,177288,114207,28634,20322,8312,34447,13125,21322,5128,3382,1746,285,1461,34573,33769,14594,1
9,1,7,9,29.1,34.6,26.2,10.1,388474,202029,135534,23503,985,111046,50911,14701,26425,13743,9219,1599,67,7554,3463,188261,113472,28098,18982,9116,46691,23424,23267,5178,3692,1486,432,1054,36358,30735,22075,0
9,1,6,6,21.7,38.3,27.9,12.1,688806,418038,203476,25838,989,176649,67292,23182,29713,18033,8777,1115,43,7620,2903,342761,173051,46246,32238,14008,123464,88972,34492,8084,5833,2251,538,1713,42400,29668,20135,0
9,1,1,1,21.3,29.5,32,17.1,311453,163974,96909,22148,996,73765,50570,10491,29688,15630,9237,2111,95,7031,4820,431010,345010,66514,38076,28438,19486,6071,13415,11418,10234,1184,85,1099,37748,33712,12207,1
9,1,7,9,16.7,29.9,37.1,16.3,722768,398045,235670,23418,1018,211234,89053,21615,33438,18415,10903,1083,47,9773,4120,328011,203658,55494,40113,15381,68859,45010,23849,8733,6611,2122,484,1638,37560,30806,14560,0
9,1,8,6,20.9,40.9,26.7,11.5,566095,294123,199187,14788,1055,183344,72785,19413,29161,15151,10260,762,54,9444,3749,266225,188492,49370,34616,14754,28363,280,28083,7775,5958,1817,249,1568,34241,31637,17910,1
9,1,6,6,22.6,30.9,34.1,12.3,583560,322014,185438,23253,1166,161019,76108,18824,31001,17107,9851,1235,62,8554,4043,258021,158947,41048,29071,11977,58026,-1377,59403,7020,5070,1950,389,1561,36755,31350,38054,0
9,1,7,8,21.2,29,31.7,18.1,680920,352510,238814,28579,1180,209055,89596,21600,31524,16320,11056,1323,55,9678,4148,507939,365064,91588,63462,28126,51287,2656,48631,13753,11212,2541,264,2277,36933,32560,21357,0
9,1,2,2,20.7,35.2,30.8,13.3,947105,555255,301532,31251,1189,269092,90318,27490,34453,20198,10969,1137,43,9789,3285,416370,229580,58916,41219,17697,127874,77473,50401,11358,8110,3248,502,2746,36659,28308,18354,0
9,1,7,9,24.9,37.4,25,12.6,708554,422435,189148,26140,1211,161797,96971,20451,34646,20656,9249,1278,59,7911,4742,389361,203472,48991,34086,14905,136898,72212,64686,7966,5688,2278,416,1862,48878,35772,34740,0
9,1,7,8,22.3,30.1,34.6,13,727157,417346,226091,15675,1234,209182,83720,23394,31083,17840,9664,670,53,8942,3579,329563,226487,55299,38218,17081,47777,4998,42779,8330,6608,1722,385,1337,39563,34275,31996,1
9,1,7,9,21.8,32.8,31.4,14.1,1014567,604266,268372,31774,1254,235344,141929,29428,34476,20534,9120,1080,43,7997,4823,739780,465934,115967,81485,34482,157879,103854,54025,16499,13424,3075,568,2507,44838,34709,21550,2
9,1,6,4,22.4,33.7,29.4,14.5,649109,351500,221187,23653,1254,196280,76422,21969,29547,16000,10068,1077,57,8934,3479,314672,220457,56694,39346,17348,37521,1264,36257,9894,6988,2906,590,2316,31804,31548,15655,0
9,1,7,9,25.5,36.5,26.2,11.8,532050,274888,172197,21673,1265,149259,84965,17384,30606,15813,9905,1247,73,8586,4888,296061,191158,46222,30929,15293,58681,21681,37000,8415,5947,2468,480,1988,35183,32144,18612,0
9,1,6,6,20.6,37.1,30.3,11.9,736493,458281,190136,19657,1271,169208,88076,23310,31596,19660,8157,843,55,7259,3778,278530,204603,50822,35583,15239,23105,-1959,25064,8242,5843,2399,492,1907,33794,35017,13143,0
9,1,7,9,20.9,33.5,29.7,15.9,600671,324211,191277,23913,1302,166062,85183,18601,32292,17430,10283,1286,70,8928,4579,282270,181704,43417,29896,13521,57149,33694,23455,7572,5231,2341,438,1903,37278,34736,12325,0
9,1,6,4,21.7,33.2,30.5,14.7,824067,482169,229947,21495,1407,207045,111951,28116,29310,17149,8179,765,50,7364,3982,590404,424617,96469,64602,31867,69318,5500,63818,14522,10849,3673,597,3076,40656,39139,20747,3
9,1,7,9,21.8,33.3,32.6,12.3,705713,374923,240246,21768,1439,217039,90544,25405,27779,14758,9457,857,57,8543,3564,343921,244798,63307,44241,19066,35816,674,35142,10309,7889,2420,426,1994,33361,31030,17624,1
9,1,6,6,22.1,37.4,27.6,12.9,752603,371215,271287,33706,1484,236097,110101,25680,29307,14455,10564,1313,58,9194,4287,451832,312409,71636,48333,23303,67787,37924,29863,12217,8873,3344,457,2887,36984,35209,10344,0
9,1,6,5,13.4,36.7,34.9,15,1234169,769057,324624,34922,1586,288116,140488,34725,35541,22147,9348,1006,46,8297,4046,658340,441121,101157,68296,32861,116062,31456,84606,16792,12508,4284,496,3788,39206,35267,22335,1
9,1,7,8,24,30.9,30.3,14.9,901440,561417,238735,24916,1629,212190,101288,30787,29280,18236,7754,809,53,6892,3290,568223,410927,94241,60152,34089,63055,-1151,64206,16359,12803,3556,756,2800,34735,32096,22931,0
9,1,6,6,24.7,41,23.6,10.7,463485,164744,244699,46940,1666,196093,54042,18509,25041,8901,13221,2536,90,10594,2920,152994,123649,33911,24341,9570,-4566,-26520,21954,6499,4255,2244,443,1801,23541,29060,12190,0
9,1,2,2,23.6,36,26.1,14.3,715238,352043,250005,41951,1680,206374,113190,27811,25718,12658,8989,1508,60,7421,4070,356611,272970,77574,56650,20924,6067,-35678,41745,10248,7360,2888,550,2338,34798,37088,17855,0
9,1,2,2,21.5,30.7,34.5,13.3,892444,516724,282350,42540,1723,238087,93370,28928,30851,17862,9760,1471,60,8230,3228,417404,265836,74372,53513,20859,77196,19234,57962,11211,7903,3308,420,2888,37232,33637,20070,2
9,1,5,8,20.5,34.8,27.4,17.4,1082938,552908,331498,43739,1734,286025,198532,31962,33882,17299,10372,1368,54,8949,6212,670572,430403,96300,64904,31396,143869,2610,141259,16763,12216,4547,154,4393,40003,35233,32155,0
9,1,7,8,19.2,33.5,31.3,15.9,1179996,633690,378386,35448,1803,341135,167920,37235,31691,17019,10162,952,48,9162,4510,698265,500657,119695,81642,38053,77913,4214,73699,18572,14496,4076,434,3642,37598,34538,20236,0
9,1,7,9,20,32,28.7,19.3,698848,403784,193039,27941,1949,163149,102025,20135,34708,20054,9587,1388,97,8103,5067,357267,202788,46506,30911,15595,107973,70049,37924,8456,5826,2630,344,2286,42250,34807,16590,0
9,1,7,8,27.8,29.4,28.3,14.5,726753,336576,272822,53323,1958,217541,117355,27398,26526,12285,9958,1946,71,7940,4283,417091,295799,81609,59051,22558,39683,2448,37235,12178,9765,2413,275,2138,34250,30292,17416,0
9,1,1,1,19.5,31.5,32.9,16.1,882137,528395,250432,27459,2019,220954,103310,28246,31231,18707,8866,972,71,7822,3658,294087,196283,51543,36721,14822,46261,-303,46564,9865,6183,3682,492,3190,29811,31746,14597,3
9,1,7,8,21.6,26.9,34.6,16.9,768607,341615,305871,54946,2049,248876,121121,24842,30940,13752,12313,2212,82,10018,4876,402866,314301,74664,50863,23801,13901,-33274,47175,11751,9139,2612,226,2386,34284,34391,19772,0
9,1,6,5,19.3,34.6,30.1,15.9,1202284,631482,406475,57716,2124,346635,164327,39937,30105,15812,10178,1445,53,8680,4115,750034,498723,130440,93037,37403,120871,15567,105304,20984,15759,5225,430,4795,35743,31647,21961,0
9,1,1,1,20.6,41.3,25,13.1,1040947,611993,327143,48627,2201,276315,101811,36166,28782,16922,9046,1345,61,7640,2815,360281,234831,56054,37749,18305,69396,-3302,72698,11893,6870,5023,490,4533,30294,34182,16038,2
9,1,7,8,23.9,24.4,28.8,22.9,1101885,539806,379984,66021,2274,311689,182095,33803,32597,15969,11241,1953,67,9221,5387,599214,434943,112813,80107,32706,51458,-17586,69044,16662,13072,3590,355,3235,35963,33273,21343,6
9,1,2,2,15.3,27.6,36.2,20.9,1556329,852077,389437,37498,2309,349630,314815,45939,33878,18548,8477,816,50,7611,6853,1005911,738942,195164,135565,59599,71805,-811,72616,20104,15193,4911,209,4702,50035,48637,15444,4
9,1,3,2,9.4,23.6,31.1,35.9,2163864,1463624,366649,39311,2395,324943,333591,60060,36028,24369,6105,655,40,5410,5554,974513,599794,136463,91222,45241,238256,11157,227099,28989,19827,9162,357,8805,33617,30251,25792,1
9,1,4,3,10.5,18.9,28.8,41.9,1830776,1075966,363897,26061,2419,335417,390913,51828,35324,20760,7021,503,47,6472,7543,1252871,865594,221385,158401,62984,165892,-1455,167347,30735,23534,7201,381,6820,40764,36781,24538,6
9,1,5,8,21.8,35.5,24.8,17.9,963869,435525,340642,62760,2444,275438,187702,30685,31412,14193,11101,2045,80,8976,6117,682542,517783,137211,97544,39667,27548,-34778,62326,18742,15701,3041,247,2794,36418,32978,22307,0
9,1,6,4,22.2,38.2,25.2,14.4,1035403,584551,323212,50546,2553,270113,127640,34434,30069,16976,9386,1468,74,7844,3707,604448,412831,101266,69705,31561,90351,2042,88309,16544,11959,4585,618,3967,36536,34521,22261,0
9,1,6,3,15.8,30,39.2,15,1824383,1074476,513616,51188,2596,459832,236291,55130,33092,19490,9316,928,47,8341,4286,559012,363431,94751,68005,26746,100830,3349,97481,17776,11219,6557,679,5878,31448,32394,16584,3
9,1,5,8,11.9,21.1,24.4,42.6,1510592,898992,328339,41962,2767,283610,283261,49024,30813,18338,6698,856,56,5785,5778,1068399,755868,216656,160607,56049,95875,618,95257,28446,23177,5269,336,4933,37559,32613,19310,8
9,1,7,9,20.1,35.5,27.9,16.5,1125936,616494,347434,35425,2786,309223,162008,36065,31220,17094,9634,982,77,8574,4492,585585,402812,101470,69676,31794,81303,4768,76535,14103,10664,3439,607,2832,41522,37773,27025,0
9,1,4,5,17.8,31.1,32.6,18.4,2574837,1465073,728102,68318,2837,656947,381662,68303,37697,21450,10660,1000,42,9618,5588,1860529,1259111,316700,226763,89937,284718,84501,200217,38663,31236,7427,792,6635,48122,40310,30176,1
9,1,4,5,12.8,32.2,32.1,22.9,1694774,979638,428889,61229,3034,364626,286247,47944,35349,20433,8946,1277,63,7605,5970,1219827,922657,245846,173456,72390,51324,1534,49790,26912,22113,4799,185,4614,45327,41725,10791,2
9,1,3,2,13.3,27.6,32.3,26.7,2715695,1504127,682710,76529,4204,601977,528858,75808,35823,19841,9006,1010,55,7941,6976,2369187,1639722,417201,295395,121806,312264,1657,310607,50876,42514,8362,307,8055,46568,38569,38561,6
9,1,5,8,21.2,30.6,29.2,19,1645617,873527,528328,106820,4335,417173,243762,48997,33586,17828,10783,2180,88,8514,4975,959485,655771,162838,112621,50217,140876,9318,131558,24445,19409,5036,223,4813,39251,33787,27334,9
9,1,5,8,15.3,30.7,30.4,23.6,2101326,1203481,516008,66216,4377,445415,381837,59779,35152,20132,8632,1108,73,7451,6387,1612069,1195501,296770,204205,92565,119798,-7453,127251,35029,28243,6786,344,6442,46021,42329,19753,8
9,1,5,8,13.8,30.7,35.4,20.1,2761393,1588719,715235,87025,4495,623715,457439,79213,34860,20056,9029,1099,57,7874,5775,1964432,1412943,350917,240457,110460,200572,1691,198881,45691,37645,8046,310,7736,42994,37533,25709,4
9,1,5,8,16.8,25.9,33.9,23.5,3097165,1907091,683390,76907,5090,601393,506684,84758,36541,22500,8063,907,60,7095,5978,2762810,2039251,452162,296973,155189,271397,-303,271700,64401,54245,10156,439,9717,42900,37593,27961,3
9,1,2,2,10.3,26.2,34.3,29.2,6226424,4277381,1093221,83247,5562,1004412,855822,148406,41955,28822,7366,561,37,6768,5767,3866015,2576246,572259,382631,189628,717510,45226,672284,85378,65897,19481,565,18916,45281,39095,35540,6
9,1,1,1,10.6,29.5,36.4,23.5,6077527,4414748,1010205,101424,7397,901384,652574,170640,35616,25872,5920,594,43,5282,3824,2751311,1964632,430346,281010,149336,356333,1447,354886,76873,57087,19786,372,19414,35790,34415,18280,24
9,1,2,2,12.2,31.6,35.6,20.7,4934663,3061803,1087024,111087,8316,967621,785836,141374,34905,21657,7689,786,59,6844,5559,3593662,2631247,717955,519002,198953,244460,-8970,253430,67527,53906,13621,350,13271,53218,48812,19097,6
9,1,2,2,13,29.2,35.6,22.2,6970508,3893202,1618812,193152,10103,1415557,1458494,198218,35166,19641,8167,974,51,7141,7358,5306365,3855767,1029370,720161,309209,421228,-814,422042,121003,97728,23275,273,23002,43853,39454,18348,13
9,1,2,2,13.7,25.1,32.5,28.6,9333050,5473495,2100239,345383,13778,1741078,1759316,245136,38073,22328,8568,1409,56,7102,7177,8734275,5952792,1465850,1026375,439475,1315633,7484,1308149,170357,134926,35431,853,34578,51270,44119,37832,2
10,1,8,6,23.4,37,28.2,11.4,258942,114077,99805,17896,545,81364,45060,8510,30428,13405,11728,2103,64,9561,5295,95917,61968,19543,14852,4691,14406,10747,3659,3110,1953,1157,266,891,30841,31730,4107,1
10,1,8,4,20,42,21.1,16.9,275845,124575,113990,22653,611,90726,37280,9653,28576,12905,11809,2347,63,9399,3862,121943,72963,22615,16846,5769,26365,9622,16743,3723,2613,1110,337,773,32754,27923,21660,0
10,1,8,7,20.5,37.6,28.7,13.3,436819,216875,156421,14357,611,141453,63523,13931,31356,15568,11228,1031,44,10154,4560,187979,132695,35453,25545,9908,19831,2143,17688,5481,3671,1810,315,1495,34296,36147,11831,0
10,1,9,10,20.9,43.2,23.9,12,321675,130010,140191,28378,701,111112,51474,10901,29509,11926,12860,2603,64,10193,4722,175857,122290,33015,24373,8642,20552,9108,11444,4412,3140,1272,282,990,39859,38946,11560,3
10,1,9,10,19.9,39.9,28.6,11.6,471300,250577,161608,17206,720,143682,59115,13231,35621,18939,12214,1300,54,10859,4468,253982,175978,40780,28424,12356,37224,3755,33469,5243,3825,1418,227,1191,48442,46007,28102,0
10,1,8,6,17.3,39.7,24.7,18.2,402981,211213,137131,24458,726,111947,54637,13174,30589,16033,10409,1857,55,8498,4147,215564,126147,37147,27914,9233,52270,38798,13472,5192,3583,1609,379,1230,41518,35207,10953,0
10,1,3,2,18.9,42.7,23.9,14.4,509346,267639,166517,24257,819,141441,75190,15018,33916,17821,11088,1615,55,9418,5007,168005,103655,30105,22286,7819,34245,24184,10061,4951,3080,1871,399,1472,33934,33654,6835,0
10,1,3,2,20.2,37.8,30.3,11.8,627031,335610,207682,25094,907,181681,83739,20776,30181,16154,9996,1208,44,8745,4031,233604,141787,44020,33212,10808,47797,23564,24233,6094,4117,1977,376,1601,38333,34439,15136,0
10,1,1,1,17.9,43.9,25,13.2,655342,384964,201083,21277,971,178835,69295,22561,29048,17063,8913,943,43,7927,3071,250755,175398,47170,34223,12947,28187,2859,25328,6441,4586,1855,168,1687,38931,38246,15014,0
10,1,7,11,16.8,39.6,28.1,15.4,713222,370445,227368,31084,993,195291,115409,19757,36100,18750,11508,1573,50,9885,5841,413154,288315,75631,54659,20972,49208,16367,32841,9663,7544,2119,429,1690,42756,38218,19433,2
10,1,6,4,22.8,36.2,28.1,12.9,758554,391002,246063,22209,1237,222617,121489,23918,31715,16348,10288,929,52,9308,5079,413373,255499,70032,49900,20132,87842,18859,68983,10763,7838,2925,463,2462,38407,32597,28019,0
10,1,7,11,17,46.7,23.8,12.5,675164,320368,223615,26974,1281,195360,131181,21720,31085,14750,10295,1242,59,8994,6040,354780,271681,68497,48726,19771,14602,-4919,19521,9147,6795,2352,442,1910,38786,39982,10220,0
10,1,7,11,19.3,35.3,31.9,13.4,910201,479028,285780,28188,1496,256096,145393,30116,30223,15906,9489,936,50,8504,4828,501986,339334,91186,64723,26463,71466,30258,41208,13371,10375,2996,645,2351,37543,32707,17528,2
10,1,7,11,18.5,44.3,24.2,13,832256,447852,259818,34061,1618,224139,124586,24708,33684,18126,10516,1379,65,9072,5042,479377,335302,86596,61962,24634,57479,3973,53506,12146,8957,3189,238,2951,39468,37435,18131,2
10,1,4,3,17.9,35.9,31.3,14.9,3009311,1820048,767369,62858,3313,701198,421894,81721,36824,22271,9390,769,41,8580,5163,1678072,1094125,272289,190348,81941,311658,109569,202089,40479,30050,10429,1777,8652,41455,36410,23357,4
10,1,3,2,16.1,33.7,31.4,18.8,1939712,1078879,559308,47716,3396,508196,301525,54358,35684,19848,10289,878,62,9349,5547,1507168,1105170,286582,203283,83299,115416,2539,112877,31632,25668,5964,620,5344,47647,43056,21122,2
10,1,3,2,14.1,35.3,28.1,22.5,3229144,1774460,826746,66568,5414,754764,627938,92422,34939,19200,8945,720,59,8166,6794,1533667,1058866,274116,194261,79855,200685,80,200605,43578,31889,11689,1322,10367,35194,33205,19350,9
10,1,3,2,9.8,27.8,31.7,30.7,8400864,4911148,1768065,125954,8158,1633953,1721651,202863,41412,24209,8716,621,40,8054,8487,3665610,2531374,594097,403569,190528,540139,-2105,542244,103943,73835,30108,842,29266,35266,34284,18528,13
10,1,3,2,11.8,29.4,28.5,30.2,7347038,4406297,1567082,172741,9167,1385174,1373659,204473,35932,21550,7664,845,45,6774,6718,5718534,4208303,1103361,794973,308388,406870,4693,402177,122320,100224,22096,441,21655,46751,41989,18572,24
10,1,2,2,13.7,32.6,30.6,23,14893696,8796150,3706020,501331,22083,3182606,2391526,414588,35924,21217,8939,1209,53,7677,5768,11263204,8189790,1968893,1357560,611333,1104521,20766,1083755,233931,183792,50139,588,49551,48148,44560,21872,16
10,1,1,1,10.6,26.8,30.7,31.9,32279487,19729247,5825628,692700,32080,5100848,6724612,660087,48902,29889,8826,1049,49,7728,10187,27001960,19328817,4358423,2964942,1393481,3314720,2963,3311757,454788,370764,84024,339,83685,59373,52132,39574,58
10,1,6,6,18.6,36.7,26.2,18.4,384341,152474,105640,10215,167,95258,126227,11684,32895,13050,9041,874,14,8153,10803,176540,116513,31694,23365,8329,28333,0,28333,5328,3583,1745,0,1745,33134,32518,16237,0
10,1,3,2,15.7,36.6,29.2,18.5,485579,229789,140341,10861,318,129162,115449,15940,30463,14416,8804,681,20,8103,7243,203650,142815,39366,29341,10025,21469,0,21469,5649,3879,1770,0,1770,36051,36817,12129,0
10,1,3,2,14.1,26.5,32.6,26.7,3293385,1767800,501492,40078,1262,460152,1024093,63087,52204,28022,7949,635,20,7294,16233,1461527,904694,198461,134030,64431,358372,16670,341702,37512,24773,12739,602,12137,38962,36519,28154,16
10,1,4,3,8.8,27.8,31.6,31.8,5660751,2226962,628974,42656,1375,584943,2804815,77003,73513,28920,8168,554,18,7596,36425,2595655,1865346,410404,277152,133252,319905,0,319905,62303,44163,18140,0,18140,41662,42238,17635,23
10,1,2,2,9.3,27.1,36.4,27.1,6738767,4113782,1338300,91092,3460,1243748,1286685,166365,40506,24727,8044,548,21,7476,7734,2247640,1518362,391166,276898,114268,338112,-6684,344796,57115,38750,18365,580,17785,39353,39184,19387,26
10,1,3,2,8.4,25.3,36.6,29.8,8952618,4649259,1720260,123651,4448,1592161,2583099,197709,45282,23516,8701,625,22,8053,13065,6631519,4881877,1392966,992367,400599,356676,-988,357664,125653,100627,25026,415,24611,52776,48515,14533,18
10,1,3,2,10.9,30.9,35.9,22.4,7342644,4105096,1651331,152436,6857,1492038,1586217,181184,40526,22657,9114,841,38,8235,8755,4730122,3460203,882889,620159,262730,387030,-60,387090,105201,84779,20422,94,20328,44963,40814,19042,17
10,1,2,2,9.4,27.3,37.3,26,12141597,6576761,2900850,300310,8174,2592366,2663986,309529,39226,21248,9372,970,26,8375,8607,8776827,6524449,1696129,1198034,498095,556249,-2559,558808,176343,145734,30609,658,29951,49771,44770,18657,22
10,1,2,2,13.5,26.4,25.2,34.9,29847567,9792367,3207166,186216,9641,3011309,16848034,357194,83561,27415,8979,521,27,8430,47168,9857603,6813890,1322359,856516,465843,1721354,64994,1656360,210259,144843,65416,249,65167,46883,47043,25417,81
10,1,1,1,11.4,27.2,29.9,31.5,87217011,52063442,13893840,1523368,71471,12299001,21259729,1891684,46105,27522,7345,805,38,6502,11239,55657329,42116836,8548022,5639358,2908664,4992471,21412,4971059,1153739,825094,328645,378,328267,48241,51045,15143,428
10,1,1,1,19,28.2,25,27.8,120336362,67290366,23221925,3543358,97025,19581542,29824071,2705982,44470,24867,8582,1309,36,7236,11022,84329609,61625993,12810741,8585781,4224960,9892875,291072,9601803,1710797,1175119,535678,2078,533600,49293,52442,17994,371
10,1,9,10,23.8,45.9,20.6,9.7,141120,48649,55051,8328,326,46397,37420,4774,29560,10190,11531,1744,68,9719,7838,50845,39188,11682,9142,2540,-25,-7156,7131,1984,1216,768,226,542,25628,32227,13157,0
10,1,8,7,18.5,42.6,23.2,15.6,307239,161147,92281,12076,516,79689,53811,8715,35254,18491,10589,1386,59,9144,6175,157086,109282,31111,24077,7034,16693,6026,10667,4045,2842,1203,213,990,38835,38452,10775,0
10,1,2,2,18.5,33.9,24.6,23,525303,334987,94918,7770,545,86603,95398,15357,34206,21813,6181,506,35,5639,6212,439172,295341,93955,78516,15439,49876,10823,39053,7305,5640,1665,133,1532,60119,52365,25492,0
10,1,7,11,29.5,39.3,21.5,9.8,226613,90557,93983,15174,594,78215,42073,7275,31150,12448,12919,2086,82,10751,5783,98261,66056,20710,16473,4237,11495,3241,8254,2992,2144,848,184,664,32841,30810,12431,0
10,1,8,7,23.1,42.8,21.8,12.4,316510,163566,112464,10336,639,101489,40480,10052,31487,16272,11188,1028,64,10096,4027,127565,86344,26367,20943,5424,14854,-928,15782,3797,2603,1194,240,954,33596,33171,16543,0
10,1,9,10,22.6,41.6,21.9,13.9,313302,159771,110555,12176,661,97718,42976,10038,31212,15917,11014,1213,66,9735,4281,120187,75790,23812,19065,4747,20585,-2076,22661,3866,2408,1458,480,978,31088,31474,23171,0
10,1,7,9,24.7,39.3,22.5,13.4,335319,173223,119120,21224,709,97187,42976,11552,29027,14995,10312,1837,61,8413,3720,180487,114974,37990,30348,7642,27523,9220,18303,5139,3925,1214,245,969,35121,29293,18889,0
10,1,6,6,20.9,42.4,23.8,13,517431,287079,164313,14901,835,148577,66039,15946,32449,18003,10304,934,52,9318,4141,250944,162841,45758,36183,9575,42345,7127,35218,5505,4080,1425,162,1263,45585,39912,27884,1
10,1,6,6,20.1,43.7,23.1,13.1,505463,301081,149900,13761,856,135283,54482,14643,34519,20561,10237,940,58,9239,3721,323549,184120,49140,36527,12613,90289,7245,83044,6276,5107,1169,152,1017,51553,36052,81656,0
10,1,6,6,24.6,41.7,21.5,12.2,456526,256487,139399,10114,857,128428,60640,14984,30468,17117,9303,675,57,8571,4047,248450,174146,51691,41311,10380,22613,-877,23490,6194,4783,1411,157,1254,40111,36409,18732,0
10,1,6,6,20.6,41.3,24.1,14,555569,302587,163536,17418,870,145248,89446,16266,34155,18602,10054,1071,53,8930,5499,281800,152836,46084,37014,9070,82880,26523,56357,5553,3980,1573,241,1332,50747,38401,42310,1
10,1,9,10,23,44.8,20.3,12,345518,172956,128277,11624,1063,115590,44285,11282,30626,15330,11370,1030,94,10246,3925,129009,80661,25427,20492,4935,22921,8038,14883,3920,2444,1476,589,887,32910,33004,16779,0
10,1,1,1,17.8,36.3,26.6,19.3,1095171,756069,169960,17159,1112,151689,169142,23450,46702,32242,7248,732,47,6469,7213,1447775,1026985,264299,198693,65606,156491,5633,150858,19679,15921,3758,101,3657,73570,64505,41252,3
10,1,6,6,20.4,42.6,23.9,13.1,757406,447696,208619,19567,1193,187859,101091,25630,29552,17468,8140,763,47,7330,3944,436831,308372,100482,82675,17807,27977,18,27959,10277,8320,1957,358,1599,42506,37064,17485,0
10,1,3,2,18.2,42.3,31.1,8.5,661111,396161,190339,17943,1226,171170,74611,22279,29674,17782,8543,805,55,7683,3349,231726,150062,51656,40933,10723,30008,396,29612,5632,3829,1803,196,1607,41145,39191,18427,0
10,1,7,8,23.6,40.6,24.4,11.4,587713,280359,210237,28962,1249,180026,97117,20227,29056,13861,10394,1432,62,8900,4801,286622,198684,59195,46779,12416,28743,-3772,32515,8318,6154,2164,383,1781,34458,32285,18257,0
10,1,3,2,14.2,46.6,26.5,12.8,808627,468019,236654,23481,1267,211906,103954,22499,35941,20802,10518,1044,56,9418,4620,284511,164390,47661,36651,11010,72460,32439,40021,8125,5152,2973,349,2624,35017,31908,15252,0
10,1,6,6,16.5,44.7,24.6,14.2,777307,420103,238999,19374,1288,218337,118205,24229,32082,17339,9864,800,53,9011,4879,352434,207437,58985,45797,13188,86012,37465,48547,8449,5973,2476,320,2156,41713,34729,22517,0
10,1,2,2,21.2,37.9,25.1,15.8,905766,559641,215602,23419,1289,190894,130523,22204,40793,25205,9710,1055,58,8597,5878,323170,219938,60436,44444,15992,42796,-6481,49277,9048,6050,2998,324,2674,35717,36353,18428,1
10,1,7,11,24.8,42.2,21.5,11.4,603034,282265,239604,28085,1392,210127,81165,20379,29591,13851,11757,1378,68,10311,3983,262417,163587,52374,42263,10111,46456,4803,41653,8287,5575,2712,764,1948,31666,29343,21382,0
10,1,6,6,20.6,39,25,15.4,704591,376533,240450,27053,1440,211957,87608,20550,34287,18323,11701,1316,70,10314,4263,329821,227908,63323,48077,15246,38590,-5667,44257,9649,6890,2759,632,2127,34182,33078,20807,0
10,1,2,2,17.1,37.5,25.3,20.1,1141608,827102,197050,22847,1444,172759,117456,25570,44646,32347,7706,894,56,6756,4594,972520,704234,176124,128106,48018,92162,-5533,97695,16867,14054,2813,88,2725,57658,50109,35851,1
10,1,6,4,26.4,42.5,20.8,10.3,952703,636611,206986,22367,1475,183144,109106,22895,41612,27806,9041,977,64,7999,4765,269591,189872,50563,38535,12028,29156,-3554,32710,6789,4768,2021,56,1965,39710,39822,16646,0
10,1,6,6,21,40.7,22.5,15.8,1181976,719941,287676,27164,1607,258905,174359,31428,37609,22908,9153,864,51,8238,5548,506808,347297,95252,73553,21699,64259,5135,59124,12725,9457,3268,527,2741,39828,36724,21570,0
10,1,2,2,17.4,42.3,26.8,13.5,1027395,568777,267359,30500,1696,235163,191259,27111,37896,20980,9862,1125,63,8674,7055,485969,361427,90368,69206,21162,34174,-6246,40420,10926,7382,3544,555,2989,44478,48961,13523,2
10,1,1,1,15.8,44.5,25.7,14,934285,644412,191576,22396,1810,167370,98297,21486,43483,29992,8916,1042,84,7790,4575,827439,595336,175004,139047,35957,57099,-164,57263,10711,8692,2019,49,1970,77251,68492,29068,0
10,1,6,6,26,38.4,22.7,12.9,1063127,555280,362450,42608,1852,317990,145397,33734,31515,16461,10744,1263,55,9426,4310,468990,307683,87542,67581,19961,73765,17359,56406,11929,8838,3091,559,2532,39315,34814,22277,0
10,1,2,2,22.5,38.8,23.8,15,1217285,752502,304837,39441,2003,263393,159946,33152,36718,22699,9195,1190,60,7945,4825,1333741,1035599,258443,193704,64739,39699,-2506,42205,20110,16672,3438,127,3311,66322,62116,12747,2
10,1,6,5,19.7,44.2,22.2,13.9,923669,469992,341011,45194,2281,293536,112666,26309,35108,17864,12962,1718,87,11157,4282,386835,233540,66869,50954,15915,86426,40938,45488,10417,7407,3010,366,2644,37135,31530,17204,1
10,1,6,6,26.1,39.3,23.3,11.3,1422417,780757,455628,52603,2289,400736,186032,41042,34658,19023,11102,1282,56,9764,4533,560302,363507,111472,89850,21622,85323,7223,78100,16125,11736,4389,787,3602,34747,30974,21682,0
10,1,6,5,15,33.1,32.6,19.4,1378138,794843,375992,49719,2411,323862,207303,39003,35334,20379,9640,1275,62,8304,5315,801485,499019,150495,121008,29487,151971,29323,122648,18697,14196,4501,521,3980,42867,35152,30816,1
10,1,1,1,18.3,39.1,30.5,12.1,1364918,836642,337582,51089,2474,284019,190694,45439,30038,18412,7429,1124,54,6251,4197,792823,537595,176543,143528,33015,78685,2204,76481,16897,11690,5207,35,5172,46921,45988,14788,0
10,1,6,3,23.4,41.1,23.3,12.2,1469758,756781,546978,62812,2485,481681,165999,46389,31683,16314,11791,1354,54,10384,3578,591499,407414,116973,92181,24792,67112,12,67100,16918,11367,5551,679,4872,34963,35842,13773,2
10,1,2,2,18.7,39.4,26.5,15.5,1446640,786098,444959,44260,2662,398037,215583,40076,36097,19615,11103,1104,66,9932,5379,708234,494834,128936,97035,31901,84464,-101,84565,17628,12985,4643,368,4275,40177,38108,19781,0
10,1,5,8,12.5,36.6,33.2,17.7,1952179,1163660,415843,38053,2785,375005,372676,51497,37909,22597,8075,739,54,7282,7237,1492352,1043006,387992,293875,94117,61354,-3445,64799,25911,22742,3169,393,2776,57595,45863,23343,0
10,1,1,1,11.8,35.4,30.5,22.3,2434389,1755308,377721,36704,2803,338214,301360,52647,46240,33341,7175,697,53,6424,5724,2526195,1887201,510342,393207,117135,128652,-159,128811,34461,28357,6104,55,6049,73306,66552,21295,2
10,1,4,5,11.8,26.8,25.2,36.2,1739204,1006846,368296,43392,2829,322075,364062,47634,36512,21137,7732,911,59,6761,7643,1129261,722199,195311,150884,44427,211751,31776,179975,25949,19612,6337,279,6058,43518,36824,29709,8
10,1,1,1,15.8,37.3,30.5,16.4,1695864,1132075,385418,52587,2938,329893,178371,43585,38909,25974,8843,1207,67,7569,4092,1239951,859922,245913,191275,54638,134116,1023,133093,20268,15586,4682,16,4666,61178,55173,28524,3
10,1,2,2,22.4,40.8,24.7,12.2,2236769,1384793,549085,62743,3345,482997,302891,62696,35676,22087,8758,1001,53,7704,4831,887091,567451,151461,114848,36613,168179,10517,157662,23515,16327,7188,719,6469,37724,34755,24372,7
10,1,2,2,24.2,41.7,22,12.1,2348770,1506710,495373,49149,3366,442858,346687,59979,39160,25121,8259,819,56,7384,5780,962990,621753,159023,120631,38392,182214,29599,152615,22448,15079,7369,1004,6365,42899,41233,23977,1
10,1,4,5,20.2,48.9,20.2,10.6,2096470,1215674,503539,59745,3502,440292,377257,52920,39616,22972,9515,1129,66,8320,7129,1819603,1381407,317720,230559,87161,120476,-8724,129200,32648,27076,5572,96,5476,55734,51020,23594,2
10,1,3,2,23.9,39.7,20.1,16.3,4446299,2744872,778019,72768,4802,700449,923408,98363,45203,27906,7910,740,49,7121,9388,2976961,2154721,519798,384370,135428,302442,14225,288217,51312,40324,10988,327,10661,58017,53435,27035,6
10,1,2,2,21.5,43.5,22.3,12.7,2767599,1665602,681768,88043,4875,588850,420229,73833,37485,22559,9234,1192,66,7975,5692,2153218,1626329,357739,255104,102635,169150,-8020,177170,41878,32489,9389,210,9179,51416,50058,19302,8
10,1,4,5,23.5,42.4,20.5,13.5,3288654,1876732,960729,117009,5152,838568,451193,83625,39326,22442,11489,1399,62,10028,5395,1441381,965490,264588,203602,60986,211303,-13157,224460,37052,26585,10467,1102,9365,38902,36317,23968,4
10,1,2,2,11.6,33.9,26.9,27.6,5570826,4210083,749194,70279,5962,672953,611549,119376,46666,35267,6276,589,50,5637,5123,3529353,2649516,616066,444334,171732,263771,-91,263862,61218,47879,13339,203,13136,57652,55338,20087,7
10,1,3,2,21.7,39.6,24.3,14.4,4797848,3099500,935114,103796,6043,825275,763234,113928,42113,27206,8208,911,53,7244,6699,4194738,3168226,658131,453405,204726,368381,5983,362398,73109,59830,13279,142,13137,57376,52954,27586,18
10,1,2,2,11.2,28.7,34.5,25.7,5196629,3313379,1037179,90934,6370,939875,846071,125722,41334,26355,8250,723,51,7476,6730,3152047,2115445,605979,448992,156987,430623,-1248,431871,66782,51998,14784,392,14392,47199,40683,30008,12
10,1,2,2,14.7,40.4,27.5,17.4,5303613,3809680,965471,85723,6595,873153,528462,137564,38554,27694,7018,623,48,6347,3842,1590445,1056577,273991,206132,67859,259877,-136,260013,42046,28341,13705,333,13372,37826,37281,19445,5
10,1,3,2,18,36.2,25.9,19.9,4643079,2805229,1293079,153916,7436,1131727,544771,128735,36067,21791,10045,1196,58,8791,4232,2364586,1613068,456686,356664,100022,294832,2942,291890,60732,45338,15394,894,14500,38935,35579,20130,3
10,1,3,2,15.3,37.1,27.5,20.1,5581124,3084823,1578941,143996,7532,1427413,917360,131993,42283,23371,11962,1091,57,10814,6950,3757732,2478895,660620,496442,164178,618217,11555,606662,76220,62487,13733,690,13043,49301,39671,46512,7
10,1,3,2,14.4,34,27.3,24.3,5859666,3425797,1472508,202641,9287,1260580,961361,156911,37344,21833,9384,1291,59,8034,6127,4174901,2998490,737430,544130,193300,438981,10870,428111,98149,75363,22786,358,22428,42536,39787,19088,12
10,1,3,2,13.9,33.9,30.5,21.7,8673554,5657412,1710427,169751,10315,1530361,1305715,198542,43686,28495,8615,855,52,7708,6577,6638934,4613121,1186544,883907,302637,839269,3938,835331,120570,97663,22907,744,22163,55063,47235,37690,8
10,1,1,1,10.5,25.9,31.1,32.5,13859048,9417066,2065661,136776,11927,1916958,2376321,249320,55587,37771,8285,549,48,7689,9531,7187559,4244952,973840,709058,264782,1968767,1448,1967319,133212,92484,40728,497,40231,53956,45899,48901,44
10,1,2,2,13,28.9,26.2,31.8,11719941,7889246,1694226,171344,12790,1510092,2136469,239665,48901,32918,7069,715,53,6301,8914,10299455,7294923,1504797,1033047,471750,1499735,-2364,1502099,187733,146014,41719,524,41195,54862,49960,36463,58
10,1,2,2,13.5,33.2,29.4,24,11748223,6863009,2456944,325772,15348,2115824,2428270,251577,46698,27280,9766,1295,61,8410,9652,8604314,5450577,1359557,994637,364920,1794180,-134,1794314,164929,124171,40758,484,40274,52170,43896,44553,16
10,1,1,1,14.1,23,26.4,36.5,18525947,10895467,3200527,502801,22567,2675159,4429953,390711,47416,27886,8192,1287,58,6847,11338,15407598,10867898,2504765,1771116,733649,2034935,0,2034935,277143,215652,61491,0,61491,55594,50396,33093,17
10,1,1,1,15.1,31.4,28.3,25.2,20778772,13094649,3786599,375299,24184,3387116,3897524,436888,47561,29973,8667,859,55,7753,8921,14556307,10149474,2135626,1474260,661366,2271207,829,2270378,278790,210406,68384,52,68332,52212,48238,33226,65
10,1,2,2,9.8,27.2,28.6,34.5,20438940,13108357,3616148,456975,24292,3134881,3714435,446496,45776,29358,8099,1023,54,7021,8319,19515945,14378443,3388030,2484170,903860,1749472,1829,1747643,349176,286176,63000,348,62652,55891,50243,27894,65
10,1,8,7,34.4,38.2,21.3,6.1,17820,1290,9638,1919,114,7605,6892,1346,13239,958,7160,1426,85,5650,5120,-2230,6362,1783,1207,576,-10375,-10915,540,426,266,160,71,89,-5235,23917,6067,0
10,1,8,7,24.7,25.3,28.6,21.5,121944,33297,61232,10411,294,50527,27415,4563,26725,7297,13419,2282,64,11073,6008,36968,39255,10327,7264,3063,-12614,-21172,8558,2031,1344,687,115,572,18202,29208,14962,1
10,1,9,10,15.5,37.8,30.6,16.2,257603,135049,87937,9079,359,78499,34617,7720,33368,17493,11391,1176,47,10168,4484,104190,68802,18740,13635,5105,16648,4800,11848,2856,1896,960,160,800,36481,36288,14810,0
10,1,9,10,18.6,35.6,28.5,17.3,251257,134775,83259,9614,381,73264,33223,8367,30030,16108,9951,1149,46,8756,3971,134671,93605,25230,18268,6962,15836,3646,12190,3428,2503,925,207,718,39286,37397,16978,0
10,1,1,1,26.9,35.5,27.3,10.3,228766,119394,84964,10439,390,74135,24408,8161,28032,14630,10411,1279,48,9084,2991,54430,35307,9917,7151,2766,9206,726,8480,2141,1080,1061,259,802,25423,32692,10574,0
10,1,9,8,17.9,34.5,31.2,16.4,343491,182417,109142,10111,448,98583,51932,10202,33669,17881,10698,991,44,9663,5090,57571,42330,11211,7919,3292,4030,-12367,16397,2799,1432,1367,429,938,20568,29560,17481,0
10,1,9,10,14.8,36.1,30.9,18.1,340877,174484,123283,11559,453,111271,43110,9869,34540,17680,12492,1171,46,11275,4368,98403,69300,17372,12023,5349,11731,-3321,15052,3923,2242,1681,306,1375,25084,30910,10947,0
10,1,8,7,30.2,36.5,18.4,14.9,253050,115082,98440,14792,487,83161,39528,9085,27854,12667,10835,1628,54,9154,4351,88711,61425,15801,11135,4666,11485,2074,9411,3317,2070,1247,150,1097,26744,29674,8579,0
10,1,7,9,19.8,33.7,25.6,21,321458,142084,127644,13658,529,113457,51730,10183,31568,13953,12535,1341,52,11142,5080,121500,86768,21900,15261,6639,12832,-3150,15982,4022,2869,1153,290,863,30209,30243,18519,0
10,1,8,5,21.1,38.9,26.7,13.2,378469,200502,132514,13494,542,118478,45453,12546,30167,15981,10562,1076,43,9443,3623,116441,70170,17220,11852,5368,29051,14988,14063,3745,2217,1528,489,1039,31092,31651,13535,0
10,1,8,7,24.1,36.8,30.5,8.7,384553,230163,115592,11732,544,103316,38798,13543,28395,16995,8535,866,40,7629,2865,101916,69447,20157,14977,5180,12312,2322,9990,3474,2286,1188,327,861,29337,30379,11603,0
10,1,3,2,19.3,38.6,31.6,10.6,354535,192531,125149,13165,553,111431,36855,12068,29378,15954,10370,1091,46,9234,3054,146317,107842,22837,15403,7434,15638,-300,15938,3636,2500,1136,258,878,40241,43137,18153,0
10,1,8,7,18.6,37.5,30.1,13.8,408324,218058,146993,13264,557,133172,43273,12672,32223,17208,11600,1047,44,10509,3415,192350,124225,28303,19467,8836,39822,24063,15759,4407,2875,1532,332,1200,43646,43209,13132,0
10,1,7,9,19,37,30,14,426416,215024,156097,17569,561,137967,55295,12462,34217,17254,12526,1410,45,11071,4437,163405,105845,29035,20629,8406,28525,1076,27449,5082,3273,1809,305,1504,32154,32339,18251,0
10,1,8,7,19.8,42.3,26.8,11,522005,315908,152227,14377,576,137274,53870,16077,32469,19650,9469,894,36,8539,3351,234907,117777,29989,21070,8919,87141,64964,22177,5166,3172,1994,548,1446,45472,37130,15337,0
10,1,8,7,24.3,35.8,25,15,318912,152905,129507,18893,584,110030,36500,11640,27398,13136,11126,1623,50,9453,3136,100616,64198,16827,11903,4924,19591,10532,9059,3443,2010,1433,283,1150,29223,31939,7877,0
10,1,9,8,20,33,33.9,13.1,275452,133345,107130,12731,590,93809,34977,10010,27518,13321,10702,1272,59,9372,3494,227597,170528,41055,28602,12453,16014,7678,8336,4253,3212,1041,319,722,53514,53091,11546,0
10,1,9,10,24.6,35.9,28.2,11.2,429275,218777,156009,15403,609,139997,54489,14626,29350,14958,10667,1053,42,9572,3725,170345,112717,29090,20341,8749,28538,4026,24512,5509,3727,1782,507,1275,30921,30243,19225,0
10,1,7,9,31.8,30.1,25.3,12.9,338147,163258,131881,23734,613,107534,43008,10939,30912,14924,12056,2170,56,9830,3932,138504,85913,23291,16647,6644,29300,9011,20289,4890,2872,2018,478,1540,28324,29914,13175,0
10,1,9,10,19.8,45,24.8,10.3,439524,226325,155340,18439,669,136232,57859,14590,30125,15512,10647,1264,46,9337,3966,154680,89321,22768,15990,6778,42591,15510,27081,4938,2930,2008,567,1441,31324,30485,18793,0
10,1,1,1,21.3,29.5,32,17.1,305497,148711,101662,22146,680,78836,55124,10260,29776,14494,9909,2158,66,7684,5373,379293,313638,59179,33846,25333,6476,-8722,15198,10319,9115,1204,94,1110,36757,34409,13692,0
10,1,7,9,29.1,34.6,26.2,10.1,376708,182824,137521,23187,706,113628,56363,14591,25818,12530,9425,1589,48,7788,3863,169160,116355,27525,18178,9347,25280,1601,23679,5035,3596,1439,443,996,33597,32357,23774,0
10,1,8,6,18.3,36.8,28.8,16.1,616210,347208,190598,23171,739,166688,78404,19240,32028,18046,9906,1204,38,8664,4075,302029,183567,47158,33039,14119,71304,42110,29194,8119,5641,2478,408,2070,37200,32542,14103,1
10,1,6,6,17.4,34.9,32.7,15,547696,290557,185353,16322,748,168283,71786,18035,30369,16111,10277,905,41,9331,3980,207293,147614,36972,25883,11089,22707,2608,20099,6468,4453,2015,219,1796,32049,33149,11191,0
10,1,9,8,21.1,34.9,30.8,13.3,559218,316038,182936,16047,770,166119,60244,16023,34901,19724,11417,1001,48,10368,3760,160574,106058,27007,19026,7981,27509,8345,19164,5094,3321,1773,279,1494,31522,31936,12827,0
10,1,9,8,15.9,37.3,32.9,13.9,566829,321229,175952,19586,781,155585,69648,16548,34254,19412,10633,1184,47,9402,4209,243786,152582,38924,27469,11455,52280,28191,24089,6212,4212,2000,369,1631,39244,36226,14769,0
10,1,6,6,21.7,38.3,27.9,12.1,644086,362515,210430,26001,785,183644,71141,22780,28274,15914,9237,1141,34,8062,3123,291340,171745,43645,29410,14235,75950,46730,29220,8001,5710,2291,526,1765,36413,30078,16555,0
10,1,8,6,20.9,40.9,26.7,11.5,588614,308576,205143,14527,833,189783,74895,19467,30237,15851,10538,746,43,9749,3847,285301,205737,51815,35715,16100,27749,319,27430,8034,6301,1733,245,1488,35512,32651,18434,1
10,1,7,9,16.7,29.9,37.1,16.3,708040,382312,231928,21423,880,209625,93800,21479,32964,17799,10798,997,41,9760,4367,314038,205129,54485,38932,15553,54424,30801,23623,8629,6462,2167,478,1689,36393,31744,13986,1
10,1,7,9,25.5,36.5,26.2,11.8,534331,265651,177522,21651,882,154989,91158,17384,30737,15281,10212,1245,51,8916,5244,277506,183650,45198,30486,14712,48658,15878,32780,8279,5804,2475,480,1995,33519,31642,16431,0
10,1,6,6,22.6,30.9,34.1,12.3,588319,311139,198922,23042,883,174997,78258,18671,31510,16664,10654,1234,47,9373,4191,244967,153629,38854,27101,11753,52484,-842,53326,7031,4941,2090,385,1705,34841,31093,31276,1
10,1,7,8,21.2,29,31.7,18.1,701549,355149,246644,29368,907,216369,99756,21448,32709,16559,11500,1369,42,10088,4651,520305,378636,93230,64212,29018,48439,2162,46277,13839,11419,2420,263,2157,37597,33158,21454,2
10,1,7,9,20.9,33.5,29.7,15.9,590717,308589,198822,24515,927,173380,83306,18447,32022,16728,10778,1329,50,9399,4516,267721,180748,42084,28589,13495,44889,20393,24496,7408,5190,2218,431,1787,36139,34826,13708,0
10,1,6,4,22.4,33.7,29.4,14.5,671639,361723,227497,23154,940,203403,82419,21991,30542,16449,10345,1053,43,9249,3748,323809,232297,58876,40499,18377,32636,221,32415,10041,7217,2824,587,2237,32249,32187,14490,1
10,1,7,8,22.3,30.1,34.6,13,746308,417117,239080,17234,946,220900,90111,23518,31733,17736,10166,733,40,9393,3832,329083,239353,57825,39632,18193,31905,3569,28336,8596,6888,1708,386,1322,38283,34749,21434,1
10,1,7,9,24.9,37.4,25,12.6,656917,367212,195368,25901,956,168511,94337,20486,32067,17925,9537,1264,47,8226,4605,336658,191881,46330,32034,14296,98447,46480,51967,7827,5499,2328,407,1921,43012,34894,27052,0
10,1,2,2,20.7,35.2,30.8,13.3,914733,510404,308537,30507,1015,277015,95792,27140,33704,18806,11368,1124,37,10207,3530,376176,226884,55998,38597,17401,93294,48656,44638,10890,7670,3220,494,2726,34543,29581,16375,0
10,1,6,6,20.6,37.1,30.3,11.9,750141,462407,192190,19333,1033,171824,95544,23409,32045,19753,8210,826,44,7340,4082,253729,183468,46401,32513,13888,23860,1748,22112,7996,5618,2378,485,1893,31732,32657,11681,0
10,1,7,9,21.8,32.8,31.4,14.1,988945,556812,290802,33392,1036,256374,141331,29445,33586,18910,9876,1134,35,8707,4800,681985,455887,108769,75700,33069,117329,63969,53360,16261,13096,3165,557,2608,41940,34811,20460,0
10,1,7,9,21.8,33.3,32.6,12.3,729073,387774,244440,22112,1064,221264,96859,25417,28684,15256,9617,870,42,8705,3811,348715,252292,62630,42948,19682,33793,-161,33954,10265,7898,2367,422,1945,33971,31944,17457,0
10,1,6,4,21.7,33.2,30.5,14.7,850168,495083,240105,21748,1083,217274,114980,28265,30078,17516,8495,769,38,7687,4068,597446,434966,97805,65020,32785,64675,4309,60366,14651,10882,3769,587,3182,40779,39971,18971,1
10,1,6,6,24.7,41,23.6,10.7,473662,168344,248390,46138,1161,201091,56928,18325,25848,9187,13555,2518,63,10974,3107,152678,126392,33329,23609,9720,-7043,-29269,22226,6513,4264,2249,447,1802,23442,29642,12334,0
10,1,6,6,22.1,37.4,27.6,12.9,769336,373491,280154,33419,1172,245563,115691,25408,30279,14700,11026,1315,46,9665,4553,448746,311489,69944,46341,23603,67313,24297,43016,12043,8851,3192,449,2743,37262,35193,15682,0
10,1,2,2,23.6,36,26.1,14.3,728634,351562,261144,42577,1208,217359,115928,27411,26582,12826,9527,1553,44,7930,4229,355621,277002,78469,57089,21380,150,-36423,36573,10167,7272,2895,567,2328,34978,38092,15710,0
10,1,7,9,20,32,28.7,19.3,692522,389644,201535,27913,1220,172402,101343,19989,34645,19493,10082,1396,61,8625,5070,352482,210554,47533,31317,16216,94395,58148,36247,8506,6020,2486,339,2147,41439,34976,16883,1
10,1,7,8,24,30.9,30.3,14.9,941011,585945,245577,24428,1254,219895,109489,30834,30519,19003,7964,792,41,7132,3551,606507,445159,102414,65750,36664,58934,-3408,62342,16877,13318,3559,739,2820,35937,33425,22107,0
10,1,2,2,21.5,30.7,34.5,13.3,899136,512054,288982,42921,1299,244762,98100,28812,31207,17772,10030,1490,45,8495,3405,402848,266644,73330,51589,21741,62874,14064,48810,11002,7736,3266,410,2856,36616,34468,17090,0
10,1,6,5,13.4,36.7,34.9,15,1238640,754711,338103,33502,1363,303238,145826,34516,35886,21866,9796,971,39,8785,4225,661127,461031,102216,67940,34276,97880,21867,76013,17435,12892,4543,488,4055,37920,35761,18745,1
10,1,1,1,19.5,31.5,32.9,16.1,920850,554015,261430,27442,1371,232617,105405,28379,32448,19522,9212,967,48,8197,3714,300620,200648,50898,35716,15182,49074,-2078,51152,9866,6189,3677,492,3185,30470,32420,16060,4
10,1,7,8,27.8,29.4,28.3,14.5,710877,307391,283396,53346,1409,228641,120090,26902,26425,11426,10534,1983,52,8499,4464,385236,296405,78964,56355,22609,9867,-29664,39531,11992,9469,2523,294,2229,32124,31303,17735,0
10,1,7,8,19.2,33.5,31.3,15.9,1217167,650463,393689,35015,1453,357221,173015,37250,32676,17462,10569,940,39,9590,4645,714263,526436,121945,82061,39884,65882,1822,64060,19179,15012,4167,429,3738,37242,35068,17138,1
10,1,5,8,20.5,34.8,27.4,17.4,1035488,507413,343260,44640,1477,297143,184815,31400,32977,16160,10932,1422,47,9463,5886,621057,415185,89277,58999,30278,116595,3266,113329,16611,11835,4776,152,4624,37388,35081,24509,1
10,1,7,8,21.6,26.9,34.6,16.9,778783,334657,316021,54842,1524,259655,128105,24481,31812,13670,12909,2240,62,10606,5233,396130,308412,71642,48323,23319,16076,-30160,46236,11644,8976,2668,239,2429,34020,34360,19035,0
10,1,7,8,23.9,24.4,28.8,22.9,1116583,518412,394472,65809,1651,327012,203699,33251,33580,15591,11863,1979,50,9835,6126,589650,448813,112559,77990,34569,28278,-37353,65631,16680,13131,3549,374,3175,35351,34180,20671,2
10,1,1,1,20.6,41.3,25,13.1,1075100,623772,339548,49226,1687,288635,111780,35887,29958,17382,9462,1372,47,8043,3115,404318,279143,60609,39672,20937,64566,-4972,69538,12348,7352,4996,488,4508,32744,37968,15425,0
10,1,6,5,19.3,34.6,30.1,15.9,1196944,604355,418961,58259,1713,358989,173628,39862,30027,15161,10510,1462,43,9006,4356,727344,509236,126396,88125,38271,91712,5588,86124,21350,15837,5513,427,5086,34068,32155,16934,0
10,1,5,8,21.8,35.5,24.8,17.9,964020,421074,344529,61379,1804,281346,198417,30194,31928,13946,11411,2033,60,9318,6571,673535,522825,134678,94217,40461,16032,-41735,57767,18706,15685,3021,263,2758,36006,33333,20945,2
10,1,7,9,20.1,35.5,27.9,16.5,1150489,621632,357666,35127,1870,320669,171191,35830,32110,17349,9982,980,52,8950,4778,592310,418455,104089,70545,33544,69766,958,68808,14055,10747,3308,611,2697,42142,38937,25513,1
10,1,6,4,22.2,38.2,25.2,14.4,1057842,587309,335516,50066,1878,283572,135017,34153,30974,17196,9824,1466,55,8303,3953,606368,422425,99985,67720,32265,83958,1882,82076,16833,11970,4863,613,4250,36023,35290,19312,0
10,1,2,2,15.3,27.6,36.2,20.9,1522443,796508,396056,37322,1886,356848,329879,46255,32914,17220,8562,807,41,7715,7132,974056,748154,195261,134917,60344,30641,-499,31140,20157,15250,4907,209,4698,48323,49059,6628,3
10,1,3,2,9.4,23.6,31.1,35.9,2293018,1550381,385692,40209,2170,343313,356945,60827,37697,25488,6341,661,36,5644,5868,1048512,628098,136797,89383,47414,283617,9449,274168,29856,20374,9482,349,9133,35119,30828,30019,0
10,1,4,3,10.5,18.9,28.8,41.9,1966595,1136487,372291,26142,2184,343965,457817,52654,37349,21584,7071,496,41,6533,8695,1330561,925554,227412,159813,67599,177595,-223,177818,31996,24579,7417,377,7040,41585,37656,25258,6
10,1,6,3,15.8,30,39.2,15,1886275,1095902,546482,51147,2230,493105,243891,54941,34333,19947,9947,931,41,8975,4439,575135,381718,95563,67436,28127,97854,4913,92941,17840,11384,6456,667,5789,32239,33531,16055,7
10,1,5,8,11.9,21.1,24.4,42.6,1548104,904233,336117,41616,2247,292254,307754,49480,31287,18275,6793,841,45,5907,6220,1093327,790366,218068,159490,58578,84893,687,84206,28775,23546,5229,333,4896,37996,33567,17199,8
10,1,4,5,12.8,32.2,32.1,22.9,1730681,995801,446614,61268,2368,382978,288266,47510,36428,20960,9400,1290,50,8061,6067,1236126,928211,246018,172281,73737,61897,332,61565,26838,21916,4922,187,4735,46059,42353,13002,2
10,1,4,5,17.8,31.1,32.6,18.4,2507348,1394575,745566,68849,2513,674204,367207,68366,36675,20399,10906,1007,37,9862,5371,1754997,1231830,306534,217636,88898,216633,50307,166326,38118,30611,7507,776,6731,46041,40241,24710,2
10,1,5,8,15.3,30.7,30.4,23.6,2111934,1187535,536777,66818,2833,467126,387622,59574,35451,19934,9010,1122,48,7841,6507,1583592,1187331,291398,197901,93497,104863,-6291,111154,34737,28122,6615,342,6273,45588,42221,17719,3
10,1,5,8,21.2,30.6,29.2,19,1632091,841506,543846,106441,3037,434368,246739,47952,34036,17549,11341,2220,63,9058,5146,924446,661024,159294,108491,50803,104128,-33949,138077,24145,19140,5005,239,4766,38287,34536,28971,4
10,1,3,2,13.3,27.6,32.3,26.7,2755630,1493700,708531,76432,3324,628775,553399,75643,36429,19747,9367,1010,44,8312,7316,2408598,1717663,419924,292111,127813,271011,504,270507,51599,43254,8345,302,8043,46679,39711,33633,9
10,1,5,8,13.8,30.7,35.4,20.1,2763431,1515938,741940,87737,3655,650548,505553,78275,35304,19367,9479,1121,47,8311,6459,1927538,1389995,339690,230261,109429,197853,2313,195540,45704,37472,8232,303,7929,42174,37094,24661,3
10,1,5,8,16.8,25.9,33.9,23.5,3180648,1987731,709725,75212,3758,630755,483192,84730,37539,23460,8376,888,44,7444,5703,2897085,2171478,462058,296650,165408,263549,537,263012,66094,55883,10211,434,9777,43833,38858,26901,8
10,1,2,2,10.3,26.2,34.3,29.2,6371093,4304280,1155868,81553,4721,1069594,910945,149374,42652,28815,7738,546,32,7161,6098,3977298,2742969,588214,385462,202752,646115,28412,617703,88263,68202,20061,560,19501,45062,40218,31675,9
10,1,1,1,10.6,29.5,36.4,23.5,6409023,4639138,1074954,101838,6515,966601,694931,173084,37028,26803,6211,588,38,5585,4015,2894399,2082062,441323,283306,158017,371014,1495,369519,80488,59584,20904,371,20533,35961,34943,17996,22
10,1,2,2,12.2,31.6,35.6,20.7,5003862,3028811,1140012,111632,6557,1021823,835039,141236,35429,21445,8072,790,46,7235,5912,3612077,2656668,714742,511629,203113,240667,-7665,248332,67598,53916,13682,341,13341,53435,49274,18614,2
10,1,2,2,13,29.2,35.6,22.2,7116900,3923760,1712077,194068,8067,1509942,1481063,200521,35492,19568,8538,968,40,7530,7386,5291341,3854249,996526,688380,308146,440566,-512,441078,120405,97200,23205,267,22938,43946,39653,19229,9
10,1,2,2,13.7,25.1,32.5,28.6,9295616,5211990,2178385,345756,10481,1822148,1905241,243665,38149,21390,8940,1419,43,7478,7819,8501873,6064226,1454920,1005889,449031,982727,5390,977337,170893,135730,35163,853,34310,49750,44679,28485,4
0,0,9,12,25.3,49,20.9,4.9,93830,83026,5694,577,464,4653,5110,2787,33667,29790,2043,207,166,1670,1834,98232,59942,20144,14283,5861,18146,0,18146,2248,1829,419,0,419,43698,32773,43308,0
0,0,8,7,8.3,30.4,38.6,22.7,84382,55994,18698,1239,495,16964,9690,1834,46010,30531,10195,676,270,9250,5284,109053,79698,21304,13988,7316,8051,0,8051,2334,2044,290,0,290,46724,38991,27762,0
0,0,9,10,11.1,31.1,34,23.8,78294,47187,15978,1393,584,14001,15129,2280,34339,20696,7008,611,256,6141,6636,50681,29474,10241,7634,2607,10966,0,10966,1642,1029,613,0,613,30865,28643,17889,0
0,0,9,12,23.4,33.9,26.3,16.4,154657,110656,25556,4522,993,20041,18445,4841,31947,22858,5279,934,205,4140,3810,126794,85928,29772,22970,6802,11094,0,11094,3502,2552,950,0,950,36206,33671,11678,0
0,0,7,11,9.4,25.3,35.8,29.5,345455,240021,44697,3368,1270,40059,60737,8994,38409,26687,4970,374,141,4454,6753,272775,168325,55541,42433,13108,48909,0,48909,6497,4677,1820,0,1820,41985,35990,26873,0
0,0,7,11,14.2,36.5,33.1,16.3,237456,152560,42369,3030,1323,38016,42527,6233,38097,24476,6798,486,212,6099,6823,169677,87076,32493,25710,6783,50108,0,50108,4314,2643,1671,0,1671,39332,32946,29987,0
0,0,7,11,22.6,35.1,25.4,17,292881,222878,33371,4659,1459,27253,36632,8190,35761,27213,4075,569,178,3328,4473,815749,671482,135971,88745,47226,8296,0,8296,9498,9235,263,0,263,85886,72711,31544,0
0,0,8,7,13.2,35.1,33.5,18.2,222264,153980,39294,4966,1594,32734,28990,6530,34037,23580,6017,760,244,5013,4440,181683,132726,35079,24660,10419,13878,0,13878,3552,2710,842,0,842,51149,48976,16482,0
0,0,8,7,25.7,39.4,20.7,14.2,177185,93415,57212,9115,1710,46387,26558,6000,29531,15569,9535,1519,285,7731,4426,110763,75480,33443,29065,4378,1840,0,1840,2736,2242,494,0,494,40484,33666,3725,2
0,0,7,8,14.6,31.3,35.3,18.7,492218,356850,59854,6310,2196,51348,75514,13105,37560,27230,4567,481,168,3918,5762,420864,254332,84947,63614,21333,81585,0,81585,8801,6545,2256,0,2256,47820,38859,36164,0
0,0,9,11,11.5,29.9,37.4,21.2,382678,279047,47379,4364,2208,40807,56252,9914,38600,28147,4779,440,223,4116,5674,331325,223996,69817,53026,16791,37512,0,37512,6861,4982,1879,0,1879,48291,44961,19964,1
0,0,7,11,25.2,38.1,22,14.7,281075,180801,72975,12048,2211,58716,27299,9338,30100,19362,7815,1290,237,6288,2923,198775,133688,52762,43445,9317,12325,0,12325,4528,3858,670,0,670,43899,34652,18396,1
0,0,7,8,10.4,29.7,39.8,20.2,584490,405379,80605,8276,2408,69921,98506,13298,43953,30484,6061,622,181,5258,7408,454150,278288,92155,70716,21439,83707,0,83707,9770,7461,2309,0,2309,46484,37299,36252,1
0,0,7,11,29,38.6,19.3,13.1,469315,305687,123402,23539,4032,95831,40226,16728,28056,18274,7377,1407,241,5729,2405,346113,235377,92620,75976,16644,18116,0,18116,8648,7224,1424,0,1424,40022,32583,12722,0
0,0,5,8,6.8,22,35.2,36,1362620,994658,133886,13310,4383,116193,234076,31003,43951,32083,4318,429,141,3748,7550,1109264,737762,263854,213918,49936,107648,-4835,112483,22422,18208,4214,15,4199,49472,40519,26788,0
0,0,7,11,11.5,31.8,36.4,20.3,1725295,1157069,283882,26302,9858,247722,284344,51590,33442,22428,5503,510,191,4802,5512,1127743,713767,226604,173479,53125,187372,705,186667,29140,18909,10231,99,10132,38701,37747,18424,2
0,0,3,2,8.2,25.5,39.3,27,3317349,2333788,423342,40012,12142,371188,560219,90431,36684,25807,4681,442,134,4105,6195,2697293,1928394,631032,477163,153869,137867,5094,132773,55121,45952,9169,174,8995,48934,41965,14761,2
0,0,2,2,11.9,31.3,38.6,18.3,2404906,1787232,314730,34449,12470,267811,302944,74409,32320,24019,4230,463,168,3599,4071,1037797,621543,195930,145940,49990,220324,6661,213663,28615,18752,9863,227,9636,36268,33145,22173,2
0,0,2,2,9.7,24.2,37.2,28.9,12242781,8892658,1378901,147602,37071,1194228,1971222,276494,44279,32162,4987,534,134,4319,7129,10690545,7197869,2050914,1473581,577333,1441762,0,1441762,192116,159538,32578,0,32578,55646,45117,44256,23
0,0,8,7,34.3,38.3,19.3,8,273725,169701,70959,7943,612,62404,33065,11467,23871,14799,6188,693,53,5442,2883,86906,57217,15980,11400,4580,13709,3009,10700,2823,2001,822,179,643,30785,28594,16641,0
0,0,8,4,37.1,35.8,17.8,9.2,352641,234886,79459,6977,660,71822,38296,14368,24543,16348,5530,486,46,4999,2665,162265,87453,23978,17410,6568,50834,27178,23656,4574,3062,1512,298,1214,35476,28561,19486,0
0,0,9,10,34,37.8,20.4,7.8,365469,229611,90244,7962,718,81564,45614,14077,25962,16311,6411,566,51,5794,3240,204852,128989,34945,24886,10059,40918,25274,15644,6383,4940,1443,359,1084,32093,26111,14432,0
0,0,8,6,39.9,29,19.9,11.2,372764,241203,89561,10304,758,78499,42000,13699,27211,17607,6538,752,55,5730,3066,204280,91805,26348,19373,6975,86127,69185,16942,5289,3669,1620,506,1114,38624,25022,15208,0
0,0,3,2,33.3,29.1,23.5,14.1,439910,280575,99830,11847,803,87180,59505,16752,26260,16749,5959,707,48,5204,3552,219840,144390,36568,25287,11281,38882,16410,22472,6651,5025,1626,338,1288,33054,28734,17447,0
0,0,9,11,32.3,38.1,20.3,9.2,307208,169194,99808,14673,805,84330,38206,13421,22890,12607,7437,1093,60,6283,2847,187754,132790,35845,25733,10112,19119,6021,13098,6082,4622,1460,318,1142,30870,28730,11469,1
0,0,6,6,33.9,35,21.9,9.2,398807,228866,114366,11884,867,101615,55575,18030,22119,12694,6343,659,48,5636,3082,194122,135132,41675,31223,10452,17315,3047,14268,6842,5603,1239,319,920,28372,24118,15509,0
0,0,6,6,39.5,35.2,17.5,7.7,203463,110410,63207,11394,882,50931,29846,11011,18478,10027,5740,1035,80,4625,2711,125967,82224,24271,17980,6291,19472,9566,9906,4065,3410,655,219,436,30988,24113,22720,1
0,0,2,2,35.7,33.4,19.9,11,301603,190453,77158,17161,986,59011,33992,12397,24329,15363,6224,1384,80,4760,2742,171649,107200,30751,22335,8416,33698,19896,13802,4705,3499,1206,336,870,36482,30637,15864,0
0,0,3,2,34.4,32,25,8.7,658259,405616,167406,16668,1115,149623,85237,25988,25329,15608,6442,641,43,5757,3280,263634,148154,44313,33144,11169,71167,42996,28171,9733,6617,3116,865,2251,27087,22390,12515,0
0,0,8,6,36.5,34.9,18.9,9.7,582650,357320,143364,14060,1287,128017,81966,25031,23277,14275,5727,562,51,5114,3275,219328,145123,40622,29699,10923,33583,6510,27073,7838,5627,2211,501,1710,27983,25790,15832,0
0,0,6,5,30,25,26.3,18.8,467546,263981,131534,25006,1308,105220,72031,22388,20884,11791,5875,1117,58,4700,3217,269769,185402,62033,48112,13921,22334,5964,16370,8744,6850,1894,308,1586,30852,27066,10322,1
0,0,6,6,32.2,34.5,22.9,10.4,510244,296464,143873,18523,1477,123873,69907,20830,24496,14233,6907,889,71,5947,3356,276782,185405,50338,35936,14402,41039,12172,28867,9523,7410,2113,384,1729,29065,25021,16696,0
0,0,6,5,30.9,30,20.6,18.4,842621,520347,186553,24544,1528,160481,135721,30772,27383,16910,6062,798,50,5215,4411,607150,399390,109373,78896,30477,98387,44038,54349,17950,14690,3260,549,2711,33825,27188,20048,2
0,0,6,4,38.1,32,19.9,10,539941,330888,136751,14976,1533,120242,72302,22658,23830,14604,6035,661,68,5307,3191,249776,154442,42374,29891,12483,52960,25861,27099,8544,6242,2302,507,1795,29234,24742,15097,0
0,0,6,6,35.3,32.4,21.3,10.9,668851,407303,156982,25518,1546,129918,104566,28027,23865,14533,5601,910,55,4635,3731,471674,310902,87366,63522,23844,73406,35818,37588,14363,12006,2357,475,1882,32840,25896,19972,0
0,0,6,5,26.8,26.2,27.6,19.3,1357326,838573,251637,23225,1992,226420,267116,45604,29763,18388,5518,509,44,4965,5857,628404,405794,108243,77624,30619,114367,51997,62370,20570,15956,4614,758,3856,30550,25432,16175,2
0,0,6,6,31.5,34.7,23.2,10.6,855000,484203,218936,27855,2014,189067,151861,37601,22739,12877,5823,741,54,5028,4039,558263,393397,106735,77639,29096,58131,16961,41170,16968,13833,3135,393,2742,32901,28439,15015,2
0,0,6,6,29.9,32.9,23,14.1,1105929,640322,269039,27355,2075,239609,196568,40857,27068,15672,6585,670,51,5865,4811,559105,394933,102111,71157,30954,62061,2710,59351,19702,16200,3502,316,3186,28378,24379,18629,0
0,0,7,9,31.6,33,23.2,12.2,923271,530513,254126,23717,2118,228291,138632,37204,24816,14260,6831,637,57,6136,3726,564461,377729,98851,70817,28034,87881,32840,55041,18431,14581,3850,877,2973,30626,25906,18514,0
0,0,6,6,37.9,30.5,21.9,9.7,772628,490917,186938,18080,2128,166730,94773,30968,24949,15852,6036,584,69,5384,3060,469923,292801,84739,61976,22763,92383,46121,46262,15253,11832,3421,780,2641,30809,24747,17517,0
0,0,1,1,33.8,35.8,20.5,9.9,1030158,702364,212978,22468,2144,188366,114816,41946,24559,16744,5077,536,51,4491,2737,403479,257016,68422,49257,19165,78041,7935,70106,13146,9789,3357,537,2820,30692,26256,24860,2
0,0,4,5,22.2,29.2,34.6,14,1396673,906249,264148,32168,2222,229758,226276,49050,28474,18476,5385,656,45,4684,4613,1422017,937196,303123,227443,75680,181698,27092,154606,26842,23366,3476,410,3066,52977,40109,50426,1
0,0,2,2,21.3,33.8,26.9,18,1428996,991111,225497,26934,2259,196304,212388,49676,28766,19952,4539,542,45,3952,4275,519013,346796,87768,61988,25780,84449,16614,67835,17404,12524,4880,324,4556,29821,27691,14889,1
0,0,1,1,29.6,36,24.8,9.6,1331674,921153,260864,22715,2347,235802,149657,54624,24379,16864,4776,416,43,4317,2740,446783,258836,68489,48965,19524,119458,33475,85983,15068,10120,4948,1122,3826,29651,25577,22473,0
0,0,3,2,34.4,39.4,18.7,7.5,831109,569960,183511,19252,2479,161780,77638,34435,24136,16552,5329,559,72,4698,2255,356826,230045,57230,40739,16491,69551,30968,38583,11142,7035,4107,1332,2775,32025,32700,13904,0
0,0,6,5,35.8,32.1,22.5,9.5,857194,532839,217385,27317,2621,187447,106970,35279,24298,15104,6162,774,74,5313,3032,451380,331348,83741,57354,26387,36291,4122,32169,14564,11954,2610,263,2347,30993,27719,13706,0
0,0,2,2,33.5,33,23.8,9.7,1219001,766107,288849,41423,3164,244262,164045,49731,24512,15405,5808,833,64,4912,3299,553016,396447,100854,72025,28829,55715,6865,48850,17069,13899,3170,225,2945,32399,28523,16587,1
0,0,2,2,22.4,33.8,27.2,16.6,2097692,1443425,351880,38101,3188,310591,302387,72978,28744,19779,4822,522,44,4256,4144,758480,496963,129278,91158,38120,132239,5390,126849,25684,17468,8216,520,7696,29531,28450,16482,4
0,0,1,1,28.7,34.6,25.6,11.1,1972841,1382036,351081,32108,3295,315678,239724,72596,27176,19037,4836,442,45,4348,3302,723161,467567,120669,85093,35576,134925,18540,116385,24218,17203,7015,522,6493,29860,27179,17925,1
0,0,1,1,32.8,34.7,23.3,9.1,1932848,1102180,490145,39749,3358,447038,340523,68500,28217,16090,7155,580,49,6526,4971,821487,553264,145234,104142,41092,122989,19592,103397,25669,20323,5346,491,4855,32003,27224,21297,0
0,0,4,5,29.7,33.6,22.9,13.9,1078746,577524,323144,61896,3412,257836,178078,44434,24277,12997,7272,1393,77,5803,4008,690476,491559,130219,92224,37995,68698,21604,47094,20797,17414,3383,427,2956,33201,28228,15932,1
0,0,6,5,33,34.9,21.7,10.4,1406672,909019,297261,27637,3536,266088,200392,53332,26376,17045,5574,518,66,4989,3757,808665,534090,144838,102665,42173,129737,51254,78483,25202,18747,6455,1219,5236,32087,28489,14989,1
0,0,6,6,36.2,34,21.5,8.3,1606262,1043610,368250,37872,3890,326488,194402,67794,23693,15394,5432,559,57,4816,2868,1016990,687786,175342,121457,53885,153862,70981,82881,33581,25340,8241,1942,6299,30285,27142,13158,1
0,0,2,2,25.5,32.5,25.1,16.9,1953325,1346438,324559,30668,3945,289946,282328,71303,27395,18883,4552,430,55,4066,3960,1300591,943854,234040,163344,70696,122697,33458,89239,32090,24567,7523,1081,6442,40529,38420,13853,15
0,0,4,5,30.6,30.5,25,13.9,2299551,1462327,480328,46025,4093,430210,356896,86516,26579,16902,5552,532,47,4973,4125,1532999,1039224,277727,198402,79325,216048,44229,171819,50941,39673,11268,1424,9844,30094,26195,17454,5
0,0,3,2,23.5,30.4,27.7,18.4,2963681,1902707,515707,61958,4367,449382,545267,93903,31561,20262,5492,660,47,4786,5807,2265990,1648255,401678,280246,121432,216057,20145,195912,62471,52717,9754,642,9112,36273,31266,21500,4
0,0,4,5,30.3,34.4,24,11.2,2067005,1333754,482130,58298,4740,419092,251121,81546,25348,16356,5912,715,58,5139,3080,1517876,1133314,286403,204123,82280,98159,24998,73161,38341,33100,5241,502,4739,39589,34239,15438,1
0,0,3,2,25.9,32.3,28.4,13.4,2680162,1627499,671239,60390,5554,605295,381424,103174,25977,15774,6506,585,54,5867,3697,1601571,1139146,284383,197351,87032,178042,11164,166878,50115,40177,9938,829,9109,31958,28353,18320,3
0,0,3,2,18.6,26.7,26.8,27.9,3241980,2196964,448474,56510,6016,385948,596542,126133,25703,17418,3556,448,48,3060,4729,2064747,1491002,409407,297808,111599,164338,-991,165329,63934,52441,11493,282,11211,32295,28432,14747,18
0,0,3,2,26.1,32.2,26.4,15.2,3141469,1864481,699108,68810,6138,624160,577880,114477,27442,16287,6107,601,54,5452,5048,2267243,1644653,456062,333065,122997,166528,12324,154204,63108,53171,9937,585,9352,35926,30931,16489,6
0,0,3,2,23.7,30.3,27.6,18.4,3349234,2208763,581193,50476,6357,524360,559278,113964,29389,19381,5100,443,56,4601,4907,2360190,1720032,433558,304945,128613,206600,34367,172233,63805,51806,11999,1165,10834,36991,33201,15897,5
0,0,1,1,13.2,23,27.1,36.8,7007234,5326827,582649,38598,7160,536891,1097758,171691,40813,31026,3394,225,42,3127,6394,3975665,2893097,623411,418303,205108,459157,4893,454264,94978,74666,20312,382,19930,41859,38747,22793,35
0,0,2,2,19.7,24.3,27.4,28.5,7586340,4656772,1197971,198749,11975,987247,1731597,223608,33927,20826,5357,889,54,4415,7744,7148048,5286320,1371801,976647,395154,489927,52727,437200,175066,150183,24883,527,24356,40831,35199,17950,9
0,0,2,2,14.6,21.9,29.2,34.3,10713604,7328934,1248962,112191,15291,1121480,2135708,301474,35537,24310,4143,372,51,3720,7084,10012693,7685959,1828058,1257491,570567,498676,19019,479657,212599,181313,31286,946,30340,47097,42391,15809,100
0,0,9,10,32,40.6,19,8.4,163644,84990,56306,5018,656,50632,22348,8110,20178,10480,6943,619,81,6243,2756,77710,39010,11367,8403,2964,27333,2021,25312,3820,1889,1931,558,1373,20343,20651,18436,0
0,0,9,8,29.8,37.8,20.6,11.8,163961,92335,50787,5857,685,44245,20839,8467,19365,10905,5998,692,81,5226,2461,57025,26968,8488,6445,2043,21569,6797,14772,2985,1363,1622,568,1054,19104,19786,14015,0
0,0,9,8,31.3,43.5,17.9,7.3,128532,84417,32173,3456,689,28028,11942,5675,22649,14875,5669,609,121,4939,2104,166150,128126,31978,22025,9953,6046,1111,4935,3992,3610,382,97,285,41621,35492,17316,1
0,0,6,6,34.6,37.2,19.8,8.4,235146,143948,64499,7466,792,56241,26699,10976,21424,13115,5876,680,72,5124,2432,138028,72622,19398,13929,5469,46008,29305,16703,4764,3134,1630,579,1051,28973,23172,15892,0
0,0,8,7,34.7,36,19.8,9.5,193271,115652,54083,7097,908,46078,23536,8042,24033,14381,6725,882,113,5730,2927,96428,44966,11684,8017,3667,39778,31322,8456,2548,1813,735,263,472,37845,24802,17915,0
0,0,9,10,31.2,39.2,19.6,10.1,262312,166773,62082,5600,926,55556,33457,11216,23387,14869,5535,499,83,4953,2983,145564,79372,20913,14533,6380,45279,25941,19338,4676,3266,1410,371,1039,31130,24303,18612,0
0,0,7,8,30.9,39.2,19.1,10.7,229616,135676,68193,6886,941,60366,25747,9479,24224,14313,7194,726,99,6368,2716,124271,79985,19818,13617,6201,24468,14137,10331,3970,2933,1037,355,682,31303,27271,15148,0
0,0,2,2,26.2,41.4,21.3,11.1,254227,169097,59930,5679,960,53291,25200,10356,24549,16328,5787,548,93,5146,2433,73275,33114,9111,6567,2544,31050,11452,19598,2957,1409,1548,383,1165,24780,23502,16822,0
0,0,9,9,27.8,39,22.7,10.5,225261,115382,79319,6674,1014,71631,30560,12127,18575,9514,6541,550,84,5907,2520,84951,45391,13577,10072,3505,25983,10881,15102,3901,2123,1778,679,1099,21777,21381,13742,0
0,0,6,6,33.2,41.1,16.1,9.6,198997,111807,64302,6916,1044,56342,22888,8589,23169,13017,7487,805,122,6560,2665,127883,96881,24080,16127,7953,6922,1326,5596,4217,3570,647,102,545,30326,27138,10268,0
0,0,2,2,32.2,38.9,18.9,10.1,358554,247971,70813,7539,1074,62200,39770,14714,24368,16853,4813,512,73,4227,2703,176641,88807,23624,16830,6794,64210,37820,26390,6357,3618,2739,1178,1561,27787,24546,16906,0
0,0,9,9,32,38.5,19.8,9.8,245801,118279,85434,7355,1094,76985,42088,11909,20640,9932,7174,618,92,6464,3534,123193,68442,18416,13075,5341,36335,12234,24101,5131,3072,2059,553,1506,24010,22279,16003,0
0,0,8,7,30.2,39.2,21.8,8.8,196281,110805,57565,4832,1131,51602,27911,9358,20975,11841,6151,516,121,5514,2983,86783,44825,12497,8869,3628,29461,16028,13433,3269,2035,1234,390,844,26547,22027,15916,1
0,0,6,6,26.6,38.2,25.4,9.9,311655,195903,80530,7685,1194,71651,35222,13114,23765,14938,6141,586,91,5464,2686,230261,166804,37569,25666,11903,25888,10840,15048,5872,4452,1420,412,1008,39213,37467,14929,1
0,0,9,10,26.7,36.5,25.1,11.7,287243,147997,97971,7336,1236,89399,41275,13524,21240,10943,7244,542,91,6610,3052,135334,78662,21798,15791,6007,34874,11667,23207,5632,3308,2324,615,1709,24029,23779,13579,0
0,0,7,11,35.4,33.8,21.6,9.2,366448,248409,84285,9786,1260,73239,33754,16298,22484,15242,5171,600,77,4494,2071,255678,163227,43441,30079,13362,49010,34039,14971,7616,6379,1237,540,697,33571,25588,21479,0
0,0,9,10,24,38.3,27.3,10.4,344317,174043,109132,9114,1285,98733,61142,16464,20913,10571,6629,554,78,5997,3714,158409,102660,31328,23118,8210,24421,5959,18462,6525,4347,2178,439,1739,24277,23616,10616,0
0,0,7,9,29.3,37.9,21.2,11.6,350786,235664,79292,8188,1326,69778,35830,14025,25011,16803,5654,584,95,4975,2555,346284,220365,57284,39538,17746,68635,48761,19874,9792,8232,1560,547,1013,35364,26769,19619,0
0,0,8,7,31.8,38.8,20.4,9,207742,126961,57386,5007,1329,51050,23395,9046,22965,14035,6344,554,147,5643,2586,93607,48866,11839,8136,3703,32902,21136,11766,3091,2002,1089,403,686,30284,24409,17152,0
0,0,2,2,28.9,35.4,24.7,11,426523,266334,102157,9434,1384,91339,58032,18073,23600,14737,5652,522,77,5054,3211,232937,137663,40579,30222,10357,54695,34776,19919,7113,5030,2083,706,1377,32748,27368,14466,1
0,0,8,7,28.4,36.8,23.3,11.5,358078,174988,124223,9151,1598,113474,58867,16869,21227,10373,7364,542,95,6727,3490,158177,97427,25751,18326,7425,34999,5793,29206,6208,4082,2126,528,1598,25480,23867,18277,0
0,0,6,6,33.4,36.8,17.9,11.9,281990,161485,86994,8755,1603,76636,33511,12012,23476,13444,7242,729,133,6380,2790,181845,113397,29050,20069,8981,39398,12330,27068,5493,4373,1120,195,925,33105,25931,29263,0
0,0,2,2,22.8,42.3,23.9,11,456166,324588,82078,7080,1620,73378,49500,17244,26454,18823,4760,411,94,4255,2871,161275,106291,26923,18806,8117,28061,3294,24767,5505,3891,1614,244,1370,29296,27317,18078,0
0,0,7,11,27.4,36.2,25.4,10.9,423422,237591,127199,12053,1670,113476,58632,20203,20958,11760,6296,597,83,5617,2902,260557,158039,44932,32466,12466,57586,27354,30232,9981,6857,3124,855,2269,26105,23048,13324,1
0,0,6,5,35.9,35.7,17.5,10.9,497917,321152,121127,11430,1700,107997,55638,21141,23552,15191,5729,541,80,5108,2632,297850,186712,48879,34650,14229,62259,33409,28850,10307,7703,2604,828,1776,28898,24239,16244,0
0,0,6,4,43.8,29.6,19.3,7.3,212528,114951,69576,13438,1706,54432,28001,11370,18692,10110,6119,1182,150,4787,2463,110705,63044,16918,12177,4741,30743,18726,12017,3245,2441,804,218,586,34116,25827,20507,0
0,0,7,9,27.1,38.3,24.3,10.3,383607,182818,143619,11836,1730,130053,57170,17391,22058,10512,8258,681,99,7478,3287,160681,95750,25335,17763,7572,39596,13491,26105,7218,4374,2844,636,2208,22261,21891,11823,0
0,0,7,9,35.8,35.3,17.3,11.7,288998,161797,92192,15350,1822,75020,35009,12729,22704,12711,7243,1206,143,5894,2750,170988,100282,25086,17277,7809,45620,32321,13299,5195,4106,1089,296,793,32914,24423,16770,0
0,0,6,6,30.2,38.4,22,9.4,526181,313722,150870,13670,1862,135338,61589,22661,23220,13844,6658,603,82,5972,2718,270345,159321,43270,30963,12307,67754,36402,31352,8932,6325,2607,856,1751,30267,25189,17905,1
0,0,6,6,26.8,41.4,20.2,11.5,529449,336053,134679,12865,1875,119939,58717,20683,25598,16248,6512,622,91,5799,2839,306560,189735,48230,33052,15178,68595,33358,35237,9903,7216,2687,799,1888,30956,26294,18664,1
0,0,6,6,32.4,36.7,17.8,13.1,508819,320571,129896,14481,2002,113413,58352,24173,21049,13262,5374,599,83,4692,2414,345633,225935,59743,42193,17550,59955,30791,29164,11457,8992,2465,580,1885,30168,25126,15472,0
0,0,6,6,36.7,36.7,18,8.5,369611,206163,117036,11362,2097,103577,46412,17343,21312,11887,6748,655,121,5972,2676,202806,118731,31872,22328,9544,52203,21868,30335,7258,4854,2404,519,1885,27942,24460,16093,0
0,0,6,6,25.2,36.4,24.5,13.9,622299,341132,171329,10636,2120,158573,109838,25274,24622,13497,6779,421,84,6274,4346,301735,183563,51274,36477,14797,66898,15032,51866,11712,7467,4245,776,3469,25763,24583,14951,0
0,0,6,6,28.2,34,23.9,13.8,597457,368879,132183,11308,2281,118594,96395,26435,22601,13954,5000,428,86,4486,3646,402310,242064,61531,42566,18965,98715,62818,35897,14634,10362,4272,994,3278,27491,23361,10951,4
0,0,6,5,30.8,38.3,19.9,11,508516,322561,126761,17181,2357,107223,59194,22924,22183,14071,5530,749,103,4677,2582,365774,240597,61668,43024,18644,63509,39924,23585,11270,9016,2254,763,1491,32456,26686,15818,0
0,0,6,4,31.7,38.2,20.3,9.9,438782,273270,111955,14290,2404,95261,53557,18883,23237,14472,5929,757,127,5045,2836,232496,152939,38706,26687,12019,40851,12616,28235,7755,5742,2013,297,1716,29980,26635,16454,0
0,0,6,6,34,38.3,17.4,10.3,405091,232568,124661,13264,2466,108931,47862,18269,22174,12730,6824,726,135,5963,2620,278450,173908,43705,30263,13442,60837,19308,41529,7831,6286,1545,338,1207,35557,27666,34407,1
0,0,7,8,24.7,32.4,23.1,19.8,531869,320444,136497,11798,2556,122143,74928,22800,23328,14055,5987,517,112,5357,3286,390118,275828,73459,51489,21970,40831,8444,32387,13184,10859,2325,367,1958,29590,25401,16541,6
0,0,7,11,30.8,38.4,20.3,10.6,394270,224230,122016,11611,2613,107792,48024,18086,21800,12398,6746,642,144,5960,2655,214975,132943,37230,26046,11184,44802,13237,31565,8171,5699,2472,672,1800,26310,23327,17536,0
0,0,7,8,25.9,35.8,21.5,16.8,634746,383793,157446,20012,2635,134799,93507,25025,25364,15336,6292,800,105,5387,3737,447216,308824,78668,55358,23310,59724,9878,49846,12665,10536,2129,284,1845,35311,29311,27017,3
0,0,7,11,26.9,34.3,21.5,17.3,479081,304469,112012,13330,2750,95932,62600,18618,25732,16353,6016,716,148,5153,3362,298990,187282,51309,36570,14739,60399,16856,43543,9171,7464,1707,290,1417,32602,25091,30729,0
0,0,3,2,38,39.5,16.2,6.3,607069,388395,161549,20877,2864,137808,57125,25058,24227,15500,6447,833,114,5500,2280,350400,184692,47554,32731,14823,118154,39251,78903,9581,7082,2499,341,2158,36572,26079,36563,0
0,0,6,6,26.7,39.7,22.4,11.2,730316,452364,187113,16526,3005,167582,90839,31565,23137,14331,5928,524,95,5309,2878,360626,248597,62912,43441,19471,49117,5969,43148,11614,8583,3031,524,2507,31051,28964,17211,1
0,0,7,11,27.5,43.2,19.2,10.1,568942,371063,144298,17492,3026,123780,53581,22770,24986,16296,6337,768,133,5436,2353,446072,319144,73240,48837,24403,53688,26487,27201,11067,9013,2054,341,1713,40306,35409,15879,0
0,0,7,8,23.2,35,29.2,12.7,878211,529899,214532,17262,3198,194072,133780,35492,24744,14930,6045,486,90,5468,3769,642588,443466,111613,77819,33794,87509,27015,60494,20449,15068,5381,1146,4235,31424,29431,14284,0
0,0,6,6,27.6,39.8,20.4,12.2,541393,351899,118781,13340,3288,102153,70713,19954,27132,17636,5953,669,165,5119,3544,455083,313466,76544,51690,24854,65073,22513,42560,13168,10882,2286,418,1868,34560,28806,22784,1
0,0,7,8,26.5,34.9,25.9,12.7,648832,386010,177986,22003,3362,152621,84836,26934,24090,14332,6608,817,125,5666,3150,313984,223101,58709,41374,17335,32174,1813,30361,10269,8446,1823,182,1641,30576,26415,18502,0
0,0,7,8,22.5,37.5,27.2,12.8,1037451,492661,315800,16958,3525,295317,228990,39992,25941,12319,7897,424,88,7384,5726,609271,420319,109039,75780,33259,79913,4745,75168,21231,15470,5761,561,5200,28697,27170,14455,2
0,0,3,2,25.7,35.8,26,12.5,1039432,676704,221194,30222,3605,187367,141534,42181,24642,16043,5244,716,85,4442,3355,645451,442574,100314,66425,33889,102563,12119,90444,17979,14265,3714,509,3205,35900,31025,28220,0
0,0,6,3,34.9,32.8,22.8,9.6,572416,340846,163300,31213,3766,128321,68270,28639,19987,11901,5702,1090,131,4481,2384,388141,268747,74746,53451,21295,44648,12576,32072,12195,9838,2357,269,2088,31828,27317,15360,1
0,0,7,8,37.8,26.5,23.4,12.4,529527,291437,178471,34676,3869,139926,59619,23946,22113,12171,7453,1448,162,5843,2490,300536,188319,49037,34447,14590,63180,33664,29516,8988,7395,1593,257,1336,33437,25466,22093,0
0,0,7,8,24.5,39.7,22,13.7,913172,559995,214246,19847,4378,190021,138931,35155,25976,15929,6094,565,125,5405,3952,693679,480832,124797,86679,38118,88050,26677,61373,21574,17556,4018,998,3020,32153,27388,20322,2
0,0,6,5,27.9,40.6,20.6,10.9,920661,587007,223305,22327,4383,196595,110349,39599,23250,14824,5639,564,111,4965,2787,647366,439494,123085,85020,38065,84787,21284,63503,19682,16038,3644,700,2944,32891,27403,21570,1
0,0,2,2,28.5,36,25.8,9.7,1317411,882102,293597,31189,4802,257606,141712,57779,22801,15267,5081,540,83,4458,2453,766857,560504,135289,89981,45308,71064,11021,60043,25720,19978,5742,880,4862,29816,28056,12349,1
0,0,5,8,22.6,33.5,24.9,19,1489131,987288,303932,28161,4951,270820,197911,57535,25882,17160,5283,489,86,4707,3440,1171208,850865,210962,145645,65317,109381,28823,80558,35491,28862,6629,955,5674,33000,29480,14198,1
0,0,5,8,25.5,35.5,24.1,14.9,1406305,805544,285498,33135,5135,247228,315263,43134,32603,18675,6619,768,119,5732,7309,1006423,709817,176139,121426,54713,120467,12832,107635,25785,21402,4383,313,4070,39031,33166,26446,0
0,0,2,2,22.4,35.7,27.4,14.6,1665534,1176580,278924,25461,5187,248276,210030,60225,27655,19536,4631,423,86,4122,3487,550326,342684,81373,54809,26564,126269,23837,102432,19539,12871,6668,678,5990,28166,26625,17101,3
0,0,1,1,30.8,33.1,23.3,12.8,1256161,860695,268324,55122,5529,207673,127142,50244,25001,17130,5340,1097,110,4133,2530,733328,496587,121271,81821,39450,115470,20062,95408,21117,17362,3755,199,3556,34727,28602,26830,0
0,0,4,5,35.3,32.1,21.3,11.3,1101396,684196,287874,48390,6871,232613,129326,47399,23237,14435,6073,1021,145,4908,2728,898818,634167,154470,103598,50872,110181,33413,76768,23043,19790,3253,305,2948,39006,32045,26041,1
0,0,2,2,17.7,37.7,28.3,16.4,2669524,1857414,501101,32551,7638,460912,311009,93493,28553,19867,5360,348,82,4930,3327,885603,595593,143049,96239,46810,146961,296,146665,30386,21165,9221,355,8866,29145,28140,16542,1
0,0,4,5,27.1,35.7,21.7,15.5,1689705,1080939,388048,34031,7953,346064,220718,71355,23680,15149,5438,477,111,4850,3093,1028901,725635,176366,119278,57088,126900,20262,106638,35936,26174,9762,1822,7940,28631,27724,13430,0
0,0,3,2,22.7,32.8,23.6,20.9,2278834,1519930,460160,49792,8052,402316,298744,87512,26040,17368,5258,569,92,4597,3414,1841230,1291139,316148,214510,101638,233943,47935,186008,53933,44137,9796,618,9178,34139,29253,20267,4
0,0,2,2,16.7,31.3,26.8,25.2,2615306,1826760,455456,38631,8634,408191,333090,99192,26366,18416,4592,389,87,4115,3358,1642276,1212494,284936,191555,93381,144846,-1,144847,50512,39318,11194,1205,9989,32513,30838,14501,3
0,0,3,2,21.7,32.8,27.6,18,2615673,1377708,643520,47861,8809,586850,594445,92096,28402,14959,6987,520,96,6372,6455,1523673,1077343,254295,169709,84586,192035,2341,189694,51052,39069,11983,364,11619,29846,27575,16326,5
0,0,2,2,23.4,31.2,28.8,16.6,3563899,2431030,608929,63675,10113,535141,523940,119426,29842,20356,5099,533,85,4481,4387,3541241,2538879,612106,417446,194660,390256,10572,379684,89868,77509,12359,794,11565,39405,32756,32830,5
0,0,3,2,25.2,34.8,24.3,15.7,2000948,1250958,477011,74231,10891,391889,272979,80562,24837,15528,5921,921,135,4864,3388,1643821,1220575,316578,220245,96333,106668,26054,80614,42989,37953,5036,358,4678,38238,32160,17233,2
0,0,2,2,19.6,32.8,27.3,20.3,7890037,4305786,726218,58687,11888,655643,2858033,186756,42248,23056,3889,314,64,3511,15304,4970367,3696286,787501,518672,268829,486580,83034,403546,116654,95906,20748,1977,18771,42608,38541,21498,10
0,0,2,2,20.5,30.5,24.5,24.5,5058606,3581253,657191,69793,12805,574593,820162,183799,27522,19485,3576,380,70,3126,4462,4390241,3252733,757854,514376,243478,379654,80965,298689,121026,98069,22957,2553,20404,36275,33168,14639,20
0,0,2,2,15.6,27.1,29.2,28.1,14301696,9709961,2003347,227060,36292,1739995,2588388,368274,38834,26366,5440,617,99,4725,7028,14308886,10095951,2367836,1596876,770960,1845099,800,1844299,303864,266542,37322,445,36877,47090,37878,50012,42
0,0,7,8,17.5,35.1,35.2,12.2,193143,123915,50519,3312,379,46828,18709,7595,25430,16315,6652,436,50,6166,2463,207013,168944,33015,21747,11268,5054,2477,2577,4398,3881,517,93,424,47070,43531,6078,0
0,0,6,4,30.7,33.9,26.7,8.7,449049,233125,133761,11094,1132,121535,82163,20379,22035,11439,6564,544,56,5964,4032,264037,160043,40667,28304,12363,63327,12634,50693,7773,6336,1437,72,1365,33968,25259,37138,0
0,0,6,8,24.4,30.1,33.6,11.8,653330,338464,224427,20215,1606,202606,90439,32964,19820,10268,6808,613,49,6146,2744,306323,215048,57752,41816,15936,33523,10479,23044,10063,7909,2154,245,1909,30441,27190,12071,4
0,0,4,3,21.8,28.7,35.7,13.9,1277929,560566,451589,34264,2725,414600,265774,51655,24740,10852,8742,663,53,8026,5145,617146,441438,109988,76584,33404,65720,-641,66361,20367,14436,5931,177,5754,30301,30579,11533,2
0,0,4,5,39.3,22.8,22.7,15.2,1037166,648917,197738,31680,3019,163039,190511,42961,24142,15105,4603,737,70,3795,4435,710296,450265,110647,76908,33739,149384,5374,144010,18484,13953,4531,123,4408,38428,32270,32670,1
0,0,6,6,36.4,24.9,27.4,11.3,1420576,697953,513278,77212,4754,431312,209345,68521,20732,10186,7491,1127,69,6295,3055,861444,638540,190004,141590,48414,32900,-2366,35266,26469,20290,6179,2256,3923,32545,31471,8990,0
0,0,4,5,20.5,24.6,36,18.8,3530600,1979519,799043,67291,6253,725499,752038,125786,28068,15737,6352,535,50,5768,5979,2242279,1618289,453509,330348,123161,170481,11077,159404,55625,44540,11085,754,10331,40311,36333,15430,2
0,0,4,6,28.8,27.7,31.2,12.3,2138546,1096033,703703,101034,6864,595805,338810,104184,20527,10520,6754,970,66,5719,3252,1285868,936512,239606,163208,76398,109750,9577,100173,39493,29596,9897,1571,8326,32559,31643,12031,1
0,0,3,2,16.2,21.6,32.2,29.9,3744862,2357387,574057,67370,7430,499257,813418,127025,29481,18558,4519,530,58,3930,6404,2613271,1874901,466772,327702,139070,271598,-1235,272833,74562,60097,14465,845,13620,35048,31198,20032,25
0,0,4,3,22.5,34.9,32.7,9.9,4508922,2635848,1124039,90252,8214,1025573,749035,188773,23885,13963,5954,478,44,5433,3968,2292760,1597803,356087,235174,120913,338870,4324,334546,72539,54691,17848,223,17625,31607,29215,18981,5
0,0,3,2,15.3,28.2,35.4,21.1,5323133,2634007,1172237,68016,8773,1095448,1516889,195424,27239,13478,5998,348,45,5605,7762,2712615,1862344,409167,272000,137167,441104,9280,431824,90797,62313,28484,496,27988,29876,29887,15429,13
0,0,1,1,27.3,30.4,30.4,11.9,5630597,3391184,1354454,114283,10511,1229660,884959,235708,23888,14387,5746,485,45,5217,3754,2296199,1630846,393921,273695,120226,271432,71506,199926,68417,48749,19668,527,19141,33562,33454,10445,14
0,0,3,2,34.2,25.7,28.2,11.8,4281536,2811213,806571,111649,26199,668723,663752,178816,23944,15721,4511,624,147,3740,3712,3128957,2018430,507454,345214,162240,603073,220368,382705,80808,69973,10835,335,10500,38721,28846,36448,6
0,0,2,2,16.6,23.3,33.4,26.7,28401473,16767739,5061814,427323,43465,4591026,6571920,920298,30861,18220,5500,464,47,4989,7141,18920448,13812760,3119591,2110653,1008938,1988097,15762,1972335,473271,381507,91764,422,91342,39978,36206,21593,320
0,0,1,1,17.5,23.1,33.5,25.9,125558179,87063053,15319964,1404591,162386,13752987,23175162,3538988,35479,24601,4329,397,46,3886,6549,99070117,73694192,14151854,8931747,5220107,11224071,177953,11046118,2176754,1791816,384938,1418,383520,45513,41128,28802,1064
0,0,8,4,11.7,26,34.1,28.2,42330,25795,7848,863,234,6751,8687,1219,34725,21161,6438,708,192,5538,7126,42047,26382,8018,5613,2405,7647,0,7647,1126,947,179,0,179,37342,27859,42721,0
0,0,8,7,14.8,28.7,39.3,17.2,90879,53710,17872,1752,848,15272,19297,3378,26903,15900,5291,519,251,4521,5713,44661,25205,10126,8111,2015,9330,586,8744,1360,849,511,45,466,32839,29688,18764,1
0,0,6,6,22.9,29.4,35.3,12.4,270487,151146,68106,8620,1567,57919,51235,9565,28279,15802,7120,901,164,6055,5357,160370,80965,30660,24453,6207,48745,20769,27976,4405,2966,1439,373,1066,36406,27298,26244,1
0,0,7,8,17.7,31.3,33.9,17.1,679185,426259,115155,9807,2091,103257,137771,18478,36756,23068,6232,531,113,5588,7456,488462,258099,91894,72307,19587,138469,4221,134248,10757,8302,2455,70,2385,45409,31089,56288,1
0,0,7,9,12.1,20.7,38.4,28.9,530997,372867,36158,3861,2571,29726,121972,13474,39409,27673,2684,287,191,2206,9052,430937,271526,75010,50771,24239,84401,3391,81010,10070,7821,2249,68,2181,42794,34718,37144,3
0,0,8,6,19,29.6,35.9,15.5,316935,147078,97864,11097,2999,83768,71993,13440,23581,10943,7282,826,223,6233,5357,150091,87855,33745,26738,7007,28491,-115,28606,4977,3087,1890,135,1755,30157,28460,16300,2
0,0,8,7,14.9,26.3,38.6,20.2,542432,322916,111665,9189,3074,99402,107851,17972,30182,17968,6213,511,171,5531,6001,278389,159183,54032,40539,13493,65174,-283,65457,7835,5461,2374,259,2115,35531,29149,30949,2
0,0,7,8,28.4,27.5,33.2,11,637458,342986,186159,32217,3583,150359,108313,28281,22540,12128,6582,1139,127,5317,3830,413881,256796,97050,77417,19633,60035,2805,57230,10823,8517,2306,69,2237,38241,30151,25583,1
0,0,6,4,16,30.2,37.1,16.6,1155794,705566,203200,12839,4665,185696,247028,38040,30384,18548,5342,338,123,4882,6494,735211,443698,147182,114137,33045,144331,2219,142112,18662,13134,5528,399,5129,39396,33782,27708,0
0,0,6,6,31.5,26.8,31,10.7,698580,433465,150386,21950,4672,123764,114729,27393,25502,15824,5490,801,171,4518,4188,454519,232444,76989,57292,19697,145086,68779,76307,11379,7915,3464,1039,2425,39944,29368,31467,0
0,0,7,12,12,27.7,42.8,17.5,704908,394159,143269,12147,5257,125865,167480,21010,33551,18761,6819,578,250,5991,7971,439928,254338,87714,64791,22923,97876,3224,94652,11505,7681,3824,115,3709,38238,33113,25520,3
0,0,6,6,20.4,30.9,38.1,10.7,786603,491491,154745,20917,5358,128470,140367,34488,22808,14251,4487,607,155,3725,4070,561507,357763,142607,116723,25884,61137,4045,57092,13023,10432,2591,375,2216,43117,34295,25764,1
0,0,6,6,14.3,28.6,40,17.1,1458892,876521,267832,20918,6517,240397,314539,45295,32209,19351,5913,462,144,5307,6944,578128,293952,96077,71303,24774,188099,2372,185727,17125,9896,7229,522,6707,33759,29704,27692,2
0,0,6,4,36,24.1,29.2,10.6,568437,377791,95852,12743,7624,75485,94794,20540,27675,18393,4667,620,371,3675,4615,430217,243324,71717,50435,21282,115176,61072,54104,10533,8199,2334,651,1683,40845,29677,32147,0
0,0,4,5,24.3,30.8,33.6,11.3,1523747,879622,377203,53011,8404,315788,266922,60602,25144,14515,6224,875,139,5211,4405,900127,557487,175385,124739,50646,167255,33685,133570,24185,18044,6141,1454,4687,37218,30896,28498,0
0,0,4,5,15.7,29.7,38.4,16.1,1690253,971374,348465,28038,8492,311935,370414,56788,29764,17105,6136,494,150,5493,6523,1047457,639439,205558,154138,51420,202460,5663,196797,26960,19358,7602,319,7283,38852,33032,27021,12
0,0,7,11,16.2,28.2,37.8,17.7,1237333,646258,333463,41859,9466,282138,257612,44641,27717,14477,7470,938,212,6320,5771,739881,425770,148378,110575,37803,165733,17152,148581,21706,14892,6814,693,6121,34086,28591,24274,3
0,0,4,5,22.7,29.8,35.4,12.1,1737875,973157,455681,60423,10103,385155,309037,63811,27235,15251,7141,947,158,6036,4843,807206,488220,157638,117268,40370,161348,-8851,170199,24578,16583,7995,743,7252,32843,29441,23469,3
0,0,1,1,25.1,23.2,34.6,17.1,1746361,1293843,190262,24676,11018,154568,262256,54647,31957,23676,3482,452,202,2828,4799,943605,594408,174529,121626,52903,174668,42313,132355,22743,16878,5865,531,5334,41490,35218,24813,22
0,0,4,3,9.7,23.8,40.4,26.1,3859328,2431107,528551,35331,11640,481580,899670,97250,39685,24999,5435,363,120,4952,9251,2028308,1093631,311174,216777,94397,623503,-3689,627192,51142,31732,19410,576,18834,39660,34465,33301,24
0,0,3,2,28.2,27.2,34.3,10.3,1792298,1094779,437844,75627,11751,350466,259675,66285,27039,16516,6605,1141,177,5287,3918,1202085,790354,284409,220612,63797,127322,14799,112523,27364,21195,6169,710,5459,43929,37290,20612,3
0,0,4,5,19.2,26,34.6,20.2,2672347,1552336,556815,74796,13682,468337,563196,87981,30374,17644,6329,850,156,5323,6401,1752777,1012467,319589,232437,87152,420721,-7315,428036,48478,33961,14517,963,13554,36156,29813,31580,7
0,0,3,2,19.6,20.5,33.5,26.4,5768900,3776396,651462,44417,16681,590364,1341042,130381,44246,28964,4997,341,128,4528,10286,4325977,2815063,786451,542735,243716,724463,67184,657279,87728,68830,18898,1159,17739,49311,40899,37053,20
0,0,5,8,15.1,25.7,36.2,23,3995003,2456864,780458,110148,19053,651257,757681,131497,30381,18684,5935,838,145,4953,5762,2723409,1567960,505814,372500,133314,649635,31231,618404,69244,51578,17666,777,16889,39331,30400,36616,11
0,0,3,2,27,23.6,34.1,15.3,2616866,1749184,442490,61333,20433,360724,425192,88764,29481,19706,4985,691,230,4064,4790,1415408,885748,251286,172814,78472,278374,35867,242507,37284,27833,9451,1042,8409,37963,31824,28839,2
0,0,1,1,10.9,22.2,40.3,26.5,7591570,5586040,781060,59923,21248,699889,1224470,175003,43380,31920,4463,342,121,3999,6997,3361932,1962985,534920,367891,167029,864027,-7924,871951,82892,54179,28713,1055,27658,40558,36231,31526,119
0,0,3,2,34.6,25.3,28.1,12,3459649,2336128,640575,110067,21364,509144,482946,140313,24657,16649,4565,784,152,3629,3442,2425782,1390066,428062,310694,117368,607654,242638,365016,57801,45249,12552,1408,11144,41968,30720,32754,8
0,0,3,2,31.2,28.9,29.5,10.4,3482098,2391056,569398,105856,23131,440411,521644,145147,23990,16473,3923,729,159,3034,3594,2767204,1712307,596241,454991,141250,458656,264276,194380,57079,49686,7393,936,6457,48480,34463,30104,0
0,0,3,2,14.4,21.8,37.1,26.7,9243300,5954382,1148049,103014,23786,1021249,2140869,258615,35742,23024,4439,398,92,3949,8278,6210885,3748632,1124599,812169,312430,1337654,61948,1275706,149346,108476,40870,2116,38754,41587,34557,32918,69
0,0,1,1,20.2,19.8,25.8,34.1,6487521,4521285,748658,102435,24930,621293,1217578,186269,34829,24273,4019,550,134,3335,6537,6053028,4119511,1294930,971629,323301,638587,44506,594081,121226,101757,19469,801,18668,49932,40484,31823,69
0,0,1,1,8.8,12.4,27.5,51.3,19856643,12457481,1136938,66024,24997,1045917,6262224,244206,81311,51012,4656,270,102,4283,25643,10268426,6065796,1308163,849889,458274,2894467,9735,2884732,175571,115503,60068,200,59868,58486,52516,48185,124
0,0,3,2,17.7,24.3,36.1,21.8,6170006,3736383,1321900,179197,32395,1110308,1111723,214752,28731,17399,6155,834,151,5170,5177,4015834,2446317,741983,534909,207074,827534,69322,758212,103948,79251,24697,1701,22996,38633,30868,32971,7
0,0,3,2,16.7,27.6,39,16.6,5260540,3141339,1224688,146075,33877,1044736,894513,175615,29955,17888,6974,832,193,5949,5094,3588492,2312691,683849,481315,202534,591952,28,591924,91346,69581,21765,1181,20584,39285,33237,28757,8
0,0,1,1,9.5,21.3,38.9,30.3,13998076,10204624,1367746,96621,35270,1235855,2425706,312762,44756,32627,4373,309,113,3951,7756,8931591,5819877,1447896,942167,505729,1663818,3642,1660176,193387,141936,51451,1285,50166,46185,41004,33094,99
0,0,2,2,20.8,19,30.8,29.4,17091378,10297625,1728325,198152,39953,1490220,5065428,408079,41883,25234,4235,486,98,3652,12413,12139426,7938822,2120570,1474350,646220,2080034,158455,1921579,253193,198832,54361,1125,53236,47945,39927,36095,209
0,0,3,2,36.2,23.9,28.9,11,6140026,4147959,1226788,234086,49270,943432,765279,242554,25314,17101,5058,965,203,3890,3155,4032503,2204803,689462,497590,191872,1138238,413527,724711,87573,69985,17588,2257,15331,46047,31504,47271,7
0,0,2,2,16.8,16.6,32.5,34.2,10543553,7299612,1042087,114089,50226,877772,2201854,251377,41943,29039,4146,454,200,3492,8759,6321353,3901909,1061598,739843,321755,1357846,94859,1262987,140941,101397,39544,542,39002,44851,38482,32383,302
0,0,2,2,15.1,20.4,36,28.5,18911246,12799274,2105934,176858,59182,1869894,4006038,465938,40587,27470,4520,380,127,4013,8598,12675850,8157844,2155708,1464224,691484,2362298,73138,2289160,271468,199719,71749,2798,68951,46694,40847,33200,186
0,0,2,2,16.2,24.5,37.9,21.4,14012653,10147632,1736292,214491,63040,1458761,2128729,408181,34330,24861,4254,525,154,3574,5215,8200281,5663980,1646678,1160972,485706,889623,44499,845124,179244,141642,37602,753,36849,45749,39988,22935,38
0,0,3,2,41,22,26.7,10.3,3845072,2579472,797668,174161,64337,559170,467932,156113,24630,16523,5110,1116,412,3582,2997,2909636,1755021,591780,448755,143025,562835,240538,322297,67019,57452,9567,328,9239,43415,30548,34884,2
0,0,2,2,38.3,22.9,27.2,11.5,10666701,7132170,2133752,431210,77880,1624662,1400779,407970,26146,17482,5230,1057,191,3982,3434,7410759,4321994,1351071,974284,376787,1737694,835057,902637,177770,145416,32354,4445,27909,41687,29722,32342,9
0,0,1,1,14.7,17.5,28.8,39,45118801,30035306,2791029,211256,80920,2498853,12292466,690078,65382,43525,4045,306,117,3621,17813,32303931,23047784,4715364,3101180,1614184,4540783,4380,4536403,449873,346414,103459,245,103214,71807,66532,43951,1471
0,0,2,2,31.6,18.6,27.4,22.5,14737704,9698226,1722763,221866,84717,1416180,3316715,405139,36377,23938,4252,548,209,3496,8187,10673941,6832036,1869486,1284126,585360,1972419,584787,1387632,221519,181142,40377,881,39496,48185,37716,35133,64
0,0,2,2,29.6,26.1,30.2,14.1,14404639,9923149,2462254,381340,95654,1985260,2019236,500020,28808,19846,4924,763,191,3970,4038,9987577,6411201,1822286,1257230,565056,1754090,372713,1381377,224867,181187,43680,3498,40182,44415,35384,34378,14
0,0,2,2,19.9,19.7,33.5,26.9,33177599,24300993,3183963,341819,97952,2744192,5692643,794197,41775,30598,4009,430,123,3455,7168,22027195,15245111,3826112,2616267,1209845,2955972,97302,2858670,435416,334790,100626,1844,98782,50589,45536,28939,406
0,0,2,2,28.8,25.2,31.5,14.5,19757562,13709995,3445398,544247,111078,2790073,2602169,656985,30073,20868,5244,828,169,4247,3961,13310038,8249148,2351199,1623504,727695,2709691,341176,2368515,283427,226818,56609,3078,53531,46961,36369,44246,36
0,0,2,2,31.5,25.4,29.6,13.5,20188632,13868968,3461219,685718,119929,2655572,2858445,760726,26539,18231,4550,901,158,3491,3758,15561199,10057848,2956987,2101508,855479,2546364,649832,1896532,341791,281008,60783,1647,59136,45528,35792,32071,48
0,0,1,1,18.8,13.9,22.3,45,50504289,33468782,4210239,618034,120274,3471931,12825268,763016,66190,43864,5518,810,158,4550,16809,53505480,37431258,7960961,5445477,2515484,8113261,0,8113261,680323,553432,126891,0,126891,78647,67635,63939,214
0,0,1,1,13.1,19.8,32.1,35,52450757,37775926,4624062,448666,130937,4044459,10050769,999013,52503,37813,4629,449,131,4048,10061,30328802,18980063,4648649,3147205,1501444,6700090,24042,6676048,491400,361391,130009,509,129500,61719,52519,51552,393
0,0,1,1,16.7,22.9,35.6,24.8,48684023,34149789,6987248,1100576,162068,5724604,7546986,1360816,35776,25095,5135,809,119,4207,5546,42911245,29643928,8715968,6471649,2244319,4551349,65172,4486177,793905,650116,143789,1188,142601,54051,45598,31460,168
0,0,2,2,32.5,21.1,28.9,17.5,24608466,16427983,4663073,904594,168905,3589574,3517410,872470,28206,18829,5345,1037,194,4114,4032,18648447,11815414,3457229,2443804,1013425,3375804,819632,2556172,424613,351991,72622,4999,67623,43919,33567,37800,39
0,0,1,1,25.8,25,33.3,15.9,54357785,39291523,8356717,1515373,188069,6653275,6709545,1943924,27963,20212,4299,780,97,3423,3452,37430027,25292176,7251059,5033907,2217152,4886792,146100,4740692,857604,685525,172079,1164,170915,43645,36895,27737,107
0,0,1,1,25,24.7,33.7,16.6,56890141,39462942,8292099,1121080,199276,6971743,9135100,1931785,29450,20428,4292,580,103,3609,4729,34659627,22792304,6464909,4485218,1979691,5402414,205186,5197228,841274,640911,200363,2740,197623,41199,35562,26299,201
0,0,1,1,17.6,19,28.4,34.9,62902099,45256915,6981942,931132,209674,5841136,10663242,1441545,43635,31395,4843,646,145,4052,7397,53334686,38445151,9517212,6480228,3036984,5372323,14141,5358182,885435,713182,172253,399,171854,60236,53907,31179,1525
0,0,1,1,16.6,15.9,27,40.5,89646127,65196355,6664193,764645,251931,5647617,17785579,1675312,53510,38916,3978,456,150,3371,10616,85234191,65757376,12578485,8199522,4378963,6898330,34964,6863366,1097630,900624,197006,850,196156,77653,73013,34989,6480
0,0,1,1,20.5,17.5,31.2,30.8,139292167,101976085,11432136,1319172,267813,9845151,25883946,2940055,47377,34685,3888,449,91,3349,8804,112612954,75811112,17571139,11393184,6177955,19230703,60870,19169833,1980809,1581819,398990,240,398750,56852,47927,48075,1534
0,0,1,1,17.4,19.9,33.2,29.5,123075207,85592863,13074313,1526764,313702,11233847,24408031,2938375,41885,29129,4450,520,107,3823,8307,97097695,65561679,17160169,11827042,5333127,14375847,184399,14191448,1837287,1478007,359280,5101,354179,52848,44358,40069,1767
0,0,1,1,30.1,18.8,26.2,24.9,365284999,244953265,50479358,8682236,1085832,40711290,69852376,9786373,37326,25030,5158,887,111,4160,7138,297257514,203757832,49698090,33813212,15884878,43801592,57559,43744033,5494908,4305519,1189389,1333,1188056,54097,47325,36820,2140
0,0,0,0,23.2,20.1,30,26.6,1408965257,972768197,169300669,24619356,4525400,140155913,266896391,35827943,39326,27151,4725,687,126,3912,7449,1091292119,742516053,184685846,126376786,58309060,164090220,6611623,157478597,20126877,15870028,4256849,65734,4191115,54221,46787,37574,0
0,0,9,12,8.4,28.4,32,31.2,24923,12539,4495,265,56,4174,7889,814,30618,15404,5522,326,69,5128,9692,16947,11306,2607,1772,835,3034,-226,3260,777,483,294,11,283,21811,23408,11519,0
0,0,9,10,7.9,14.5,33.9,43.7,19296,12221,2385,242,89,2054,4690,627,30775,19491,3804,386,142,3276,7480,12573,6272,1623,1094,529,4678,0,4678,475,291,184,0,184,26469,21553,25424,0
0,0,9,12,13.7,35.5,34.7,16.1,45367,29585,8122,605,92,7425,7660,1467,30925,20167,5536,412,63,5061,5222,31053,13889,4011,3102,909,13153,9019,4134,1114,589,525,314,211,27875,23581,19592,0
0,0,9,12,15.9,34.8,35.2,14.2,68456,47678,10240,843,104,9293,10538,1939,35305,24589,5281,435,54,4793,5435,55718,26463,7013,5233,1780,22242,12667,9575,1440,844,596,275,321,38693,31354,29829,0
0,0,9,12,13.8,36.1,30.3,19.9,45154,26358,6698,642,117,5939,12098,1449,31162,18190,4622,443,81,4099,8349,27156,14568,4118,3003,1115,8470,5072,3398,972,590,382,73,309,27938,24692,10997,0
0,0,9,10,20.7,35.5,30.4,13.4,75335,47383,16016,990,119,14907,11936,2522,29871,18788,6351,393,47,5911,4733,48698,22617,6074,4512,1562,20007,13301,6706,1447,942,505,147,358,33654,24010,18732,0
0,0,9,10,18.4,32.1,29.5,19.9,113247,70804,22402,1451,201,20750,20041,4467,25352,15850,5015,325,45,4645,4486,76803,41894,11694,8872,2822,23215,13777,9438,2521,1632,889,262,627,30465,25670,15053,0
0,0,9,12,21.5,34.3,30.1,14,116899,72636,24349,2289,220,21840,19914,3997,29247,18173,6092,573,55,5464,4982,75487,30497,9257,7369,1888,35733,25458,10275,2552,1381,1171,581,590,29580,22083,17415,0
0,0,8,7,9.7,28.1,35.6,26.7,110459,56866,18630,1502,229,16899,34963,3989,27691,14256,4670,377,57,4236,8765,43033,22936,6183,4443,1740,13914,367,13547,2140,979,1161,162,999,20109,23428,13561,0
0,0,8,7,22.5,34.5,31.2,11.9,96011,59524,23986,3378,320,20288,12501,5677,16912,10485,4225,595,56,3574,2202,63918,36102,9642,7360,2282,18174,14740,3434,1707,1167,540,207,333,37445,30936,10312,0
0,0,9,12,31.8,27.3,28.1,12.8,78287,38098,27292,3887,331,23074,12897,3562,21978,10696,7662,1091,93,6478,3621,31268,19402,5498,4204,1294,6368,3743,2625,1367,794,573,194,379,22873,24436,6926,0
0,0,9,12,11.6,32,36.9,19.5,198706,139085,28885,1633,350,26902,30736,5945,33424,23395,4859,275,59,4525,5170,179679,121504,29630,20955,8675,28545,5493,23052,4639,3340,1299,220,1079,38732,36378,21364,0
0,0,1,1,5.9,25.6,37.3,31.2,231072,186893,12641,1053,393,11195,31538,4810,48040,38855,2628,219,82,2327,6557,306230,213019,34653,16870,17783,58558,0,58558,6072,5577,495,0,495,50433,38196,118299,1
0,0,7,11,22.8,35.1,30.6,11.5,132043,73763,33069,4450,408,28211,25211,6118,21583,12057,5405,727,67,4611,4121,67929,42376,11785,9126,2659,13768,9797,3971,2111,1544,567,233,334,32179,27446,11889,0
0,0,7,11,20.5,33.8,30.1,15.5,364041,260747,44430,3938,476,40016,58864,9765,37280,26702,4550,403,49,4098,6028,285011,117683,28409,20003,8406,138919,109464,29455,6318,4160,2158,757,1401,45111,28289,21024,0
0,0,7,8,20.5,27.3,32.7,19.5,182662,128415,24976,2365,494,22117,29271,7331,24916,17517,3407,323,67,3017,3993,84471,53165,14888,11159,3729,16418,0,16418,2935,2069,866,0,866,28781,25696,18958,0
0,0,9,12,6.4,15.1,30.1,48.5,373710,230693,13021,1015,544,11462,129996,7097,52657,32506,1835,143,77,1615,18317,297201,174044,37153,23000,14153,86004,560,85444,7966,5225,2741,100,2641,37309,33310,32353,0
0,0,6,6,22.2,32.4,29.3,16.1,167915,77856,54276,6234,631,47411,35783,7145,23501,10897,7596,872,88,6636,5008,81488,52752,14500,10384,4116,14236,1028,13208,3400,2099,1301,240,1061,23967,25132,12449,1
0,0,1,1,6.6,21.5,33.1,38.8,410206,304110,27983,2012,684,25287,78113,9150,44831,33236,3058,220,75,2764,8537,167482,114960,25873,17174,8699,26649,0,26649,4184,3255,929,0,929,40029,35318,28686,0
0,0,9,12,27.9,33.8,23.8,14.4,173288,98355,54190,7696,719,45775,20743,8337,20785,11797,6500,923,86,5491,2488,69852,38745,11211,8515,2696,19896,1644,18252,3026,1568,1458,438,1020,23084,24710,17894,0
0,0,7,10,12.7,26.8,31.5,29,303345,168469,46604,4010,750,41844,88272,11496,26387,14655,4054,349,65,3640,7678,177632,98335,24241,16480,7761,55056,-1300,56356,7765,3773,3992,235,3757,22876,26063,15000,0
0,0,8,4,7.7,24,33.7,34.5,428011,291186,35796,2727,838,32231,101029,13627,31409,21368,2627,200,61,2365,7414,310227,201289,46529,30509,16020,62409,5175,57234,10413,7178,3235,152,3083,29792,28042,18564,0
0,0,7,11,20.4,33.5,33.7,12.5,400718,300497,51395,4677,853,45865,48826,12956,30929,23194,3967,361,66,3540,3769,276341,184943,48028,34522,13506,43370,14356,29014,7435,5332,2103,388,1715,37168,34685,16918,0
0,0,7,11,5.9,17.8,32.7,43.6,450994,290455,35235,2731,869,31635,125304,14456,31198,20092,2437,189,60,2188,8668,368292,247617,59402,40949,18453,61273,3907,57366,12133,8638,3495,156,3339,30355,28666,17181,0
0,0,7,11,28,28.9,31.2,11.9,353786,218573,82521,9827,879,71815,52692,13480,26245,16215,6122,729,65,5328,3909,249333,143179,40814,30363,10451,65340,34802,30538,7492,5587,1905,482,1423,33280,25627,21460,1
0,0,7,11,21.9,30,29.3,18.8,317440,183046,75632,11256,936,63440,58762,12208,26003,14994,6195,922,77,5197,4813,198328,119858,31818,22342,9476,46652,18676,27976,7012,4608,2404,291,2113,28284,26011,13240,0
0,0,7,11,23.1,27.2,33.4,16.2,408677,229701,112741,10409,1042,101290,66235,15582,26228,14741,7235,668,67,6500,4251,260968,174451,47990,34150,13840,38527,8881,29646,8417,6303,2114,465,1649,31005,27677,17978,1
0,0,7,8,17.7,32,35.7,14.6,599014,400265,94849,9798,1081,83970,103900,21694,27612,18450,4372,452,50,3871,4789,440462,263324,70386,50335,20051,106752,46978,59774,12469,9381,3088,813,2275,35325,28070,26274,0
0,0,7,11,11.5,29.9,34.2,24.3,447062,228152,92674,5824,1081,85769,126236,17105,26136,13338,5418,340,63,5014,7380,265216,180669,47032,33646,13386,37515,410,37105,10309,6816,3493,191,3302,25727,26507,11237,0
0,0,1,1,6.7,26.7,36.3,30.3,509860,388660,44498,3749,1090,39659,76702,16204,31465,23985,2746,231,67,2447,4734,133115,72527,18534,13547,4987,42054,-399,42453,5435,2505,2930,202,2728,24492,28953,15562,3
0,0,7,9,3.7,10.9,28.3,57.1,1500334,639022,39866,1436,1094,37336,821446,15399,97431,41498,2589,93,71,2425,53344,1028396,704133,128738,74054,54684,195525,-595,196120,22795,17423,5372,62,5310,45115,40414,36934,3
0,0,7,11,17.4,27.1,28.6,27,390843,248525,81704,12517,1102,68085,60614,15236,25653,16312,5363,822,72,4469,3978,327557,227112,61136,44234,16902,39309,14667,24642,10368,8288,2080,259,1821,31593,27403,13532,0
0,0,9,10,6.6,21.6,35,36.8,158009,95862,16027,894,1102,14031,46120,4055,38966,23640,3952,220,272,3460,11374,90929,48942,11418,7499,3919,30569,-439,31008,3125,1762,1363,81,1282,29097,27776,24187,2
0,0,7,11,4.7,17.7,35.1,42.5,1006088,686497,44667,3136,1309,40222,274924,21398,47018,32082,2087,147,61,1880,12848,827375,534132,113055,69372,43683,180188,6006,174182,21021,15171,5850,490,5360,39359,35207,32497,8
0,0,1,1,7.5,27.4,38.5,26.6,814664,629046,55212,3993,1420,49799,130406,22182,36726,28358,2489,180,64,2245,5879,207759,125845,29986,20341,9645,51928,-1828,53756,8312,4191,4121,1098,3023,24995,30027,17782,1
0,0,7,8,6.7,17.7,27.3,48.3,1002525,664964,43845,3123,1494,39228,293716,25487,39335,26090,1720,123,59,1539,11524,812789,574186,118060,71558,46502,120543,-524,121067,24565,18683,5882,32,5850,33087,30733,20695,2
0,0,2,2,6,23.5,38.9,31.7,752305,549923,77492,6453,1509,69530,124890,21978,34230,25022,3526,294,69,3164,5683,308729,204436,46210,30537,15673,58083,-842,58925,11343,6931,4412,103,4309,27218,29496,13675,33
0,0,6,3,28.6,31,27,13.5,717501,497527,125456,12896,1527,111033,94518,27727,25877,17944,4525,465,55,4005,3409,542122,345595,89074,62249,26825,107453,53971,53482,15519,11871,3648,685,2963,34933,29113,18050,0
0,0,6,6,18.9,33.1,27.1,21,654993,403968,115224,12149,1636,101439,135801,24514,26719,16479,4700,496,67,4138,5540,384607,262890,69237,49733,19504,52480,-3808,56288,14232,9742,4490,852,3638,27024,26985,15472,2
0,0,6,6,19.9,34,28.5,17.6,726113,404380,179175,13236,1877,164062,142558,29389,24707,13760,6097,450,64,5582,4851,374715,240156,63662,45901,17761,70897,1802,69095,14453,8791,5662,1008,4654,25926,27318,14846,1
0,0,5,8,13.4,16.5,27.5,42.6,2301394,1592784,70217,6488,2628,61101,638393,47205,48753,33742,1487,137,56,1294,13524,1780061,1168690,222418,126751,95667,388953,4643,384310,40277,30779,9498,107,9391,44195,37970,40923,3
0,0,5,9,14.6,26.9,34.6,23.8,1803560,1204833,135072,11930,2715,120427,463655,49579,36377,24301,2724,241,55,2429,9352,1245829,873197,195640,125833,69807,176992,456,176536,34001,24417,9584,465,9119,36641,35762,19359,8
0,0,6,5,8.6,23.1,31.9,36.4,1695984,1080683,162182,12821,2766,146595,453119,47575,35649,22715,3409,269,58,3081,9524,1234953,822410,188043,126379,61664,224500,656,223844,35438,25059,10379,849,9530,34848,32819,23488,6
0,0,6,6,24.3,30.7,29.6,15.4,514099,274375,166841,16975,2834,147032,72883,19247,26711,14255,8668,882,147,7639,3787,298084,192515,54162,37944,16218,51407,22513,28894,9668,7409,2259,452,1807,30832,25984,15990,0
0,0,4,5,19.5,36.7,30.3,13.5,1014183,601270,231950,20264,2905,208781,180963,46641,21744,12891,4973,434,62,4476,3880,659882,445352,128557,97100,31457,85973,-1000,86973,19624,14194,5430,719,4711,33626,31376,18462,3
0,0,1,1,0,0,0,0,2192932,1826077,129312,8033,2928,118351,237543,46313,47350,39429,2792,173,63,2555,5129,2091556,1642830,315723,198418,117305,133003,147,132856,37650,30371,7279,20,7259,55553,54092,18302,37
0,0,7,8,19.3,33.4,28.6,18.7,1064088,666844,176812,16293,3008,157511,220432,37227,28584,17913,4750,438,81,4231,5921,732541,454751,115614,80456,35158,162176,207,161969,22996,15397,7599,848,6751,31855,29535,23992,1
0,0,3,2,15,30.3,32.7,22,3964891,2555071,687321,61037,8538,617746,722499,130194,30454,19625,5279,469,66,4745,5549,2767250,1925018,460639,306048,154591,381593,4044,377549,79069,59009,20060,1425,18635,34998,32622,20260,7
0,0,3,2,18.7,31,32,18.3,4002198,2315650,1099204,108767,12122,978315,587344,149825,26712,15456,7337,726,81,6530,3920,2532809,1800700,463062,320839,142223,269047,2641,266406,71955,57689,14266,711,13555,35200,31214,19654,3
0,0,1,1,3,13.1,32,51.9,11286130,9172653,439412,26050,14237,399125,1674065,243112,46424,37730,1807,107,59,1642,6886,5306821,3782667,783203,495668,287535,740951,-445,741396,132616,89597,43019,803,42216,40016,42219,17562,68
0,0,3,2,20.4,26.9,31.1,21.6,6355911,4724139,748987,75360,14929,658698,882785,222879,28517,21196,3361,338,67,2955,3961,4193409,2842509,668569,448817,219752,682331,125767,556564,116668,82566,34102,2932,31170,35943,34427,17856,203
0,0,2,2,7.7,21.3,31.5,39.5,9358231,6646041,914742,69300,17808,827634,1797448,275116,34016,24157,3325,252,65,3008,6533,6835500,4978287,1157174,788742,368432,700039,-3609,703648,180859,135514,45345,1347,43998,37795,36736,15993,430
0,0,2,2,7.2,15.1,25.3,52.4,12904847,8771847,843464,60962,18388,764114,3289536,280241,46049,31301,3010,218,66,2727,11738,10663355,8031605,1665540,1098459,567081,966210,-1070,967280,218044,166577,51467,605,50862,48905,48216,19018,427
0,0,1,1,21.2,30.8,30.7,17.4,11420709,8874539,1380429,158236,29662,1192531,1165741,395146,28903,22459,3493,400,75,3018,2950,8176095,6036370,1338955,857143,481812,800770,-3149,803919,190371,155264,35107,674,34433,42948,38878,23347,59
0,0,1,1,9.3,20.5,33.1,37,21844161,15639413,1619061,170910,37154,1410997,4585687,524466,41650,29820,3087,326,71,2690,8744,18356205,14084627,2805665,1758801,1046864,1465913,-842,1466755,359421,286437,72984,461,72523,51072,49172,20225,101
0,0,1,1,8.2,22.6,32.7,36.5,22467370,16858707,1745780,126068,37337,1582375,3862883,519675,43234,32441,3359,243,72,3045,7433,12933541,9222431,2073420,1378263,695157,1637690,49,1637641,297456,219943,77513,415,77098,43481,41931,21241,189
0,0,2,2,8.7,22.9,36.6,31.8,19369713,13415602,2159498,205483,38115,1915900,3794613,565800,34234,23711,3817,363,67,3386,6707,15126295,11169064,2818705,1946565,872140,1138526,-2005,1140531,353683,282328,71355,1167,70188,42768,39561,16250,219
0,0,1,1,21.1,20,24.4,34.5,25567247,17052263,2807797,286669,43700,2477428,5707187,551691,46343,30909,5089,520,79,4491,10345,32472994,22926442,4848677,3194769,1653908,4697875,36,4697839,529590,453738,75852,10,75842,61317,50528,61942,34
0,0,4,5,20.4,35.7,25,19,3803594,2719106,601051,51373,20386,529292,483437,115636,32893,23514,5198,444,176,4577,4181,2153739,1416846,412825,304489,108336,324068,10125,313943,52079,40599,11480,475,11005,41355,34899,28527,17
0,0,1,1,10.8,29,27.4,32.8,5608069,4329169,554572,26833,20779,506960,724328,147657,37980,29319,3756,182,141,3433,4905,2456764,1571260,504348,393001,111347,381156,4343,376813,61038,44249,16789,362,16427,40250,35510,22939,57
0,0,1,1,11.3,28.6,26.4,33.8,7338812,5532589,740175,35950,23432,680793,1066048,162191,45248,34112,4564,222,144,4197,6573,4897983,3354647,843979,600362,243617,699357,425,698932,96862,74157,22705,295,22410,50567,45237,31188,101
0,0,4,5,14.1,31.4,27,27.5,8514243,6175029,877541,43238,29003,805300,1461673,188912,45070,32687,4645,229,154,4263,7737,4391120,2475005,664952,468948,196004,1251163,21231,1229932,95576,66288,29288,745,28543,45944,37337,43090,86
0,0,2,2,14,32,27.8,26.2,11024366,7779722,1368312,94644,40462,1233206,1876332,269664,40882,28850,5074,351,150,4573,6958,8844434,6051595,1733285,1299980,433305,1059554,6870,1052684,172255,144674,27581,623,26958,51345,41829,39049,154
0,0,2,2,15.6,23.5,21,39.9,66978056,45536653,4619272,312077,122259,4184936,16822131,897653,74615,50729,5146,348,136,4662,18740,44855456,31138852,6035101,4175438,1859663,7681503,9839,7671664,591253,448278,142975,217,142758,75865,69463,53739,533
0,0,1,1,17.6,28.6,24.1,29.6,38614913,28068846,5100858,431584,142186,4527088,5445209,878081,43976,31966,5809,492,162,5156,6201,37079470,26753654,6381673,4458863,1922810,3944143,6158,3937985,617361,521014,96347,592,95755,60061,51349,41126,243
0,0,2,2,17,30.8,24.6,27.6,33850958,23953967,5095972,419089,144277,4532606,4801019,847162,39958,28276,6015,495,170,5350,5667,24531961,16970247,4236834,2937121,1299713,3324880,8456,3316424,485556,392790,92766,419,92347,50523,43204,35913,331
0,0,1,1,22.2,20.6,18.2,39.1,30275589,20965670,3569040,517540,60764,2990736,5740879,567136,53383,36968,6293,913,107,5273,10123,63302277,46640747,12305311,9105523,3199788,4356219,0,4356219,769796,708380,61416,0,61416,82233,65841,70930,55
0,0,3,2,20.6,32.9,27.8,18.6,29808,3055914,54,4759,5245,96828027,69328192,144585,31075,21136,5180,460,109,4611,4759,3436387,2330464,711383,534929,176454,394540,45191,349349,81729,69119,12610,626,11984,42046,33717,29151,6
0,0,4,5,23.5,35.6,24.3,16.6,6096020,3892722,1202175,76503,19334,1106338,1001123,177222,34398,21965,6783,432,109,6243,5649,3880731,2246792,598021,425689,172332,1035918,212508,823410,96294,73795,22499,1023,21476,40301,30446,38341,4
0,0,1,1,14.5,29.6,26.3,29.5,21706,15928356,2570791,203731,70487,2296573,4077774,523343,43140,30436,4912,389,135,4388,7792,20468288,14967226,3304807,2287615,1017192,2196255,3380,2192875,350651,302944,47707,266,47441,58372,49406,46223,308
0,0,8,7,31.8,40.1,20.9,7.2,137768,87267,31875,4508,128,27239,18626,8131,16944,10733,3920,554,16,3350,2291,77650,47245,15827,12475,3352,14578,7680,6898,2349,1815,534,161,373,33057,26030,18493,0
0,0,8,7,34.4,40.4,17.8,7.4,174959,120631,32838,5008,137,27693,21490,7820,22373,15426,4199,640,18,3541,2748,107488,76395,22319,17013,5306,8774,348,8426,2999,2456,543,50,493,35841,31105,17091,1
0,0,6,7,27.5,38.9,26.1,7.5,235832,147732,50540,8032,289,42219,37560,14856,15875,9944,3402,541,19,2842,2528,200676,139025,47853,38027,9826,13798,3091,10707,5346,4361,985,227,758,37538,31879,14125,0
0,0,6,7,37.1,35.1,20.5,7.3,266411,157158,74106,11909,338,61859,35147,14017,19006,11212,5287,850,24,4413,2507,199108,143414,45835,35693,10142,9859,-488,10347,4904,3842,1062,240,822,40601,37328,12588,0
0,0,6,7,30.9,38.6,22.9,7.7,276315,157397,79126,9103,405,69618,39792,13850,19951,11364,5713,657,29,5027,2873,127117,82244,25606,19803,5803,19267,2614,16653,4283,3212,1071,168,903,29679,25605,18442,0
0,0,2,2,26.8,32.2,24,16.9,405521,248510,79218,10965,438,67815,77793,14210,28538,17488,5575,772,31,4772,5475,136092,90161,26555,20172,6383,19376,-519,19895,5119,3253,1866,462,1404,26586,27716,14170,0
0,0,3,2,27.6,36.1,26.9,9.4,374217,241505,83951,9434,444,74073,48761,15801,23683,15284,5313,597,28,4688,3086,132024,84552,26172,20182,5990,21300,3430,17870,4575,3055,1520,416,1104,28858,27677,16187,0
0,0,6,7,34.1,39.4,19.8,6.8,297555,143317,98853,12872,446,85535,55385,15427,19288,9290,6408,834,29,5544,3590,123287,82431,25353,19526,5827,15503,1175,14328,4147,2901,1246,180,1066,29729,28415,13441,0
0,0,6,4,30.2,36.8,23.2,9.8,225425,125878,49776,5468,459,43849,49771,12284,18351,10247,4052,445,37,3570,4052,90966,50441,14227,10737,3490,26298,18355,7943,2424,1845,579,203,376,37527,27339,21125,1
0,0,6,6,34.8,37.8,18.6,8.8,417229,228210,125470,15717,484,109269,63549,19523,21371,11689,6427,805,25,5597,3255,163946,103934,32736,25393,7343,27276,3449,23827,6625,4053,2572,756,1816,24747,25644,13121,0
0,0,2,2,21.6,34.9,27.7,15.7,714107,497032,107875,13465,737,93673,109200,26706,26740,18611,4039,504,28,3508,4089,249700,158636,47817,36678,11139,43247,105,43142,8475,5435,3040,115,2925,29463,29188,14749,0
0,0,6,6,28.8,38.8,23.2,9.2,529036,307817,142122,15868,763,125491,79097,22216,23813,13856,6397,714,34,5649,3560,272123,186119,56107,42780,13327,29897,1040,28857,8716,6568,2148,405,1743,31221,28337,16556,1
0,0,6,5,25.3,34.9,28.9,10.9,1574196,961713,366931,47468,809,318654,245552,63109,24944,15239,5814,752,13,5049,3891,1027370,740537,211127,159342,51785,75706,1162,74544,29654,24107,5547,722,4825,34645,30719,15450,2
0,0,1,1,28.1,41.4,22.3,8.2,603761,417119,113656,14859,821,97976,72986,24832,24314,16798,4577,598,33,3946,2939,301827,213742,65619,50589,15030,22466,362,22104,9046,7399,1647,241,1406,33366,28888,15721,0
0,0,6,6,25.8,40.1,25.6,8.4,607074,382187,143495,17365,871,125259,81392,28098,21606,13602,5107,618,31,4458,2897,324438,233463,68827,52399,16428,22148,1686,20462,9125,7494,1631,367,1264,35555,31153,16188,0
0,0,6,6,32.5,34.2,23.1,10.2,401353,219298,113628,17709,882,95037,68427,19070,21046,11500,5958,929,46,4984,3588,206503,142533,43426,33321,10105,20544,3951,16593,7306,5532,1774,509,1265,28265,25765,13117,1
0,0,6,6,30,40.9,20.2,8.9,504312,312295,119309,16033,883,102393,72708,20515,24583,15223,5816,782,43,4991,3544,346154,235305,65166,48987,16179,45683,233,45450,8869,7479,1390,102,1288,39030,31462,35287,1
0,0,6,6,26.8,38.8,23.9,10.5,910038,506074,260602,27466,1180,231956,143362,38687,23523,13081,6736,710,31,5996,3706,454271,284644,78792,58915,19877,90835,40081,50754,14652,10604,4048,883,3165,31004,26843,16036,0
0,0,8,7,26.1,38.2,25.1,10.6,955032,547374,243742,27548,1306,214888,163916,38355,24900,14271,6355,718,34,5603,4274,425622,268909,78588,59445,19143,78125,29698,48427,14246,10282,3964,768,3196,29877,26153,15152,0
0,0,6,5,36.5,35.3,19.8,8.4,675307,394812,162187,20738,1309,140140,118308,33864,19942,11659,4789,612,39,4138,3494,433993,270470,77907,58078,19829,85616,51834,33782,13256,10468,2788,842,1946,32739,25838,17360,2
0,0,6,5,42,31.5,18.1,8.4,573989,371535,127935,21815,1392,104728,74519,26874,21359,13825,4761,812,52,3897,2773,391291,228154,64845,48377,16468,98292,70477,27815,10570,8316,2254,827,1427,37019,27436,19492,0
0,0,4,3,22.7,38.8,26.2,12.2,1682055,788943,584466,30020,1502,552944,308646,69261,24286,11391,8439,433,22,7983,4456,778245,536949,148628,109664,38964,92668,7756,84912,24039,17581,6458,712,5746,32374,30541,14778,3
0,0,6,6,30.9,32.7,23.6,12.8,1175639,661781,309002,32096,1680,275226,204856,47930,24528,13807,6447,670,35,5742,4274,683926,456513,142931,110681,32250,84482,25963,58519,20264,15780,4484,971,3513,33751,28930,16658,1
0,0,4,5,34.9,33.9,22.3,8.9,901761,535639,221463,23410,2318,195735,144659,39247,22977,13648,5643,596,59,4987,3686,505433,337105,85122,60772,24350,83206,30696,52510,14817,11445,3372,485,2887,34112,29454,18188,1
0,0,2,2,29.3,35.9,21.9,12.9,1188718,722776,251724,48109,2330,201285,214218,45258,26265,15970,5562,1063,51,4448,4733,642448,454793,134250,101802,32448,53405,9118,44287,19033,15747,3286,302,2984,33754,28881,14841,3
0,0,1,1,19,34.4,27.7,18.9,2582054,1604123,317582,26063,2775,288744,660349,65568,39380,24465,4844,397,42,4404,10071,972126,660485,162997,117798,45199,148644,-897,149541,26053,19226,6827,322,6505,37313,34354,22989,3
0,0,4,5,14.1,31.9,32.7,21.2,2403085,1263854,504440,28900,3007,472533,634791,77008,31206,16412,6550,375,39,6136,8243,909813,590690,150078,108735,41343,169045,9891,159154,28476,19167,9309,66,9243,31950,30818,17219,4
0,0,4,3,29.6,37.3,23.6,9.4,1736603,976526,497637,61300,3208,433129,262440,73792,23534,13233,6744,831,43,5870,3556,904462,646307,176832,131442,45390,81323,13760,67563,25840,20792,5048,377,4671,35002,31084,14464,5
0,0,4,5,25.5,34.6,26.3,13.6,2366429,1081858,732677,51584,3739,677354,551894,95614,24750,11315,7663,540,39,7084,5772,1179697,806869,208141,149825,58316,164687,48699,115988,37340,29613,7727,645,7082,31593,27247,16378,4
0,0,4,5,21.7,38,27.1,13.2,3613455,1588999,1077372,55752,4234,1017386,947084,133791,27008,11877,8053,417,32,7604,7079,1590679,1101889,280119,202569,77550,208671,344,208327,47674,35103,12571,334,12237,33366,31390,17024,7
0,0,3,2,17.9,35.7,28.9,17.6,4787584,2184238,1156936,44384,4863,1107689,1446410,155262,30836,14068,7452,286,31,7134,9316,2075407,1459269,344366,241442,102924,271772,14006,257766,59929,44433,15496,193,15303,34631,32842,16844,13
0,0,4,5,45.8,29.1,16.8,8.2,837559,556828,168558,32152,4906,131500,112173,38201,21925,14576,4412,842,128,3442,2936,602816,388967,105183,75873,29310,108666,62468,46198,17634,14699,2935,301,2634,34185,26462,17539,0
0,0,1,1,12.8,24.5,29.6,33.1,7647516,4722037,761042,46528,5329,709185,2164437,160266,47718,29464,4749,290,33,4425,13505,2713096,1888312,433510,303142,130368,391274,30243,361031,76157,55356,20801,145,20656,35625,34112,17478,48
0,0,2,2,14.7,28.3,30.7,26.3,7915782,3348866,941924,42648,5807,893469,3624992,141912,55780,23598,6637,301,41,6296,25544,3210894,2250316,500321,344690,155631,460257,35081,425176,82372,64480,17892,332,17560,38980,34899,24213,44
0,0,3,2,18.4,29.1,29.4,23.1,6860492,2644497,861920,47300,6635,807985,3354075,127955,53616,20667,6736,370,52,6315,26213,2557555,1763832,408583,284239,124344,385140,42781,342359,68831,52815,16016,304,15712,37157,33396,21790,7
0,0,1,1,21.5,37.7,28,12.7,4304921,2195861,1212890,67309,6793,1138788,896170,157156,27393,13972,7718,428,43,7246,5702,1725324,1239823,314536,226431,88105,170965,2103,168862,55500,41873,13627,567,13060,31087,29609,12930,5
0,0,3,2,11.9,20.3,29.1,38.7,7468700,4882308,1033118,126082,7199,899837,1553274,233756,31951,20886,4420,539,31,3849,6645,6142935,4506056,1259485,945576,313909,377394,10185,367209,157313,134175,23138,1231,21907,39049,33583,16762,96
0,0,1,1,13.6,31.7,34.6,20.1,5554572,3883795,703229,61487,7846,633896,967548,169418,32786,22924,4151,363,46,3742,5711,1950452,1380652,343510,245058,98452,226290,1268,225022,60423,45204,15219,296,14923,32280,30543,15079,22
0,0,2,2,10.9,18.9,28.5,41.7,8657242,5991533,954333,124654,9247,820432,1711376,258083,33544,23216,3698,483,36,3179,6631,7563137,5529387,1520026,1138603,381423,513724,158,513566,179458,153821,25637,248,25389,42144,35947,20228,43
0,0,1,1,20.2,34.3,28.9,16.6,8106337,4630503,1773411,111780,9943,1651688,1702423,267587,30294,17305,6627,418,37,6173,6362,3874820,2757773,662959,468119,194840,454088,34223,419865,112088,85544,26544,1375,25169,34569,32238,16682,21
0,0,2,2,21.8,35.9,28.6,13.7,8488351,4367853,2117453,159348,9981,1948124,2003045,303558,27963,14389,6975,525,33,6418,6599,4589638,3280948,833887,601274,232613,474803,-15928,490731,134595,105700,28895,2569,26326,34100,31040,18641,16
0,0,2,2,18.6,31.9,28.8,20.8,11376805,6437142,1756804,117597,11504,1627703,3182859,306845,37077,20978,5725,383,37,5305,10373,6691416,4467874,1000398,685508,314890,1223144,132513,1090631,165924,133738,32186,587,31599,40328,33408,34515,72
0,0,1,1,20.9,33.9,29.4,15.7,5636761,3961189,1011057,160950,11867,838240,664515,228026,24720,17372,4434,706,52,3676,2914,3231516,2389118,545682,380673,165009,296716,18434,278282,96673,75871,20802,337,20465,33427,31489,13598,3
0,0,2,2,12.9,30.1,29.5,27.4,17164320,7788669,2498548,101921,12401,2384226,6877103,367912,46653,21170,6791,277,34,6480,18692,8867609,6302264,1375726,941709,434017,1189619,4965,1184654,221889,172376,49513,236,49277,39964,36561,24041,38
0,0,2,2,22.3,32.7,29.9,15.1,6979638,4074786,1443621,132326,15094,1296201,1461231,241965,28846,16840,5966,547,62,5357,6039,3444455,2463624,613489,439592,173897,367342,38876,328466,97208,74170,23038,266,22772,35434,33216,14424,10
0,0,2,2,17.7,32.5,28.6,21.1,20767776,11154712,3096368,199676,19031,2877661,6516696,555029,37417,20098,5579,360,34,5185,11741,12569198,8612840,1931486,1333225,598261,2024872,15518,2009354,300554,233888,66666,625,66041,41820,36825,30426,39
0,0,1,1,22.4,36.8,27.7,13.1,11955274,7211379,2686778,187326,20471,2478981,2057117,421844,28341,17095,6369,444,49,5877,4876,4407407,3093285,773891,555815,218076,540231,3382,536849,138966,101288,37678,943,36735,31716,30540,14614,27
0,0,2,2,18,32.3,32.1,17.6,14851177,8350913,3052332,225666,21939,2804727,3447932,486297,30539,17172,6277,464,45,5768,7090,7748369,5499032,1352316,963210,389106,897021,27951,869070,225053,176921,48132,930,47202,34429,31082,18412,37
0,0,1,1,11.3,24.4,33.3,31,15017540,11067338,1545851,147872,22094,1375885,2404351,406840,36913,27203,3800,363,54,3382,5910,9299348,7089475,1537440,1037224,500216,672433,3660,668773,226633,183751,42882,285,42597,41033,38582,15700,99
0,0,2,2,13.7,28.9,33.9,23.6,17623694,10903676,3181753,205469,24426,2951858,3538265,529907,33258,20577,6004,388,46,5571,6677,11913814,8897809,2027462,1401914,625548,988543,13091,975452,272273,223540,48733,420,48313,43757,39804,20190,314
0,0,2,2,25.2,33.7,26.1,14.9,16064215,9918474,3083654,344659,27514,2711481,3062087,547373,29348,18120,5634,630,50,4954,5594,10340531,7402477,1803521,1282694,520827,1134533,99706,1034827,266193,221296,44897,2108,42789,38846,33451,24184,19
0,0,1,1,17.3,29.1,31.7,21.9,29084893,19770996,3848512,493741,54446,3300325,5465385,828988,35085,23850,4642,596,66,3981,6593,28380349,21463273,5031060,3488896,1542164,1886016,16212,1869804,580607,511056,69551,301,69250,48880,41998,27001,33
0,0,1,1,16,29.7,31.4,22.9,35616883,20865352,5888429,403003,54831,5430595,8863102,929426,38321,22450,6336,434,59,5843,9536,23430957,17436450,4030912,2815231,1215681,1963595,-73,1963668,566828,471514,95314,78,95236,41337,36980,20619,161
0,0,1,1,18.2,25.8,29.9,26.1,33275582,23769749,4327171,624204,58129,3644838,5178662,1053341,31591,22566,4108,593,55,3460,4916,35622016,27850406,5827134,3912076,1915058,1944476,18182,1926294,815356,705166,110190,579,109611,43689,39495,17574,112
0,0,1,1,19.2,26.7,29,25.1,40149791,28273143,5262427,670187,64865,4527375,6614221,1143154,35122,24733,4603,586,57,3960,5786,36527839,27264754,6105572,4198735,1906837,3157513,90187,3067326,796165,681655,114510,2235,112275,45880,39998,27320,97
0,0,1,1,16.4,26.9,29,27.7,69272114,32616758,7681202,535327,76291,7069584,28974154,1278380,54187,25514,6009,419,60,5530,22665,35084656,25007138,5224542,3543569,1680973,4852976,220820,4632156,766983,606284,160699,734,159965,45744,41247,28957,294
0,0,0,0,20.1,28.7,28.8,22.3,641627431,380739925,98486302,9786500,919026,87780776,162401204,17842038,35962,21339,5520,549,52,4920,9102,425117211,309874331,71150914,49534424,21616490,44091966,1488435,42603531,10067189,8163188,1904001,35397,1868604,42228,37960,22800,0
0,0,8,7,43.8,32.6,15.3,8.4,35057,18403,11391,1902,128,9361,5263,1858,18868,9905,6131,1024,69,5038,2833,11184,6306,2110,1708,402,2768,1697,1071,479,293,186,62,124,23349,21522,8637,0
0,0,9,12,33.9,40.3,19.3,6.5,62254,36889,18460,1527,181,16752,6905,2763,22531,13351,6681,553,66,6063,2499,15407,8508,2898,2324,574,4001,128,3873,750,409,341,85,256,20543,20802,15129,0
0,0,8,7,38.7,33.9,18.3,9.1,58121,35088,12361,2218,189,9954,10672,2576,22562,13621,4799,861,73,3864,4143,28636,16005,4342,3317,1025,8289,6025,2264,782,588,194,92,102,36619,27219,22196,0
0,0,3,2,33,34.2,24,8.8,167581,103500,41777,6234,370,35173,22304,8068,20771,12828,5178,773,46,4360,2765,57397,36192,10335,8014,2321,10870,3491,7379,2123,1544,579,103,476,27036,23440,15502,1
0,0,8,7,34.5,33.8,20.1,11.7,126054,73015,34856,6153,414,28289,18183,6256,20149,11671,5572,984,66,4522,2906,69828,37823,12369,10024,2345,19636,15629,4007,2213,1688,525,104,421,31554,22407,9518,0
0,0,9,8,43.7,36,13.5,6.9,174799,116147,42151,7421,446,34284,16501,8096,21591,14346,5206,917,55,4235,2038,100723,54412,15080,11158,3922,31231,25104,6127,2642,2020,622,167,455,38124,26937,13466,0
0,0,7,9,38.2,39.7,13.7,8.5,135857,79449,41019,6224,472,34323,15389,6679,20341,11895,6141,932,71,5139,2304,48610,29240,8545,6605,1940,10825,5027,5798,1912,1251,661,145,516,25424,23373,11236,0
0,0,6,6,38,32.9,18.4,10.8,191922,115646,51905,9003,495,42407,24371,8510,22553,13589,6099,1058,58,4983,2864,110337,74560,21193,15205,5988,14584,7492,7092,3765,2856,909,213,696,29306,26106,10190,0
0,0,6,6,37.6,32.5,20.4,9.5,171246,96136,49212,9485,500,39227,25898,7707,22220,12474,6385,1231,65,5090,3360,98052,63181,18462,14159,4303,16409,11695,4714,3077,2505,572,137,435,31866,25222,10837,0
0,0,9,12,24.9,33.4,24.2,17.4,275031,128599,76266,3711,502,72053,70166,9940,27669,12938,7673,373,51,7249,7059,148120,89667,23816,17598,6218,34637,2566,32071,5572,3761,1811,109,1702,26583,23841,18843,0
0,0,8,6,35.2,40.3,16.6,7.9,157288,89761,37861,6785,514,30562,29666,6906,22776,12998,5482,982,74,4425,4296,40684,26943,7495,5561,1934,6246,1335,4911,1581,905,676,134,542,25733,29771,9061,0
0,0,7,9,43.1,29.3,17.5,10.2,237226,143442,65622,8471,523,56628,28162,10158,23354,14121,6460,834,51,5575,2772,128421,80418,21658,16201,5457,26345,13563,12782,4554,3280,1274,244,1030,28200,24518,12410,0
0,0,9,8,37.6,39.4,15.2,7.8,181850,107597,53910,8291,531,45088,20343,9516,19110,11307,5665,871,56,4738,2138,80787,53631,16310,12528,3782,10846,2226,8620,3006,2146,860,252,608,26875,24991,14178,0
0,0,6,6,32.1,36.8,22.5,8.6,223534,127275,62214,9384,540,52290,34045,8905,25102,14293,6986,1054,61,5872,3823,113663,66664,17503,12921,4582,29496,20846,8650,3628,2603,1025,161,864,31329,25610,10012,0
0,0,3,2,25.7,41.6,26.8,5.8,234118,155524,44051,7366,572,36113,34543,11677,20049,13319,3772,631,49,3093,2958,44494,22758,7920,6387,1533,13816,3429,10387,1496,1014,482,66,416,29742,22444,24969,0
0,0,9,11,28.6,39.4,18.6,13.5,193157,119480,45813,6414,576,38823,27864,8997,21469,13280,5092,713,64,4315,3097,84006,53872,14295,10548,3747,15839,8367,7472,2890,1999,891,206,685,29068,26949,10908,0
0,0,6,6,26.6,36.2,24.3,12.9,261618,169181,54108,7090,588,46430,38329,10890,24024,15535,4969,651,54,4264,3520,139555,90529,23432,17367,6065,25594,15558,10036,4241,3178,1063,164,899,32906,28486,11164,0
0,0,8,7,29,36.3,24.6,10.1,202395,128679,46468,5998,613,39857,27248,8274,24462,15552,5616,725,74,4817,3293,63124,40751,11589,8732,2857,10784,1087,9697,2567,1703,864,178,686,24591,23929,14136,0
0,0,7,9,32.3,44,17.1,6.6,228922,140489,63311,7523,615,55173,25122,10552,21695,13314,6000,713,58,5229,2381,152536,101774,27041,19774,7267,23721,13999,9722,4957,3976,981,274,707,30772,25597,13751,0
0,0,8,7,42.9,34.7,14.4,8,136485,79134,40209,6211,620,33378,17142,6153,22182,12861,6535,1009,101,5425,2786,61144,43923,11447,8313,3134,5774,2106,3668,2075,1586,489,159,330,29467,27694,11115,1
0,0,7,8,32.3,38.5,19.4,9.9,237636,149649,59252,8310,629,50313,28735,9779,24301,15303,6059,850,64,5145,2938,120048,67445,20338,15523,4815,32265,19578,12687,3536,2580,956,323,633,33950,26141,20043,0
0,0,1,1,34,41.7,17,7.3,252610,173149,53751,7570,644,45537,25710,11350,22256,15255,4736,667,57,4012,2265,124440,81137,22845,16934,5911,20458,5389,15069,3137,2181,956,173,783,39668,37202,19245,5
0,0,3,2,28.8,37.8,22.2,11.1,261943,154458,61574,7961,670,52943,45911,12408,21111,12448,4962,642,54,4267,3700,94733,59551,17303,13238,4065,17879,391,17488,3833,2626,1207,44,1163,24715,22677,15037,0
0,0,1,1,30.3,37.2,21,11.5,345398,224886,64781,8286,739,55756,55731,12985,26600,17319,4989,638,57,4294,4292,136502,87990,22644,16557,6087,25868,5410,20458,4809,3003,1806,251,1555,28385,29301,13156,1
0,0,3,2,35.5,32.8,21,10.7,258617,153914,62737,13094,753,48890,41966,10134,25520,15188,6191,1292,74,4824,4141,120368,70641,19425,14568,4857,30302,19297,11005,3669,2792,877,216,661,32807,25301,16649,0
0,0,6,6,32.3,38.7,18.5,10.5,217445,130019,58250,9710,762,47778,29176,9245,23520,14064,6301,1050,82,5168,3156,111818,70557,18639,13627,5012,22622,16219,6403,3988,2959,1029,242,787,28039,23845,8136,0
0,0,6,6,31.6,33.5,22.4,12.6,310956,186736,76878,14686,768,61424,47342,11749,26467,15894,6543,1250,65,5228,4029,249262,173091,42044,30462,11582,34127,26239,7888,6011,4866,1145,332,813,41468,35572,9702,0
0,0,6,6,35,35.9,17.1,12,246872,129439,66855,8390,770,57695,50578,10553,23394,12266,6335,795,73,5467,4793,151483,97091,26699,19951,6748,27693,12276,15417,4967,3793,1174,306,868,30498,25597,17762,0
0,0,3,2,27.9,37.4,19,15.6,357369,252516,60923,7079,797,53047,43930,13699,26087,18433,4447,517,58,3872,3207,107848,49101,13414,10155,3259,45333,31630,13703,3330,2027,1303,374,929,32387,24223,14750,0
0,0,7,9,36.4,40.1,15.2,8.3,263349,138816,83263,10680,813,71770,41270,15070,17475,9211,5525,709,54,4762,2739,167778,117260,33827,25191,8636,16691,7686,9005,6299,5225,1074,267,807,26636,22442,11159,0
0,0,8,7,34.6,38.3,18.4,8.6,422985,297384,72443,8539,816,63088,53158,16683,25354,17826,4342,512,49,3782,3186,181051,94673,23162,16368,6794,63216,35884,27332,5823,4205,1618,501,1117,31092,22514,24469,1
0,0,3,2,32.7,39.6,20.8,6.8,318088,222320,60477,8084,846,51547,35291,12875,24706,17268,4697,628,66,4004,2741,68306,42154,11307,8587,2720,14845,6350,8495,2354,1666,688,159,529,29017,25303,16059,0
0,0,3,2,32.5,37.1,19.1,11.3,393965,244155,94169,13639,860,79670,55641,16124,24433,15142,5840,846,53,4941,3451,153853,86779,23224,17287,5937,43850,35267,8583,4650,3519,1131,388,743,33087,24660,11552,1
0,0,6,6,34,34.6,22,9.4,433873,280234,93791,12839,864,80088,59848,17735,24464,15801,5288,724,49,4516,3375,238645,152062,42152,31337,10815,44431,29769,14662,7144,5473,1671,394,1277,33405,27784,11482,0
0,0,9,10,24.6,35,22.7,17.6,454372,241583,95084,6549,870,87665,117705,15934,28516,15161,5967,411,55,5502,7387,262227,183760,42459,29042,13417,36008,3898,32110,8734,6678,2056,113,1943,30024,27517,16526,2
0,0,6,6,28.3,35.8,23.5,12.5,329883,204911,73233,8944,894,63395,51739,12127,27202,16897,6039,738,74,5228,4266,175552,120198,38904,30995,7909,16450,6734,9716,5160,3946,1214,257,957,34022,30461,10153,1
0,0,7,9,36.7,35.4,18.5,9.4,309916,189151,78208,9911,897,67400,42557,13729,22574,13777,5697,722,65,4909,3100,192164,134713,34008,24277,9731,23443,7501,15942,6408,4985,1423,208,1215,29988,27024,13121,0
0,0,6,6,33.1,38.6,18.1,10.2,317274,187461,86035,13921,904,71210,43778,15065,21060,12443,5711,924,60,4727,2906,171761,111138,30196,22293,7903,30427,15926,14501,5798,4314,1484,339,1145,29624,25762,12665,0
0,0,2,2,33,30.4,25.8,10.9,387248,263408,76635,6978,928,68729,47205,16188,23922,16272,4734,431,57,4246,2916,162839,103592,26421,18741,7680,32826,3103,29723,5797,4012,1785,229,1556,28090,25821,19102,1
0,0,6,4,26,37.1,18.2,18.7,539134,348306,82619,9133,949,72537,108209,16925,31854,20579,4881,540,56,4286,6393,305856,206695,48955,34663,14292,50206,15637,34569,9679,6895,2784,522,2262,31600,29978,15282,0
0,0,6,6,35.4,36,20.4,8.1,375562,237167,94160,13058,969,80133,44235,16567,22669,14316,5684,788,58,4837,2670,201101,126737,34111,25447,8664,40253,27346,12907,6394,5133,1261,215,1046,31452,24691,12339,0
0,0,3,2,27.5,47.4,18.8,6.2,357286,234519,83743,11589,975,71179,39024,16535,21608,14183,5065,701,59,4305,2360,113259,59802,17627,13562,4065,35830,2368,33462,3807,2336,1471,214,1257,29750,25600,26621,0
0,0,1,1,20.5,33.2,28.2,18.1,616601,455924,70871,6687,998,63186,89806,19611,31442,23248,3614,341,51,3222,4579,292630,181786,42603,29558,13045,68241,13654,54587,9785,6744,3041,187,2854,29906,26955,19126,4
0,0,6,5,30.2,41.2,18.5,10.1,404636,251292,104193,12021,999,91173,49151,17179,23554,14628,6065,700,58,5307,2861,177661,120274,29960,21685,8275,27427,6627,20800,6275,4510,1765,375,1390,28313,26668,14964,1
0,0,9,12,25.8,35.1,26.5,12.5,535919,286565,132936,7666,1006,124264,116418,19856,26990,14432,6695,386,51,6258,5863,277672,175497,45457,33684,11773,56718,2303,54415,9861,6335,3526,259,3267,28159,27703,16656,0
0,0,1,1,24.7,40.1,21.2,14,427438,303507,72551,7110,1013,64428,51380,15908,26869,19079,4561,447,64,4050,3230,107099,60568,16946,12807,4139,29585,1447,28138,4604,2388,2216,322,1894,23262,25363,14856,0
0,0,7,8,34.2,37.2,19.1,9.5,425270,250403,112589,15508,1064,96017,62278,17243,24663,14522,6530,899,62,5568,3612,354675,251321,70139,50936,19203,33215,8874,24341,10207,8654,1553,180,1373,34748,29041,17728,0
0,0,1,1,28.7,37,23,11.3,412425,267533,90230,9830,1100,79300,54662,16961,24316,15773,5320,580,65,4675,3223,162538,104677,28574,21239,7335,29287,9708,19579,5225,3709,1516,226,1290,31108,28222,15178,0
0,0,6,6,29.9,33.3,19.2,17.6,460192,252787,97126,12427,1111,83588,110279,15499,29692,16310,6267,802,72,5393,7115,246547,159263,36264,25658,10606,51020,11371,39649,7317,5300,2017,213,1804,33695,30050,21978,0
0,0,6,6,36.8,35.2,18,10,295908,184186,76566,12499,1113,62954,35156,14241,20779,12934,5376,878,78,4421,2469,204660,125739,32018,23423,8595,46903,32409,14494,5445,4368,1077,289,788,37587,28786,18393,1
0,0,7,9,32.7,37.2,21.7,8.4,391222,238930,103953,12516,1223,90214,48339,17769,22017,13446,5850,704,69,5077,2720,308610,219488,62731,47789,14942,26391,12986,13405,8563,6761,1802,453,1349,36040,32464,9937,0
0,0,8,7,24,35.1,25.4,15.4,614144,384116,123944,10173,1226,112545,106084,24690,24874,15558,5020,412,50,4558,4297,288079,181960,48013,35765,12248,58106,11722,46384,10170,6702,3468,282,3186,28326,27150,14559,3
0,0,8,4,29.1,38.9,21.6,10.4,531346,301062,143308,10290,1229,131789,86976,22174,23963,13577,6463,464,55,5943,3922,252422,148120,36777,26260,10517,67525,2528,64997,9666,5710,3956,203,3753,26114,25940,17319,4
0,0,7,9,33.7,36.6,18.1,11.6,461946,286378,107594,15233,1230,91131,67974,20550,22479,13936,5236,741,60,4435,3308,247652,169619,51440,40172,11268,26593,9876,16717,8163,6690,1473,398,1075,30338,25354,15551,0
0,0,6,6,30.6,39.7,19.1,10.6,586092,380854,123563,20440,1277,101846,81675,24031,24389,15848,5142,851,53,4238,3399,290653,176471,45848,33860,11988,68334,28016,40318,8847,6823,2024,401,1623,32853,25864,24842,0
0,0,1,1,30.2,39.9,21.3,8.6,549475,377788,105904,11902,1290,92712,65783,22055,24914,17129,4802,540,58,4204,2983,263946,185485,47630,34630,13000,30831,2622,28209,8624,6336,2288,135,2153,30606,29275,13102,4
0,0,6,4,24.5,40.5,20.5,14.4,580331,356981,107389,12253,1296,93840,115961,20012,28999,17838,5366,612,65,4689,5795,336062,218873,58576,43323,15253,58613,5653,52960,9956,7509,2447,188,2259,33755,29148,23444,3
0,0,7,9,31.7,38.8,18.9,10.5,492390,264213,117159,17704,1311,98144,111018,20155,24430,13109,5813,878,65,4869,5508,349008,256490,67662,50248,17414,24856,7917,16939,10022,8322,1700,371,1329,34824,30821,12746,1
0,0,6,4,28,30.4,23.9,17.6,651336,430843,104689,9870,1350,93469,115804,25884,25164,16645,4045,381,52,3611,4474,325520,212571,57735,42793,14942,55214,9085,46129,10119,7038,3081,229,2852,32169,30203,16174,8
0,0,3,2,31.7,38.1,21.6,8.6,550625,366899,112600,18332,1351,92917,71126,21670,25410,16931,5196,846,62,4288,3282,181457,104004,26939,20066,6873,50514,34448,16066,5918,4086,1832,422,1410,30662,25454,11394,1
0,0,1,1,29.8,33.1,21.4,15.6,882312,574912,143078,10297,1360,131421,164322,27277,32346,21077,5245,377,50,4818,6024,358709,227056,55018,38908,16110,76635,10348,66287,11409,7288,4121,264,3857,31441,31155,17186,1
0,0,6,6,41.5,34,15.5,9.1,382290,218239,112169,19594,1369,91206,51882,16924,22589,12895,6628,1158,81,5389,3066,248180,171785,45201,33374,11827,31194,15856,15338,7529,5904,1625,300,1325,32963,29096,11576,1
0,0,8,7,33,37.5,19.2,10.3,561733,356766,127308,12637,1369,113302,77659,21725,25857,16422,5860,582,63,5215,3575,389848,232971,57127,40199,16928,99750,56090,43660,11403,8199,3204,738,2466,34188,28415,17705,1
0,0,6,6,34.7,35.4,20.8,9.1,561082,356550,130139,23967,1377,104795,74393,23363,24016,15261,5570,1026,59,4486,3184,376948,224124,62368,46778,15590,90456,56121,34335,11662,9842,1820,376,1444,32323,22772,23778,0
0,0,6,5,39.6,34.6,18.1,7.7,537752,339558,134815,15143,1386,118286,63379,25506,21083,13313,5286,594,54,4638,2485,299985,211645,58490,43228,15262,29850,4476,25374,9668,7605,2063,277,1786,31029,27830,14207,0
0,0,3,2,13.3,23.4,23.5,39.8,1128487,832409,94442,7458,1389,85595,201636,28616,39436,29089,3300,261,49,2991,7046,456472,286376,67338,47943,19395,102758,13302,89456,14003,9716,4287,344,3943,32598,29475,22687,7
0,0,6,6,33.7,39.2,19.2,7.9,524184,341664,115355,16021,1395,97939,67165,23165,22628,14749,4980,692,60,4228,2899,289480,155239,47525,37760,9765,86716,66680,20036,8643,6445,2198,536,1662,33493,24087,12055,0
0,0,2,2,21,32.8,26.8,19.3,923230,682809,104050,10521,1424,92105,136371,26557,34764,25711,3918,396,54,3468,5135,272924,167288,42824,31285,11539,62812,3068,59744,9137,5849,3288,64,3224,29870,28601,18531,2
0,0,6,4,34,33.3,19.8,12.9,646893,409744,140391,11251,1469,127671,96758,26808,24131,15284,5237,420,55,4762,3609,393717,242091,61645,44572,17073,89981,32555,57426,12422,9155,3267,313,2954,31695,26444,19440,0
0,0,3,2,22.3,38.7,21.9,17.1,704208,486429,115573,12340,1483,101750,102206,24080,29245,20201,4800,512,62,4225,4244,285645,189672,52634,39851,12783,43339,8022,35317,8580,6335,2245,181,2064,33292,29940,17111,0
0,0,2,2,21,29.4,28.4,21.1,924491,651482,116269,10805,1483,103981,156740,28170,32818,23127,4127,384,53,3691,5564,193605,119247,31828,23825,8003,42530,-545,43075,8879,5297,3582,289,3293,21805,22512,13081,0
0,0,3,2,18.7,35.9,28.5,17,756468,573393,87824,11248,1532,75044,95251,26505,28541,21633,3313,424,58,2831,3594,252582,151532,38229,27569,10660,62821,13231,49590,7723,5552,2171,149,2022,32705,27293,24525,0
0,0,3,2,22.1,41,21.8,15,729975,523530,114228,13521,1533,99174,92217,27189,26848,19255,4201,497,56,3648,3392,160011,102758,27265,20311,6954,29988,1787,28201,5744,3873,1871,174,1697,27857,26532,16618,0
0,0,6,5,34.1,34.5,18.6,12.8,511382,302853,135049,23236,1551,110262,73480,22456,22773,13487,6014,1035,69,4910,3272,366686,250498,62983,45285,17698,53205,20089,33116,11549,9609,1940,187,1753,31750,26069,18891,0
0,0,3,2,29.2,40.8,19.1,10.9,713328,502975,133795,14852,1570,117373,76558,27123,26300,18544,4933,548,58,4327,2823,223519,115677,32057,24111,7946,75785,39430,36355,7427,4269,3158,675,2483,30095,27097,14642,2
0,0,1,1,37,36.1,17.9,9,689228,448793,156074,16694,1587,137793,84361,27987,24627,16036,5577,596,57,4923,3014,316848,216468,56941,41389,15552,43439,7835,35604,10027,7143,2884,314,2570,31599,30305,13854,0
0,0,6,6,32.8,39.2,18.1,9.8,499357,298931,121658,15482,1619,104557,78768,20593,24249,14516,5908,752,79,5077,3825,316254,212067,57941,42860,15081,46246,7382,38864,9750,7548,2202,427,1775,32436,28096,21895,1
0,0,1,1,34.2,35.7,19.3,10.8,529304,327262,136909,20542,1693,114674,65133,22587,23434,14489,6061,909,75,5077,2884,251080,174669,48186,35642,12544,28225,3990,24235,8282,6009,2273,341,1932,30316,29068,12544,2
0,0,7,8,28.9,35.9,21.2,14.1,611052,372189,154890,15641,1743,137506,83973,25332,24122,14692,6114,617,69,5428,3315,420529,298714,74133,52898,21235,47682,6966,40716,12924,10166,2758,188,2570,32539,29384,15843,6
0,0,6,6,28.9,36.9,20.7,13.5,597633,372107,135033,13507,1755,119771,90493,24376,24517,15265,5540,554,72,4913,3712,346897,222054,57640,41411,16229,67203,27189,40014,10129,7706,2423,551,1872,34248,28816,21375,0
0,0,6,5,30.3,33.5,24,12.1,719299,451780,161439,27242,1758,132439,106080,27511,26146,16422,5868,990,64,4814,3856,475991,297145,82056,61907,20149,96790,59645,37145,14447,11414,3033,316,2717,32947,26033,13671,1
0,0,2,2,35.1,37,18.3,9.5,519912,322492,138687,25701,1763,111223,58733,22939,22665,14059,6046,1120,77,4849,2560,341870,234403,67123,51426,15697,40344,19571,20773,8496,6569,1927,413,1514,40239,35683,13721,1
0,0,2,2,33.3,35.2,19.8,11.7,596871,381422,120858,18955,1783,100120,94591,21419,27866,17808,5643,885,83,4674,4416,374619,256259,63816,45785,18031,54544,8358,46186,10916,8838,2078,215,1863,34318,28995,24791,1
0,0,6,5,26.6,33.2,23.4,16.8,651607,412094,130118,20423,1805,107890,109395,24756,26321,16646,5256,825,73,4358,4419,362996,247217,70316,52783,17533,45463,16229,29234,11116,8379,2737,178,2559,32655,29504,11424,1
0,0,6,5,29.9,37.1,21.5,11.6,693374,449957,156839,20082,1816,134941,86578,28522,24310,15776,5499,704,64,4731,3035,444013,308726,83323,62101,21222,51964,11131,40833,12239,9720,2519,289,2230,36279,31762,18311,2
0,0,6,3,33.3,37.2,18,11.5,659645,401739,165949,20027,1882,144040,91957,27440,24040,14641,6048,730,69,5249,3351,343385,237809,61800,45357,16443,43776,5120,38656,10712,8677,2035,285,1750,32056,27407,22089,0
0,0,7,11,32.7,35,19.7,12.7,639677,380590,167472,25431,1895,140146,91615,26539,24103,14341,6310,958,71,5281,3452,430085,299405,75859,54424,21435,54821,22553,32268,14785,11757,3028,307,2721,29089,25466,11859,0
0,0,6,5,29.1,33.7,21.3,15.8,992731,621703,184265,14794,2022,167449,186763,39155,25354,15878,4706,378,52,4277,4770,670918,441628,124135,93374,30761,105155,42843,62312,19909,15631,4278,369,3909,33699,28253,15941,1
0,0,4,8,29.7,38.8,20.2,11.4,859644,468081,270329,29779,2117,238433,121234,35011,24554,13370,7721,851,60,6810,3463,677204,489299,131458,91273,40185,56447,10794,45653,19742,17014,2728,261,2467,34303,28759,18505,2
0,0,3,2,38.9,35.4,18.5,7.2,881719,639921,158946,21353,2187,135406,82852,39723,22197,16110,4001,538,55,3409,2086,529772,394902,92264,63348,28916,42606,7687,34919,15371,12980,2391,271,2120,34466,30424,16471,0
0,0,4,3,16.7,33.2,34.1,16,1212485,825122,164194,21414,2255,140525,223169,46673,25978,17679,3518,459,48,3011,4782,943730,691038,220950,167681,53269,31742,310,31432,23605,20209,3396,44,3352,39980,34195,9377,2
0,0,6,5,30.1,30.2,20.4,19.3,820645,487373,191703,34634,2290,154779,141569,32622,25156,14940,5876,1062,70,4745,4340,560928,383845,106452,79797,26655,70631,31070,39561,16162,13624,2538,339,2199,34707,28174,17990,1
0,0,7,8,35.2,33,21.8,10,937632,613481,202640,31135,2295,169210,121511,39829,23541,15403,5088,782,58,4248,3051,735611,515402,133313,96185,37128,86896,43229,43667,22325,18652,3673,565,3108,32950,27633,14050,1
0,0,2,2,21.1,40.4,24.8,13.6,1322213,1023651,166831,18422,2341,146068,131731,45729,28914,22385,3648,403,51,3194,2881,442953,307431,77241,56662,20579,58281,2368,55913,13276,9276,4000,179,3821,33365,33143,14633,0
0,0,6,5,35.1,35.8,17.7,11.4,1043734,659634,239563,37503,2350,199710,144537,42993,24277,15343,5572,872,55,4645,3362,634547,407781,108007,80415,27592,118759,73025,45734,19008,16055,2953,530,2423,33383,25399,18875,1
0,0,4,5,32.1,30.3,22,15.6,1036167,671030,206748,30323,2374,174051,158389,38789,26713,17299,5330,782,61,4487,4083,889204,643402,164282,119999,44283,81520,27430,54090,26896,22426,4470,337,4133,33061,28690,13087,3
0,0,4,5,26.5,33.6,23.2,16.8,1328297,813903,285060,35488,2435,247137,229334,43556,30496,18686,6545,815,56,5674,5265,1042981,771213,176475,122967,53508,95293,19962,75331,28920,24658,4262,420,3842,36064,31276,19607,2
0,0,4,5,27.4,35.4,21,16.2,1106213,647940,289470,28563,2561,258346,168803,46304,23890,13993,6252,617,55,5579,3646,782160,559068,167755,130915,36840,55337,1075,54262,24269,20543,3726,159,3567,32229,27215,15212,0
0,0,6,6,31.9,35.5,20.8,11.7,1452179,1058614,219832,23487,2752,193593,173733,50607,28695,20918,4344,464,54,3825,3433,884547,583652,139597,98501,41096,161298,88513,72785,25852,18888,6964,789,6175,34216,30901,11787,10
0,0,6,5,29.7,37.1,18.8,14.4,1236590,782919,272475,40157,2855,229463,181196,46751,26451,16747,5828,859,61,4908,3876,897690,653158,165834,119699,46135,78698,13037,65661,25523,21382,4141,603,3538,35172,30547,18559,3
0,0,6,5,34.1,34.1,21.2,10.6,1380248,1006126,230553,26908,2944,200701,143569,50602,27277,19883,4556,532,58,3966,2837,1098874,724852,166699,114147,52552,207323,25390,181933,28320,23425,4895,737,4158,38802,30944,43755,2
0,0,6,3,36.7,35.1,20.2,8,939429,603899,224624,23821,2950,197853,110906,39860,23568,15151,5635,598,74,4964,2782,512899,363621,92592,66896,25696,56686,10669,46017,15862,12449,3413,345,3068,32335,29209,14999,0
0,0,4,5,22.1,29.7,22.8,25.4,1474360,967615,260282,36455,3272,220555,246463,63048,23385,15347,4128,578,52,3498,3909,936052,652584,177726,133552,44174,105742,35779,69963,29869,24147,5722,571,5151,31339,27025,13582,1
0,0,1,1,26.7,36,26.4,10.9,1502414,1113891,216765,26914,3294,186557,171758,57889,25953,19242,3744,465,57,3223,2967,705108,497548,114875,80703,34172,92685,16132,76553,22455,15856,6599,405,6194,31401,31379,12359,2
0,0,2,2,24,34.8,27.4,13.8,1536040,1124760,258092,23088,3510,231494,153188,59745,25710,18826,4320,386,59,3875,2564,697744,466477,110334,77101,33233,120933,6564,114369,21137,15980,5157,246,4911,33011,29191,23288,3
0,0,2,2,33.2,35,21.7,10.2,1578203,1048330,350150,32796,3771,313583,179723,65160,24220,16089,5374,503,58,4813,2758,694431,449631,123009,90793,32216,121791,16468,105323,22047,15367,6680,509,6171,31498,29260,17067,5
0,0,3,2,17.8,29.3,29.2,23.8,2653601,1552062,396866,40469,4143,352254,704673,72589,36557,21382,5467,558,57,4853,9708,1918936,1338800,319700,227530,92170,260436,-193,260629,48723,40648,8075,40,8035,39385,32936,32437,1
0,0,1,1,26.5,35.6,24.8,13,2145101,1573919,301586,33989,4153,263444,269596,73696,29107,21357,4092,461,56,3575,3658,934955,620784,148393,103929,44464,165778,12126,153652,26931,19983,6948,474,6474,34717,31066,23734,11
0,0,3,2,13.2,34.2,38,14.5,1523407,941209,220911,38907,4558,177446,361287,64718,23539,14543,3413,601,70,2742,5582,1808165,1305376,467568,360425,107143,35221,278,34943,35797,32608,3189,56,3133,50512,40032,11153,1
0,0,1,1,32.2,34.7,20.6,12.5,1579468,1018909,333330,47844,4700,280786,227229,61091,25854,16679,5456,783,77,4596,3720,1031688,765600,195665,141264,54401,70423,440,69983,31188,25718,5470,274,5196,33080,29769,13469,7
0,0,4,3,27,33.7,21.3,18,1749204,1103864,345143,46049,4747,294347,300197,63233,27663,17457,5458,728,75,4655,4747,1479660,1131791,271095,189136,81959,76774,1033,75741,39192,33454,5738,228,5510,37754,33831,13746,10
0,0,3,2,22.3,30.6,27.4,19.7,2693174,1753666,470412,62411,4869,403132,469096,98273,27405,17845,4787,635,50,4102,4773,2211213,1583338,434515,319140,115375,193360,6628,186732,63146,54107,9039,412,8627,35017,29263,21645,3
0,0,3,2,37,29,21.1,12.8,2668157,1851038,401543,48001,4993,348549,415576,94162,28336,19658,4264,510,53,3702,4413,3027814,2290298,495673,328598,167075,241843,11832,230011,73818,66233,7585,397,7188,41017,34579,31999,9
0,0,1,1,17.6,29.4,29.7,23.4,2272929,1662727,313766,37874,5203,270689,296436,78086,29108,21294,4018,485,67,3467,3796,1592093,1227693,269100,182697,86403,95300,1088,94212,43712,35179,8533,105,8428,36422,34898,11178,21
0,0,1,1,7.6,24,32.2,36.2,4344629,3253185,359847,21278,5552,333017,731597,101961,42611,31906,3529,209,54,3266,7175,2030461,1440961,322622,221728,100894,266878,767,266111,53672,40424,13248,156,13092,37831,35646,20326,13
0,0,1,1,25.3,34.7,25.4,14.5,2197633,1598911,350890,49787,5730,295373,247832,85647,25659,18669,4097,581,67,3449,2894,1051164,746772,185607,133536,52071,118785,2177,116608,30401,21511,8890,281,8609,34577,34716,13545,2
0,0,1,1,28.2,34.2,23.5,14.1,2505062,1801490,391433,45054,5891,340488,312139,90334,27731,19943,4333,499,65,3769,3455,1629362,1173354,287143,203544,83599,168865,22157,146708,44693,35709,8984,462,8522,36457,32859,17215,5
0,0,3,2,28.5,33.2,22.4,15.8,2627080,1630286,570887,55937,6016,508934,425907,94332,27849,17282,6052,593,64,5395,4515,1941938,1412819,332310,233035,99275,196809,10239,186570,51414,43396,8018,521,7497,37771,32556,24886,6
0,0,3,2,19,21.6,19.6,39.8,2762390,1765848,407523,55038,6193,346292,589019,109536,25219,16121,3720,502,57,3161,5377,3117936,2329873,626764,472022,154742,161299,2461,158838,78943,68764,10179,88,10091,39496,33882,15741,14
0,0,1,1,18.4,32.8,28.2,20.6,3341541,2477731,390727,42332,6197,342198,473083,108371,30834,22863,3605,391,57,3158,4365,1377648,1026026,246852,174710,72142,104770,1318,103452,44312,32542,11770,393,11377,31090,31529,9093,10
0,0,2,2,12.1,25.8,30.2,32,3709934,2736513,385630,31024,6261,348345,587791,106477,34843,25701,3622,291,59,3272,5520,1350528,921841,210311,146061,64250,218376,1639,216737,41980,29967,12013,167,11846,32171,30762,18296,14
0,0,1,1,19.2,39.1,26.5,15.2,2943144,2338456,324571,34575,6293,283703,280117,113132,26015,20670,2869,306,56,2508,2476,832694,563669,139250,99971,39279,129775,3908,125867,28575,18913,9662,189,9473,29141,29803,13287,0
0,0,1,1,28.9,34.2,20.3,16.5,2747247,1842627,464726,55227,6369,403130,439894,102526,26796,17972,4533,539,62,3932,4291,1695139,1222235,303311,218187,85124,169593,30244,139349,50115,38366,11749,914,10835,33825,31857,12861,4
0,0,3,2,26.3,28.3,27.6,17.8,2490587,1501435,566770,104603,6485,455682,422382,94610,26325,15870,5991,1106,69,4816,4464,2473484,1884630,469277,338805,130472,119577,9350,110227,62867,55584,7283,115,7168,39345,33906,15378,3
0,0,1,1,14.3,23.5,27.6,34.6,5784002,4731746,333013,20819,6495,305699,719243,137643,42022,34377,2419,151,47,2221,5225,3325378,2124513,422200,275385,146815,778665,11798,766867,68406,52191,16215,334,15881,48612,40707,48288,35
0,0,3,2,15.7,32.4,32.2,19.8,3967088,2635983,547458,66041,7316,474101,783647,126201,31435,20887,4338,523,58,3757,6210,3198149,2332430,695911,525235,170676,169808,6873,162935,70194,60089,10105,283,9822,45562,38816,16589,5
0,0,1,1,18.9,34.6,27.3,19.2,3230435,2489469,408405,51710,7695,349000,332561,113354,28499,21962,3603,456,68,3079,2934,1653987,1207209,275381,189319,86062,171397,-365,171762,53336,40679,12657,123,12534,31011,29676,13704,17
0,0,3,2,29.5,29.6,22.2,18.7,4929725,3435386,658920,66902,8397,583621,835419,160979,30623,21341,4093,416,52,3625,5190,3657361,2643051,575677,400896,174781,438633,40523,398110,89023,72899,16124,707,15417,41083,36256,25823,22
0,0,1,1,15.6,27.3,30.2,27,6548758,5255459,527915,40290,9471,478154,765384,182128,35957,28856,2899,221,52,2625,4202,2591161,1555454,341620,233533,108087,694087,4545,689542,73218,46823,26395,435,25960,35390,33220,26562,35
0,0,3,2,22.8,31.7,24.2,21.3,4778755,2972217,948362,136981,10025,801356,858176,154003,31030,19300,6158,889,65,5204,5572,4262910,3209999,735779,510802,224977,317132,1068,316064,109092,92247,16845,121,16724,39076,34798,18899,12
0,0,1,1,15.8,34.3,30.4,19.5,4866001,3721031,560195,63576,10733,485886,584775,169607,28690,21939,3303,375,63,2865,3448,2117872,1487356,353716,249988,103728,276800,2428,274372,66708,46025,20683,307,20376,31748,32316,13465,11
0,0,2,2,19.8,26.9,28.3,25,8165848,5257350,1254359,144979,14047,1095333,1654139,242242,33709,21703,5178,598,58,4522,6828,6869348,5180754,1209874,839516,370358,478720,1304,477416,168092,144710,23382,33,23349,40867,35801,20447,14
0,0,2,2,21.1,28.2,30.4,20.3,6049268,3440349,1043101,154225,14064,874812,1565818,186543,32428,18443,5592,827,75,4690,8394,4850927,3660713,912373,656586,255787,277841,-513,278354,120634,107793,12841,54,12787,40212,33961,21769,9
0,0,1,1,19.9,31.9,31.5,16.6,6047539,4457527,965863,180683,21535,763645,624149,256292,23596,17392,3769,705,84,2980,2435,6222594,4828107,1190216,835416,354800,204271,-243,204514,141416,119616,21800,48,21752,44002,40363,9402,1
0,0,2,2,22,29.6,29.7,18.7,5487413,3269936,1170980,174982,28790,967208,1046497,195837,28020,16697,5979,894,147,4939,5344,5762967,4300865,1176298,868206,308092,285804,588,285216,134258,120082,14176,129,14047,42925,35816,20304,2
0,0,1,1,11.2,20.8,28.3,39.8,27670009,21769123,2050493,209975,40787,1799731,3850393,646754,42783,33659,3170,325,63,2783,5953,21246748,15138197,2914309,1869943,1044366,3194242,0,3194242,419697,332488,87209,129,87080,50624,45530,36682,125
0,0,1,1,12.7,22,31.2,34.1,24134790,19521599,1833613,230423,42856,1560334,2779578,710978,33946,27457,2579,324,60,2195,3910,19735832,14625737,2819283,1806982,1012301,2290812,1728,2289084,432672,335698,96974,192,96782,45614,43568,23652,228
0,0,1,1,14.9,20.3,28.4,36.3,23597308,16994999,2534305,387276,52073,2094956,4068004,668998,35273,25404,3788,579,78,3131,6081,18574870,14003902,2933208,1957693,975515,1637760,-156,1637916,400574,316930,83644,31,83613,46371,44186,19589,162
0,0,1,1,16,19.4,23.3,41.4,50414207,35770023,3496771,525246,62102,2909423,11147413,818737,61576,43689,4271,642,76,3554,13615,62869254,44037494,8276451,5384885,2891566,10555309,85,10555224,907198,785830,121368,205,121163,69300,56039,87116,291
0,0,5,8,16.7,29.7,34.1,19.4,2027093,1348022,304135,30486,4513,269136,374936,62863,32246,21444,4838,485,72,4281,5964,1505975,996441,245692,169653,76039,263842,-5042,268884,40960,31154,9806,475,9331,36767,31984,28816,3
0,0,5,8,15.4,31.4,31.1,22.1,4855304,3074831,858871,126456,13955,718460,921602,168237,28860,18277,5105,752,83,4271,5478,3426785,2263825,581353,409524,171829,581607,30260,551347,95409,69342,26067,2847,23220,35917,32647,23744,4
0,0,2,2,15.2,27.8,29.2,27.9,35767141,24865036,3999608,493636,64693,3441279,6902497,918181,38954,27081,4356,538,70,3748,7518,27887151,19394664,5413134,3903215,1509919,3079353,16106,3063247,587533,500001,87532,579,86953,47465,38789,35229,32
0,0,9,12,15.5,41.4,31.1,12,124452,76397,28066,1540,381,26145,19989,4226,29449,18078,6641,364,90,6187,4730,69515,31355,8795,6402,2393,29365,20619,8746,2273,1349,924,476,448,30583,23243,19522,0
0,0,9,12,17.2,44.4,25,13.4,133383,75165,31811,2036,396,29379,26407,5304,25148,14171,5998,384,75,5539,4979,69880,36730,10657,7766,2891,22493,12983,9510,2794,1560,1234,605,629,25011,23545,15119,0
0,0,9,10,16.7,46.6,24.7,12,181066,118355,36680,2344,413,33923,26031,6534,27711,18114,5614,359,63,5192,3984,101819,47872,13430,9813,3617,40517,30930,9587,3442,2053,1389,654,735,29581,23318,13044,0
0,0,8,6,21.3,38.3,26.1,14.2,360242,259269,49590,2782,436,46372,51383,11677,30851,22203,4247,238,37,3971,4400,221441,91161,25324,18582,6742,104956,72497,32459,6180,3804,2376,815,1561,35832,23965,20794,2
0,0,9,10,13.4,39.9,31.8,15,244256,160075,47862,2421,453,44988,36319,7835,31175,20431,6109,309,58,5742,4635,155917,66441,18811,13775,5036,70665,53482,17183,4230,2734,1496,592,904,36860,24302,19008,0
0,0,8,6,15,42.4,28.7,14,247925,161180,45855,2956,464,42435,40890,7616,32553,21163,6021,388,61,5572,5369,182799,109288,29572,20851,8721,43939,31550,12389,4903,3668,1235,392,843,37283,29795,14696,0
0,0,9,12,16.1,45.9,25.9,12.1,163978,95583,40166,2913,496,36757,28229,6494,25251,14719,6185,449,76,5660,4347,83522,43270,13602,10213,3389,26650,14435,12215,3489,2030,1459,668,791,23939,21315,15442,0
0,0,7,9,18.9,37.6,30,13.4,222831,162938,31107,1594,611,28902,28786,6743,33046,24164,4613,236,91,4286,4269,156340,64327,17266,12336,4930,74747,52567,22180,3700,2511,1189,492,697,42254,25618,31822,0
0,0,8,7,15,43.2,28.1,13.6,252114,171104,40138,2145,654,37339,40872,7369,34213,23219,5447,291,89,5067,5546,202313,105612,28638,20436,8202,68063,34772,33291,5037,3684,1353,482,871,40165,28668,38222,1
0,0,9,10,14.6,38.1,31.9,15.4,326311,208600,64556,3171,664,60721,53155,10228,31904,20395,6312,310,65,5937,5197,181841,83012,23047,16845,6202,75782,47264,28518,5524,3500,2024,664,1360,32918,23718,20969,0
0,0,7,9,13.7,38.4,32.6,15.4,313251,198512,55469,3201,695,51573,59270,10033,31222,19786,5529,319,69,5140,5908,192558,109968,31262,22688,8574,51328,32471,18857,6021,4233,1788,502,1286,31981,25979,14663,2
0,0,8,7,17.5,44.8,25.5,12.3,207366,136155,34912,2043,695,32174,36299,6324,32790,21530,5521,323,110,5088,5740,119491,49122,13573,9833,3740,56796,42100,14696,3424,2062,1362,537,825,34898,23823,17813,0
0,0,9,12,18.3,41.5,25.1,15.1,189582,114051,48887,4225,727,43935,26644,8618,21998,13234,5673,490,84,5098,3092,97671,57205,16130,11543,4587,24336,12437,11899,4425,2730,1695,623,1072,22073,20954,11100,0
0,0,8,7,12.2,48.4,28.2,11.2,229531,151416,40045,2126,742,37177,38070,7932,28937,19089,5049,268,94,4687,4800,139570,81018,21522,15224,6298,37030,19220,17810,4716,3164,1552,642,910,29595,25606,19571,0
0,0,2,2,16.8,36.6,30.3,16.3,562111,357374,140805,4899,752,135154,63932,14905,37713,23977,9447,329,50,9068,4289,203448,120761,33328,24295,9033,49359,25527,23832,6216,4285,1931,382,1549,32730,28182,15385,0
0,0,7,9,16.3,35,34.8,13.9,305969,204555,55030,3087,840,51103,46384,9702,31537,21084,5672,318,87,5267,4781,208879,96794,27270,19592,7678,84815,62537,22278,5694,3946,1748,637,1111,36684,24530,20052,0
0,0,7,11,20.7,43,23.7,12.6,294363,190720,50161,2836,859,46466,53482,9760,30160,19541,5139,291,88,4761,5480,217743,122130,37922,27931,9991,57691,33773,23918,6795,4655,2140,735,1405,32045,26236,17023,0
0,0,7,9,15.6,44.5,27.1,12.8,313140,205048,53426,2482,870,50074,54666,10800,28994,18986,4947,230,81,4636,5062,200288,100979,26522,18412,8110,72787,40749,32038,5840,3906,1934,706,1228,34296,25852,26090,0
0,0,9,10,15.8,43,27.6,13.6,339861,215623,62561,3326,907,58328,61677,10716,31715,20122,5838,310,85,5443,5756,191751,87543,23273,16437,6836,80935,52770,28165,5657,3655,2002,632,1370,33896,23952,20558,0
0,0,9,10,17.3,46.3,24.6,11.8,188670,115913,42443,3136,939,38368,30314,7638,24701,15176,5557,411,123,5023,3969,96018,56157,16479,11912,4567,23382,14626,8756,3886,2230,1656,676,980,24709,25183,8935,0
0,0,6,6,14.4,42.3,28.7,14.6,306921,184974,57664,3448,988,53228,64283,9800,31318,18875,5884,352,101,5431,6559,176487,92184,27101,20003,7098,57202,36264,20938,5327,3580,1747,605,1142,33131,25750,18335,1
0,0,6,6,13.4,45.9,25.3,15.3,381155,241484,70902,3774,1004,66124,68769,12547,30378,19246,5651,301,80,5270,5481,237718,135564,37612,27177,10435,64542,38115,26427,7465,5480,1985,708,1277,31844,24738,20695,1
0,0,7,9,17.8,44.3,25.4,12.6,218957,137546,45676,3119,1004,41553,35735,7955,27524,17291,5742,392,126,5224,4492,161495,113183,27188,18596,8592,21124,5580,15544,4715,3349,1366,568,798,34251,33796,19479,0
0,0,3,2,13.5,38.3,31,17.2,418498,285950,60785,2576,1010,57199,71763,12406,33734,23049,4900,208,81,4611,5785,222095,123193,31220,21247,9973,67682,42268,25414,6163,4212,1951,605,1346,36037,29248,18881,3
0,0,6,6,20.9,44.5,23.5,11.1,246147,151259,52197,4383,1059,46755,42691,9462,26014,15986,5516,463,112,4941,4512,152372,97536,26150,18752,7398,28686,6183,22503,5018,3544,1474,605,869,30365,27521,25895,0
0,0,2,2,14.6,44.9,25.6,14.9,387962,268448,61442,3581,1062,56799,58072,11249,34489,23864,5462,318,94,5049,5162,184988,86490,22709,16142,6567,75789,29437,46352,5613,3209,2404,772,1632,32957,26952,28402,42
0,0,2,2,15,44.1,28.2,12.7,465419,317358,89817,5561,1083,83173,58244,15362,30297,20659,5847,362,70,5414,3791,189185,107159,28482,20240,8242,53544,31379,22165,6624,4234,2390,670,1720,28561,25309,12887,0
0,0,7,11,14.5,39.3,29.6,16.6,464680,278378,102702,6507,1090,95105,83600,16274,28554,17106,6311,400,67,5844,5137,287657,176349,49646,35394,14252,61662,33342,28320,8873,6808,2065,674,1391,32419,25903,20359,8
0,0,8,5,20.3,41,26,12.7,327645,224737,52769,4713,1102,46954,50139,11862,27621,18946,4449,397,93,3958,4227,173113,109694,28964,20735,8229,34455,15612,18843,5734,4086,1648,508,1140,30191,26846,16529,3
0,0,6,6,18.3,42.9,25.4,13.4,270391,165606,63024,3739,1140,58145,41761,9566,28266,17312,6588,391,119,6078,4366,148381,80820,21778,15410,6368,45783,31022,14761,5026,3436,1590,515,1075,29523,23522,13731,0
0,0,9,8,14,39.6,33.7,12.7,218926,148029,36947,2088,1170,33689,33950,7742,28278,19120,4772,270,151,4351,4385,100613,49611,14090,9984,4106,36912,21856,15056,3454,2054,1400,522,878,29129,24153,17148,0
0,0,9,9,21.1,41.4,26.1,11.4,199501,129595,41983,3010,1183,37790,27923,8583,23244,15099,4891,351,138,4403,3253,97097,52604,15579,11421,4158,28914,-184,29098,4113,2252,1861,799,1062,23607,23359,27399,1
0,0,7,9,19.3,39,27,14.7,475717,308232,87206,4430,1187,81589,80279,14552,32691,21181,5993,304,82,5607,5517,291291,149897,40024,28869,11155,101370,72635,28735,8835,6397,2438,767,1671,32970,23432,17196,0
0,0,7,11,16.3,39.8,27.9,16,681442,444279,113081,5837,1223,106021,124082,20973,32491,21183,5392,278,58,5055,5916,530382,334500,83504,58323,25181,112378,54714,57664,16394,12717,3677,821,2856,32352,26303,20190,0
0,0,7,9,15.6,39.1,31.8,13.5,480709,296551,84166,4943,1240,77983,99992,13717,35045,21619,6136,360,90,5685,7290,320635,172222,47498,33416,14082,100915,64246,36669,8356,6169,2187,594,1593,38372,27917,23019,1
0,0,6,6,18.2,40.7,28.3,12.9,330069,204026,69745,5058,1253,63434,56298,11214,29434,18194,6219,451,112,5657,5020,227423,142289,39965,27804,12161,45169,25947,19222,6957,5358,1599,455,1144,32690,26556,16802,0
0,0,7,9,16,38.6,30.9,14.5,333152,222803,56014,3436,1268,51310,54335,10766,30945,20695,5203,319,118,4766,5047,218373,112045,30169,21455,8714,76159,56194,19965,5962,4100,1862,692,1170,36627,27328,17064,3
0,0,6,6,12.7,40.4,29.4,17.5,530353,352767,83304,5013,1269,77022,94282,16261,32615,21694,5123,308,78,4737,5798,388237,241731,74816,56464,18352,71690,42491,29199,10832,8425,2407,664,1743,35842,28692,16752,2
0,0,6,6,15.6,43,29.3,12.1,239999,160439,47507,3878,1273,42356,32053,9180,26144,17477,5175,422,139,4614,3492,180903,110139,29190,20373,8817,41574,19088,22486,5898,4338,1560,591,969,30672,25389,23205,0
0,0,7,9,17.8,36,33.1,13,296853,191237,61973,3183,1333,57457,43643,10527,28199,18166,5887,302,127,5458,4146,195361,120721,33441,23450,9991,41199,23133,18066,6232,4530,1702,420,1282,31348,26649,14092,0
0,0,6,6,21.5,42.8,23.4,12.4,498216,341024,83447,6445,1385,75617,73745,16920,29445,20155,4932,381,82,4469,4358,382962,219556,58415,39478,18937,104991,65313,39678,10285,7860,2425,735,1690,37235,27933,23478,2
0,0,6,6,12.5,42.7,29.6,15.2,430341,294388,69663,3506,1421,64736,66290,12380,34761,23779,5627,283,115,5229,5355,316878,150098,40096,28467,11629,126684,61317,65367,7687,5709,1978,672,1306,41223,26291,50051,2
0,0,8,7,16,46.3,26.1,11.6,302733,193424,58668,4142,1445,53081,50641,10881,27822,17776,5392,381,133,4878,4654,130491,66551,18488,13271,5217,45452,22445,23007,5061,2811,2250,901,1349,25784,23675,17055,2
0,0,7,8,18.7,36.2,26.5,18.7,572724,384212,94984,7260,1463,86261,93528,19970,28679,19239,4756,364,73,4320,4683,446843,271651,69953,49262,20691,105239,57575,47664,13224,10646,2578,704,1874,33790,25517,25434,1
0,0,7,9,18.6,41.2,28.1,12.2,327266,191763,84748,8256,1514,74978,50755,13453,24327,14254,6300,614,113,5573,3773,202838,134184,38434,27524,10910,30220,6349,23871,7367,5200,2167,635,1532,27533,25805,15582,1
0,0,6,6,12.7,43.2,29.4,14.7,321089,195258,72520,5696,1572,65252,53311,12143,26442,16080,5972,469,129,5374,4390,246050,163172,46595,32815,13780,36283,12028,24255,8177,6224,1953,559,1394,30090,26217,17400,0
0,0,7,9,11.9,31.4,25.4,31.2,477568,274411,73192,7035,1615,64542,129965,16315,29272,16820,4486,431,99,3956,7966,347831,237039,61260,41618,19642,49532,13863,35669,11297,8069,3228,637,2591,30790,29377,13766,2
0,0,6,6,12.3,41.9,29.6,16.3,577349,398549,75551,4258,1645,69648,103249,18213,31700,21883,4148,234,90,3824,5669,236028,140158,38209,27460,10749,57661,18016,39645,8355,5566,2789,787,2002,28250,25181,19803,1
0,0,7,9,14.2,38.6,31.8,15.4,383880,273407,58586,3032,1661,53893,51887,11834,32439,23104,4951,256,140,4554,4385,351435,222434,66408,48794,17614,62593,40813,21780,9429,7419,2010,717,1293,37272,29982,16845,0
0,0,7,11,14.4,38.9,33.1,13.6,527848,345213,93765,5366,1672,86727,88870,16287,32409,21196,5757,329,103,5325,5456,356132,178265,46806,32908,13898,131061,87478,43583,10244,6786,3458,1081,2377,34765,26270,18335,3
0,0,6,6,14.3,37,31.5,17.1,587666,382543,103521,5843,1715,95963,101602,17974,32695,21283,5759,325,95,5339,5653,407746,219378,57967,40571,17396,130401,74432,55969,10965,7905,3060,710,2350,37186,27752,23817,1
0,0,6,6,18.6,44.3,22.7,14.4,398320,260015,73011,4722,1757,66532,65294,14371,27717,18093,5080,329,122,4630,4543,255415,143206,40744,29306,11438,71465,30145,41320,8712,5935,2777,885,1892,29318,24129,21839,0
0,0,2,2,12.4,41,32.2,14.4,478347,344764,65811,3800,1772,60239,67772,14918,32065,23111,4412,255,119,4038,4543,180088,101156,26697,18815,7882,52235,17498,34737,6592,3949,2643,812,1831,27319,25616,18972,0
0,0,7,9,12.7,38,32.8,16.5,306211,196272,57726,3443,1806,52477,52213,11340,27003,17308,5090,304,159,4628,4604,222781,133013,37838,27429,10409,51930,21039,30891,7524,5427,2097,517,1580,29609,24509,19551,0
0,0,6,6,16.6,45.3,26,12.2,364781,236340,66125,3866,1873,60386,62316,12561,29041,18815,5264,308,149,4807,4961,218683,117352,31809,22270,9539,69522,32921,36601,6953,4649,2304,824,1480,31452,25242,24730,1
0,0,7,8,12,36.8,34.9,16.3,531000,350029,86225,5745,1935,78545,94746,16848,31517,20776,5118,341,115,4662,5624,430421,270900,69201,48500,20701,90320,48281,42039,12002,9490,2512,573,1939,35862,28546,21681,0
0,0,6,6,14.1,40.4,28.8,16.6,414773,251628,87008,5785,1955,79268,76137,14002,29622,17971,6214,413,140,5661,5438,270880,160144,44785,31719,13066,65951,38796,27155,8817,6475,2342,615,1727,30722,24733,15724,0
0,0,6,6,19.6,33.6,26.9,19.8,1009397,721781,128841,6962,1968,119911,158775,32726,30844,22055,3937,213,60,3664,4852,882583,501291,131970,93612,38358,249322,172973,76349,24161,19230,4931,1282,3649,36529,26068,20923,5
0,0,3,2,17.5,39.1,27,16.4,685482,453230,105603,6725,1980,96898,126649,21350,32107,21229,4946,315,93,4539,5932,338194,190458,52046,36938,15108,95690,38859,56831,11692,7552,4140,916,3224,28925,25220,17627,2
0,0,6,6,12.6,39.1,29,19.3,847767,602475,111125,6102,1991,103032,134167,24980,33938,24118,4449,244,80,4125,5371,570835,349883,83541,56800,26741,137411,89993,47418,14893,11022,3871,1156,2715,38329,31744,17465,4
0,0,8,7,17.8,41.4,28.3,12.4,460198,312860,81990,4238,2005,75747,65348,14965,30752,20906,5479,283,134,5062,4367,208407,90448,25022,17881,7141,92937,54623,38314,6731,3796,2935,955,1980,30962,23827,19351,0
0,0,8,6,13,42.1,29.2,15.8,548731,376958,72698,3817,2018,66863,99075,16297,33671,23131,4461,234,124,4103,6079,465488,310791,94625,69932,24693,60072,24291,35781,13229,10369,2860,886,1974,35187,29973,18126,6
0,0,6,5,11,38.2,32,18.8,876229,560555,160895,7989,2073,150833,154779,26500,33065,21153,6072,301,78,5692,5841,471158,319082,85424,57797,27627,66652,25873,40779,13766,10403,3363,643,2720,34226,30672,14992,4
0,0,7,8,17.4,41.2,24.9,16.5,640390,429655,108125,9749,2158,96218,102610,22454,28520,19135,4815,434,96,4285,4570,379282,241173,63268,44433,18835,74841,34714,40127,11541,8612,2929,792,2137,32864,28004,18777,5
0,0,3,2,12.3,37.6,28.5,21.5,753121,504769,113142,4932,2174,106036,135210,23833,31600,21179,4747,207,91,4449,5673,441533,290653,75306,52208,23098,75574,31118,44456,13856,10135,3721,812,2909,31866,28678,15282,6
0,0,6,6,14.9,47.2,24.8,13,482567,323354,76436,5424,2258,68754,82777,17955,26876,18009,4257,302,126,3829,4610,292359,175241,49203,34877,14326,67915,30134,37781,9745,6541,3204,1147,2057,30001,26791,18367,3
0,0,3,2,14.7,42.3,30.3,12.7,545313,359900,96473,5761,2269,88443,88940,20605,26465,17467,4682,280,110,4292,4316,277061,176985,48750,34534,14216,51326,18357,32969,9630,6976,2654,834,1820,28771,25371,18115,1
0,0,7,11,15.9,37.3,26.3,20.5,638896,428290,91156,4470,2408,84278,119450,21060,30337,20337,4328,212,114,4002,5672,484345,311974,80338,55036,25302,92033,36242,55791,15696,11648,4048,1216,2832,30858,26783,19700,1
0,0,7,9,14.1,40.9,30.3,14.8,481127,288996,101558,6322,2453,92783,90573,16520,29124,17494,6148,383,148,5616,5483,277224,167368,47633,34580,13053,62223,33023,29200,9061,6466,2595,751,1844,30595,25884,15835,0
0,0,7,9,13.3,42.5,25.7,18.5,595528,396127,93961,5537,2472,85952,105440,19002,31340,20847,4945,291,130,4523,5549,474183,322202,79532,53902,25630,72449,30231,42218,13390,10582,2808,746,2062,35413,30448,20474,2
0,0,6,6,15.8,40.8,30.5,12.9,523195,348170,88847,5544,2509,80794,86178,18197,28752,19133,4883,305,138,4440,4736,263910,144207,38415,27606,10809,81288,49133,32155,8601,5630,2971,968,2003,30684,25614,16053,4
0,0,7,9,13.9,39.7,30.3,16.2,576137,388540,94078,6877,2603,84598,93519,20354,28306,19089,4622,338,128,4156,4595,491663,351029,90026,61902,28124,50608,16518,34090,14143,11287,2856,692,2164,34764,31100,15753,2
0,0,6,6,15.4,43.6,28.3,12.7,609418,405559,99662,6523,2618,90521,104197,20831,29255,19469,4784,313,126,4345,5002,322556,183421,49859,35006,14853,89276,35226,54050,10481,7054,3427,926,2501,30775,26002,21611,3
0,0,6,6,15.2,43.7,27.2,13.8,554801,342591,124589,8871,2676,113042,87621,21426,25894,15989,5815,414,125,5276,4089,338624,195737,53882,38164,15718,89005,51609,37396,11662,8235,3427,1133,2294,29037,23769,16302,0
0,0,7,8,10.8,35.3,32.6,21.3,611037,366167,92665,4289,2705,85671,152205,16644,36712,22000,5567,258,163,5147,9145,399581,253023,70615,50553,20062,75943,18739,57204,13206,9900,3306,415,2891,30258,25558,19787,9
0,0,6,6,16,40.6,24.5,18.9,991684,666025,147561,9041,2849,135671,178098,32774,30258,20322,4502,276,87,4140,5434,838632,616898,153018,105203,47815,68716,22595,46121,23213,18786,4427,817,3610,36128,32838,12776,13
0,0,6,6,18.5,44.7,24.7,12.1,549296,346790,106288,7990,2965,95333,96218,20124,27296,17233,5282,397,147,4737,4781,254417,155969,44920,32187,12733,53528,18156,35372,10606,6860,3746,1038,2708,23988,22736,13062,3
0,0,8,7,17.4,45.6,24.2,12.8,516479,321921,98250,5949,3314,88987,96308,18269,28271,17621,5378,326,181,4871,5272,299562,178373,47977,32625,15352,73212,33343,39869,10694,6882,3812,1333,2479,28012,25919,16083,3
0,0,5,8,15.8,36.8,30.5,16.9,1127869,724979,221207,16881,3327,200999,181683,38562,29248,18800,5736,438,86,5212,4711,891512,625363,159489,110459,49030,106660,47114,59546,24465,20178,4287,831,3456,36440,30992,17230,2
0,0,3,2,12.2,43.4,30.5,13.9,792574,567232,113579,7209,3433,102937,111763,26265,30176,21596,4324,274,131,3919,4255,302996,169396,46129,33045,13084,87471,38274,49197,10076,6263,3813,968,2845,30071,27047,17292,0
0,0,2,2,10,37.8,31,21.2,1400988,1051058,165857,9922,3717,152218,184073,43339,32326,24252,3827,229,86,3512,4247,438408,271081,69380,47978,21402,97947,13230,84717,16072,10071,6001,1031,4970,27278,26917,17046,7
0,0,4,5,19.7,34.5,28.6,17.2,1368931,870772,188599,17537,3754,167308,309560,41894,32676,20785,4502,419,90,3994,7389,1129781,874225,202872,135327,67545,52684,4931,47753,28130,23940,4190,656,3534,40163,36517,13512,15
0,0,2,2,10.5,32.7,30.1,26.8,1953714,1479517,164128,11091,3812,149225,310069,53042,36833,27893,3094,209,72,2813,5846,1242832,879133,191705,124209,67496,171994,33725,138269,31883,25496,6387,724,5663,38981,34481,24416,8
0,0,3,2,6.5,21.3,27.7,44.5,2553133,1733994,263106,15783,3954,243369,556033,82884,30804,20921,3174,190,48,2936,6709,2088997,1480303,436428,326504,109924,172266,43909,128357,58150,48812,9338,777,8561,35924,30327,14993,46
0,0,4,5,17.7,37.2,28,17,1178075,753979,230408,17595,4788,208025,193688,39646,29715,19018,5812,444,121,5247,4885,869154,613816,153693,106473,47220,101645,36855,64790,23679,19754,3925,692,3233,36706,31073,20040,22
0,0,4,5,14.4,41.5,29.7,14.4,1425738,925496,290551,23602,5070,261879,209691,49475,28817,18706,5873,477,102,5293,4238,980719,699631,180194,122919,57275,100894,14704,86190,29227,23824,5403,1025,4378,33555,29367,19687,2
0,0,5,8,18.5,39.9,27.1,14.6,954569,578631,232809,22165,5323,205321,143129,35855,26623,16138,6493,618,148,5726,3992,686903,502904,129836,89420,40416,54163,5312,48851,20839,17404,3435,654,2781,32962,28896,17566,6
0,0,6,5,13.2,44.8,26.1,15.9,1107812,757841,175582,11389,5655,158538,174389,37482,29556,20219,4684,304,151,4230,4653,674058,442389,128002,92429,35573,103667,51602,52065,17804,13552,4252,934,3318,37860,32644,15692,7
0,0,2,2,16,39.3,29.7,15,2745179,1927867,466267,42666,5700,417901,351045,90198,30435,21374,5169,473,63,4633,3892,1685003,1217920,291983,192076,99907,175100,54909,120191,48105,39629,8476,890,7586,35028,30733,15844,5
0,0,5,8,14.2,39.3,30.5,16,1192857,741280,244614,21330,5771,217513,206963,40332,29576,18379,6065,529,143,5393,5131,980088,701349,184416,124224,60192,94323,13629,80694,26916,22863,4053,501,3552,36413,30676,22718,5
0,0,5,8,16.4,42.7,28.3,12.5,991254,602105,207683,17847,5838,183998,181466,36364,27259,16558,5711,491,161,5060,4990,769574,563747,147583,98429,49154,58244,11458,46786,21140,17599,3541,731,2810,36404,32033,16650,1
0,0,5,8,12.7,33.3,33.7,20.3,1586164,1080531,257987,15764,5879,236344,247646,44741,35452,24151,5766,352,131,5282,5535,1328297,846554,205297,137027,68270,276446,50110,226336,33613,28157,5456,624,4832,39517,30065,46841,1
0,0,3,2,6.3,19.8,26.3,47.6,4173074,2977108,346324,28955,7634,309735,849642,120300,34689,24747,2879,241,63,2575,7063,3795451,2689804,784149,581392,202757,321498,18474,303024,97459,83630,13829,1032,12797,38944,32163,23679,32
0,0,3,2,14.8,40.2,23.7,21.3,2716339,1743178,437689,31028,11532,395129,535472,90769,29926,19205,4822,342,127,4353,5899,2279498,1753420,425033,287573,137460,101045,40291,60754,65285,55085,10200,1217,8983,34916,31831,6763,16
0,0,3,2,18.6,35,27.5,18.9,3387457,2417838,482755,49471,11906,421378,486864,100589,33676,24037,4799,492,118,4189,4840,2723813,1603743,394385,267696,126689,725685,54547,671138,63317,53540,9777,943,8834,43019,29954,75972,14
0,0,3,2,13.5,35.1,28.4,23,3808996,2481636,677639,61978,14357,601304,649721,127021,29987,19537,5335,488,113,4734,5115,3326312,2487914,603913,410643,193270,234485,30022,204463,87292,75586,11706,725,10981,38106,32915,18620,23
0,0,2,2,13.7,30.7,30.7,24.9,5700906,3931993,749910,78236,14619,657055,1019003,158543,35958,24801,4730,493,92,4144,6427,4243201,3057850,705514,465233,240281,479837,8895,470942,109248,93110,16138,627,15511,38840,32841,30362,23
0,0,3,2,9.4,30.3,32.5,27.7,7058492,4998545,889548,71538,24097,793913,1170399,200395,35223,24943,4439,357,120,3962,5840,6246120,4751641,1095083,726689,368394,399396,22076,377320,145011,123579,21432,1167,20265,43073,38450,18619,81
0,0,2,2,11.7,29.5,29.1,29.7,15679903,11446010,1610983,145588,45836,1419559,2622910,399030,39295,28685,4037,365,115,3558,6573,15043356,11152710,2446637,1606132,840505,1444009,16042,1427967,321683,275352,46331,574,45757,46765,40503,31208,84
0,0,8,7,13.6,31.8,39.7,15,95634,61840,20038,1518,112,18408,13756,4137,23117,14948,4844,367,27,4450,3325,42610,23569,7512,5499,2013,11529,5441,6088,1980,1122,858,391,467,21520,21006,13036,2
0,0,2,2,32.4,34.6,22.8,10.2,254263,170212,45307,4980,168,40159,38744,10993,23130,15484,4121,453,15,3653,3524,131173,67265,17778,11856,5922,46130,29968,16162,4236,2677,1559,537,1022,30966,25127,15814,3
0,0,8,7,15.8,34.7,34.6,14.8,102669,52056,28735,1886,194,26655,21878,3665,28013,14204,7840,515,53,7273,5969,57456,36726,10965,7579,3386,9765,2917,6848,2432,1597,835,189,646,23625,22997,10601,0
0,0,9,12,11.6,31.4,34.8,22.2,30453,20608,3916,182,220,3514,5929,1069,28487,19278,3663,170,206,3287,5546,18626,10522,2741,1867,874,5363,422,4941,646,397,249,91,158,28833,26504,31272,0
0,0,8,7,17.4,33,36.6,13,73458,46580,16427,1086,236,15105,10451,2825,26003,16488,5815,384,84,5347,3699,641671,564586,75756,38788,36968,1329,-1703,3032,9012,8474,538,192,346,71202,66626,8763,0
0,0,3,2,11.8,40,34.7,13.6,265385,189389,43074,4431,238,38405,32922,12079,21971,15679,3566,367,20,3179,2726,129875,78170,23072,16261,6811,28633,14227,14406,5421,3314,2107,689,1418,23958,23588,10159,0
0,0,9,8,12.7,22.6,36.6,28.1,209055,141638,23129,2136,415,20578,44288,7814,26754,18126,2960,273,53,2633,5668,122531,67161,16984,10934,6050,38386,1652,36734,3904,2522,1382,263,1119,31386,26630,32828,0
0,0,7,11,14.5,42.1,31.6,11.7,136825,81354,33612,2083,524,31005,21859,6077,22515,13387,5531,343,86,5102,3597,61714,39122,12902,9046,3856,9690,3900,5790,2837,1727,1110,413,697,21753,22653,8307,1
0,0,9,12,15.5,37.5,29.6,17.4,111373,57786,20105,1060,651,18394,33482,4084,27271,14149,4923,260,159,4504,8198,69677,50640,13865,9532,4333,5172,-927,6099,2679,1690,989,246,743,26009,29964,8209,0
0,0,9,10,22.6,32.8,31.5,13,109550,73552,20687,2036,727,17924,15311,4694,23338,15669,4407,434,155,3818,3262,72979,44003,12213,8346,3867,16763,9122,7641,2289,1595,694,235,459,31882,27588,16647,0
0,0,8,7,19.2,37.4,28.6,14.9,99410,48425,21218,1229,955,19034,29767,3817,26044,12687,5559,322,250,4987,7799,49778,31178,9012,5991,3021,9588,-360,9948,2163,1240,923,269,654,23013,25144,15211,0
0,0,2,2,13.7,32.5,33.9,19.9,196836,133601,28647,2151,980,25516,34588,6981,28196,19138,4104,308,140,3655,4955,63901,41766,12370,8467,3903,9765,100,9665,2724,1701,1023,90,933,23459,24554,10359,1
0,0,6,6,13.4,34.2,36.5,15.9,189714,120194,31845,2091,1032,28722,37675,6963,27246,17262,4573,300,148,4125,5411,177317,123447,33732,23138,10594,20138,13187,6951,4607,3376,1231,400,831,38489,36566,8365,1
0,0,3,2,25.3,32.8,27.6,14.3,178653,121113,31571,3755,1033,26783,25969,7426,24058,16309,4251,506,139,3607,3497,155713,98106,26246,17620,8626,31361,20173,11188,4143,3262,881,303,578,37585,30075,19356,1
0,0,6,6,23.4,35.5,28.4,12.7,245811,139988,57402,5536,1044,50822,48421,9995,24593,14006,5743,554,104,5085,4845,114488,76994,22135,15014,7121,15359,193,15166,4688,3158,1530,516,1014,24422,24381,14957,0
0,0,7,9,27.4,34.7,25.9,12,438098,313505,67161,5899,1113,60149,57432,14614,29978,21452,4596,404,76,4116,3930,325209,170759,40605,25941,14664,113845,97316,16529,8314,6276,2038,608,1430,39116,27208,11559,0
0,0,6,5,11.5,22.3,41.7,24.4,521251,348643,98091,9048,1125,87918,74517,33807,15418,10313,2901,268,33,2601,2204,451940,321984,82792,53823,28969,47164,-1696,48860,17721,14003,3718,390,3328,25503,22994,14681,0
0,0,6,5,19.6,34.6,33.8,12,265682,152741,55733,4976,1445,49312,57208,12610,21069,12113,4420,395,115,3911,4537,113861,78739,23394,16506,6888,11728,-1118,12846,4922,3061,1861,460,1401,23133,25723,9169,0
0,0,8,7,11.1,29.1,33.5,26.3,309778,168943,43260,2606,1529,39125,97575,8779,35286,19244,4928,297,174,4457,11115,191011,123584,32578,21027,11551,34849,-1690,36539,6826,4482,2344,136,2208,27983,27573,16548,0
0,0,7,11,17.5,31.3,33.3,17.9,186892,89743,48104,2813,1582,43709,49045,7708,24246,11643,6241,365,205,5671,6363,101076,68641,20868,14797,6071,11567,-2253,13820,4409,2872,1537,304,1233,22925,23900,11208,0
0,0,7,8,24.9,26.8,34.2,14,497827,350171,80398,9332,1725,69341,67258,19654,25330,17817,4091,475,88,3528,3422,377525,219844,51980,32289,19691,105701,65347,40354,10412,7928,2484,554,1930,36259,27730,20909,0
0,0,3,2,15.6,29.4,39.8,15.2,497198,349349,79302,8188,1863,69251,68547,21674,22940,16118,3659,378,86,3195,3163,231431,139795,38996,26333,12663,52640,21984,30656,9709,6081,3628,753,2875,23837,22989,10663,1
0,0,2,2,20.6,35,33,11.4,372594,218902,84092,6887,1919,75286,69600,16304,22853,13426,5158,422,118,4618,4269,126486,84767,23993,16077,7916,17726,-1692,19418,6246,3550,2696,770,1926,20251,23878,10082,1
0,0,6,6,20.2,41.2,27.2,11.4,221643,126322,53719,4296,1935,47488,41602,9053,24483,13954,5934,475,214,5246,4595,168393,115577,31903,20656,11247,20913,2938,17975,5074,3791,1283,249,1034,33187,30487,17384,0
0,0,6,6,19.9,37.3,29.5,13.4,220081,113373,59139,3790,2029,53320,47569,8659,25416,13093,6830,438,234,6158,5494,135888,89962,27991,19511,8480,17935,862,17073,4472,3254,1218,211,1007,30386,27647,16954,2
0,0,6,5,25.5,32,31.9,10.6,567727,348473,100572,11632,2198,86742,118682,21484,26426,16220,4681,541,102,4038,5524,290539,174148,46076,30006,16070,70315,27810,42505,9238,6428,2810,619,2191,31450,27092,19400,3
0,0,4,5,12.8,25,44.9,17.3,702712,454758,97187,10563,2219,84405,150767,25919,27112,17545,3750,408,86,3256,5817,548598,378571,128914,95295,33619,41113,16739,24374,13678,11216,2462,338,2124,40108,33753,11476,1
0,0,7,8,23.1,29.8,33.2,13.9,568044,382221,93887,10893,2240,80754,91936,21372,26579,17884,4393,510,105,3778,4302,443871,244634,63163,41092,22071,136074,78804,57270,12502,9422,3080,579,2501,35504,25964,22899,1
0,0,7,11,9.8,15.9,31.2,43.1,1273048,622090,58061,3187,2274,52600,592897,20897,60920,29769,2778,153,109,2517,28372,733407,472998,100892,57518,43374,159517,1466,158051,20681,14348,6333,171,6162,35463,32966,25649,7
0,0,4,5,9,22.6,27.4,41,988056,635458,127852,8601,2413,116838,224746,35958,27478,17672,3556,239,67,3249,6250,621442,411498,131510,95456,36054,78434,9646,68788,21272,16166,5106,938,4168,29214,25455,16504,11
0,0,7,11,20,35.9,29.4,14.7,222422,127359,52868,4748,2471,45649,42195,10303,21588,12361,5131,461,240,4431,4095,149542,98278,27559,18292,9267,23705,2092,21613,5378,3712,1666,356,1310,27806,26476,16498,2
0,0,6,6,17.1,38.3,30.2,14.4,357484,180339,89618,5887,2861,80870,87527,15522,23031,11618,5774,379,184,5210,5639,196964,128230,37231,25513,11718,31503,359,31144,7427,4685,2742,674,2068,26520,27370,15060,2
0,0,7,8,26.3,32.7,30.9,10.1,426064,282510,82370,9243,2960,70167,61184,19013,22409,14859,4332,486,156,3690,3218,288665,186150,49073,32346,16727,53442,29474,23968,9335,7100,2235,582,1653,30923,26218,14500,1
0,0,3,2,14.5,31.8,34.8,18.9,1112190,687053,224739,15771,3615,205353,200398,38071,29214,18047,5903,414,95,5394,5264,943904,673381,169824,110165,59659,100699,12045,88654,25931,21779,4152,414,3738,36401,30919,23717,1
0,0,6,5,19.4,31.1,35.1,14.4,965543,643017,185126,20482,4443,160201,137400,43173,22365,14894,4288,474,103,3711,3183,564332,390030,107664,72644,35020,66638,21055,45583,20357,14807,5550,1211,4339,27722,26341,10505,5
0,0,6,7,22.1,40.3,27.3,10.2,318266,154295,99571,7938,4696,86937,64400,12912,24649,11950,7712,615,364,6733,4988,176032,129317,33805,22132,11673,12910,-93,13003,6056,4533,1523,39,1484,29067,28528,8762,2
0,0,6,6,14.4,33.5,35.2,16.9,1054733,592190,192489,14166,5864,172459,270054,39576,26651,14963,4864,358,148,4358,6824,637373,430651,109099,68961,40138,97623,252,97371,21735,14771,6964,665,6299,29325,29155,15458,4
0,0,5,8,18.7,30.4,34.9,16,1899767,1220702,331182,29173,6067,295942,347883,69833,27204,17480,4742,418,87,4238,4982,1390780,902517,233594,151484,82110,254669,84453,170216,44451,34462,9989,1156,8833,31288,26189,19270,1
0,0,3,2,12.5,25.9,36.7,24.9,2046658,1363289,367155,33822,7541,325792,316214,77419,26436,17609,4742,437,97,4208,4084,1465332,1062093,295294,197150,98144,107945,5478,102467,46608,37177,9431,915,8516,31439,28569,12032,6
0,0,3,2,12.2,26.5,35.2,26.1,2956670,1911227,401145,36646,7719,356780,644298,91709,32240,20840,4374,400,84,3890,7025,1951932,1282210,313794,198103,115691,355928,16514,339414,57511,44367,13144,857,12287,33940,28900,27624,42
0,0,3,2,12.7,30.3,38,19.1,3675588,2310830,609533,44775,14422,550336,755225,125972,29178,18344,4839,355,114,4369,5995,2377079,1587414,400783,254013,146770,388882,1453,387429,73502,54684,18818,768,18050,32340,29029,21464,13
0,0,2,2,24,30.3,30.8,14.9,3680827,2457367,712163,83072,17902,611189,511297,163947,22451,14989,4344,507,109,3728,3119,2230871,1548299,387229,243163,144066,295343,40276,255067,74036,53727,20309,2149,18160,30132,28818,14046,108
0,0,2,2,9.2,23.1,36.5,31.2,13093647,8997654,1254579,96740,28121,1129718,2841414,348755,37544,25799,3597,277,81,3239,8147,10987165,7772359,1777753,1115179,662574,1437053,26604,1410449,259256,207744,51512,1277,50235,42380,37413,28077,1308
0,0,7,10,36.7,28.8,25.2,9.2,139314,90570,27456,2117,636,24703,21288,6917,20141,13094,3969,306,92,3571,3078,145234,100128,27646,20785,6861,17460,9627,7833,3757,2942,815,344,471,38657,34034,16631,1
0,0,9,10,24.2,33.1,32.2,10.5,100955,58917,28061,3476,659,23926,13977,4346,23229,13557,6457,800,152,5505,3216,36428,21675,8209,6669,1540,6544,3105,3439,1450,800,650,288,362,25123,27094,9500,0
0,0,1,1,20.1,44.6,25.9,9.4,142243,87378,31340,2029,783,28528,23525,5163,27550,16924,6070,393,152,5525,4556,40085,22648,8229,6667,1562,9208,3696,5512,1887,1005,882,390,492,21243,22535,11203,0
0,0,2,2,16.6,39.1,31,13.4,172502,107037,33766,2457,786,30523,31699,6136,28113,17444,5503,400,128,4974,5166,67456,39585,13064,10077,2987,14807,7023,7784,2350,1406,944,281,663,28705,28154,11741,1
0,0,9,12,17.7,38.9,33.6,9.8,177167,111033,34696,2837,813,31046,31438,6796,26069,16338,5105,417,120,4568,4626,137946,90938,30410,23680,6730,16598,3663,12935,4215,3037,1178,302,876,32727,29943,14766,0
0,0,9,10,31.9,29.1,29.5,9.6,101774,52243,34831,3411,822,30598,14700,4615,22053,11320,7547,739,178,6630,3185,41543,26363,9461,7472,1989,5719,858,4861,1517,1047,470,133,337,27385,25180,14424,0
0,0,8,7,26.4,36.9,29,7.7,145457,80142,42040,4697,838,36505,23275,6030,24122,13291,6972,779,139,6054,3860,73682,46942,13294,9952,3342,13446,2863,10583,2160,1437,723,166,557,34112,32667,19000,1
0,0,8,5,16.2,38,33.8,12.1,189463,127875,28976,1641,860,26475,32612,5977,31699,21395,4848,275,144,4429,5456,129278,94957,22574,16594,5980,11747,597,11150,2672,1925,747,128,619,48382,49328,18013,0
0,0,9,8,16.9,46.6,24.4,12.1,137847,91977,26328,2346,872,23110,19542,5457,25261,16855,4825,430,160,4235,3581,81101,50029,15064,10979,4085,16008,8563,7445,2120,1431,689,266,423,38255,34961,17600,0
0,0,7,9,16.4,46.2,25.7,11.7,209237,141712,38558,3411,1041,34106,28967,7508,27869,18875,5136,454,139,4543,3858,107026,62335,20417,16199,4218,24274,11295,12979,3165,2114,1051,428,623,33815,29487,20833,0
0,0,7,8,25.7,31.9,31.9,10.5,217159,130681,58202,5506,1129,51567,28276,8471,25636,15427,6871,650,133,6087,3338,81314,41097,15789,12847,2942,24428,10011,14417,2955,1676,1279,559,720,27517,24521,20024,0
0,0,9,10,29.3,31.7,32,7.1,152954,83378,52486,7839,1206,43441,17090,6575,23263,12681,7983,1192,183,6607,2599,95407,61317,23159,19207,3952,10931,4500,6431,2766,2030,736,222,514,34493,30205,12512,0
0,0,9,8,17.6,46.3,26.1,10,203617,135846,42006,3478,1220,37308,25765,7786,26152,17447,5395,447,157,4792,3309,60249,30252,11154,9163,1991,18843,10229,8614,2340,1359,981,328,653,25747,22260,13191,0
0,0,9,8,19.8,43,27.1,10.1,296419,204213,55057,5082,1425,48550,37149,11057,26808,18469,4979,460,129,4391,3360,108349,57799,19764,15223,4541,30786,15102,15684,3859,2360,1499,518,981,28077,24491,15988,0
0,0,7,8,33,34.7,25.4,6.9,186295,93276,71238,15465,1468,54305,21781,8914,20899,10464,7992,1735,165,6092,2443,98953,66601,24195,19904,4291,8157,349,7808,2814,2079,735,115,620,35165,32035,12594,0
0,0,3,2,11.7,38.3,29.5,20.5,394157,277228,58369,4543,1541,52285,58560,12556,31392,22079,4649,362,123,4164,4664,113736,58594,20741,16789,3952,34401,12230,22171,4029,2356,1673,297,1376,28229,24870,16113,0
0,0,7,9,17.4,40.6,30.7,11.2,254275,154689,54032,5093,1548,47391,45554,9905,25671,15617,5455,514,156,4785,4599,130687,77454,27982,22734,5248,25251,10125,15126,4337,2630,1707,693,1014,30133,29450,14917,1
0,0,2,2,15,40.2,30.3,14.5,387353,255022,73649,4940,1588,67121,58682,12952,29907,19690,5686,381,123,5182,4531,167556,112125,33890,25083,8807,21541,8021,13520,5315,3870,1445,399,1046,31525,28973,12925,3
0,0,7,10,32.9,27.8,27.6,11.7,255301,148912,65868,6468,1616,57784,40521,12816,19920,11619,5140,505,126,4509,3162,107159,66412,25497,21323,4174,15250,4111,11139,3880,2263,1617,500,1117,27618,29347,9972,1
0,0,6,6,21.2,38,26.1,14.7,531732,394740,79959,5022,1667,73270,57033,14587,36452,27061,5482,344,114,5023,3910,317857,128716,36315,26492,9823,152826,13923,138903,6267,4510,1757,408,1349,50719,28540,102967,23
0,0,3,2,14,42,30.1,13.9,460863,317165,78787,5193,1752,71842,64911,14092,32704,22507,5591,369,124,5098,4606,245463,144511,44275,33629,10646,56677,21444,35233,7084,5073,2011,412,1599,34650,28486,22034,0
0,0,3,2,11.3,37.2,30.4,21,565820,411092,78341,4617,1825,71899,76387,16649,33985,24692,4705,277,110,4319,4588,172248,103741,33900,26556,7344,34607,13284,21323,5912,3805,2107,371,1736,29135,27264,12283,4
0,0,6,6,20,44.3,23.1,12.6,365400,238731,72379,6721,1852,63806,54290,13670,26730,17464,5295,492,135,4668,3971,266616,179400,55023,40557,14466,32193,13598,18595,7997,6352,1645,344,1301,33340,28243,14293,0
0,0,6,6,17.8,30.9,38.8,12.5,351259,220540,71100,6363,1856,62881,59619,12451,28211,17713,5710,511,149,5050,4788,177078,113105,36964,29005,7959,27009,1906,25103,5511,4008,1503,175,1328,32132,28220,18903,1
0,0,6,6,25.4,35.6,28.6,10.4,435169,250033,102699,8578,1956,92165,82437,15074,28869,16587,6813,569,130,6114,5469,235105,148185,44218,32585,11633,42702,1958,40744,7854,5368,2486,395,2091,29934,27605,19485,1
0,0,6,4,20.9,34.9,30.8,13.4,465112,309524,78526,4863,1966,71697,77062,14950,31111,20704,5253,325,132,4796,5155,295233,190626,59036,43889,15147,45571,10973,34598,8303,6026,2277,599,1678,35557,31634,20619,1
0,0,7,8,23.5,34.8,31,10.7,388544,230707,104649,11444,2026,91179,53188,15477,25105,14906,6762,739,131,5891,3437,234509,168479,49172,37303,11869,16858,2753,14105,6248,4833,1415,347,1068,37533,34860,13207,0
0,0,6,4,21.1,43.8,24.9,10.1,358174,229659,81570,8244,2040,71286,46945,14382,24904,15969,5672,573,142,4957,3264,147468,75926,26166,20955,5211,45376,22394,22982,4912,3108,1804,511,1293,30022,24429,17774,1
0,0,7,9,24.8,34.7,30.5,10,456111,282123,104976,9170,2053,93753,69012,16910,26973,16684,6208,542,121,5544,4081,245909,133483,46399,36789,9610,66027,20778,45249,7825,5071,2754,988,1766,31426,26323,25622,1
0,0,7,9,24.1,38.3,28,9.7,375287,224143,101287,8075,2118,91094,49857,14134,26552,15858,7166,571,150,6445,3527,262659,173624,60658,46670,13988,28377,4761,23616,7846,5882,1964,580,1384,33477,29518,17064,1
0,0,7,9,20.4,43.8,25.9,9.9,408541,238913,98422,8580,2159,87683,71206,16862,24229,14169,5837,509,128,5200,4223,193344,115241,37642,29250,8392,40461,16333,24128,7250,4761,2489,776,1713,26668,24205,14085,0
0,0,7,11,16.6,32.8,35.4,15.2,436589,262463,102560,9638,2184,90738,71566,16258,26854,16144,6308,593,134,5581,4402,294777,188525,60151,45786,14365,46101,6822,39279,9150,6909,2241,443,1798,32216,27287,21846,1
0,0,7,9,18.7,41.8,29.7,9.7,513747,318326,109790,8068,2200,99522,85631,16910,30381,18825,6493,477,130,5885,5064,308975,137666,45838,35733,10105,125471,8044,117427,6503,4876,1627,324,1303,47513,28233,90120,0
0,0,6,6,16.5,43.6,26.4,13.4,496627,335917,95718,7352,2258,86108,64992,16716,29710,20096,5726,440,135,5151,3888,289046,192980,59515,46042,13473,36551,8415,28136,7213,5206,2007,402,1605,40073,37069,17530,1
0,0,1,1,27.2,34.2,23.6,15,475263,323158,89178,7881,2343,78954,62927,17988,26421,17965,4958,438,130,4389,3498,231518,149678,46862,35617,11245,34978,9469,25509,7131,4944,2187,538,1649,32466,30275,15469,1
0,0,6,6,20,39.3,27,13.6,460222,297810,94473,8229,2348,83896,67939,16728,27512,17803,5648,492,140,5015,4061,248941,150248,51251,39416,11835,47442,18373,29069,7658,5375,2283,480,1803,32507,27953,16123,1
0,0,7,9,16.7,44,26.1,13.1,454412,279791,97910,7020,2404,88486,76711,15914,28554,17581,6152,441,151,5560,4820,219709,138111,42989,32508,10481,38609,10239,28370,7411,4987,2424,537,1887,29646,27694,15034,1
0,0,6,6,20.7,39.6,25.9,13.8,631813,446772,98531,7930,2449,88152,86510,20101,31432,22226,4902,395,122,4385,4304,441198,266347,76862,55454,21408,97989,20395,77594,11889,8835,3054,503,2551,37110,30147,30417,0
0,0,2,2,15.1,43.6,28.7,12.6,504278,341324,90507,6791,2455,81261,72447,16694,30207,20446,5422,407,147,4868,4340,157256,85192,31902,26016,5886,40162,15846,24316,5784,3441,2343,634,1709,27188,24758,14228,3
0,0,7,9,14.3,41.4,28.6,15.6,529752,342787,108031,8512,2499,97020,78934,19479,27196,17598,5546,437,128,4981,4052,254616,143165,51381,40389,10992,60070,27867,32203,8666,5479,3187,876,2311,29381,26130,13935,9
0,0,6,6,20.1,42.1,26.6,11.2,401806,240065,99771,9702,2527,87542,61970,15471,25972,15517,6449,627,163,5658,4006,164366,98813,35553,28856,6697,30000,8179,21821,5418,3657,1761,359,1402,30337,27020,15564,0
0,0,7,8,17.7,39.5,26.9,15.8,459483,302697,91155,8978,2594,79583,65631,17874,25707,16935,5100,502,145,4452,3672,270475,169780,49938,36864,13074,50757,22530,28227,8290,6317,1973,521,1452,32627,26877,19440,0
0,0,6,6,20.7,37,32.1,10.3,538391,343623,106524,9385,2728,94411,88244,20051,26851,17137,5313,468,136,4709,4401,412144,265394,99378,80594,18784,47372,7448,39924,10419,7922,2497,478,2019,39557,33501,19774,0
0,0,6,6,16.4,41.6,26.8,15.2,731261,444160,118144,7207,2733,108204,168957,22680,32243,19584,5209,318,121,4771,7450,383767,246944,75184,55400,19784,61639,16764,44875,12949,9112,3837,800,3037,29637,27101,14776,4
0,0,7,9,25.2,31,28.1,15.8,469336,276637,125920,13141,2856,109923,66779,18071,25972,15308,6968,727,158,6083,3695,234585,151294,55026,44583,10443,28265,36,28229,7628,5484,2144,527,1617,30753,27588,17458,0
0,0,6,6,18.6,41.8,26.3,13.3,514439,322758,112954,10912,2877,99165,78727,18987,27094,16999,5949,575,152,5223,4146,302116,195712,62924,47629,15295,43480,25600,17880,8700,6753,1947,534,1413,34726,28981,12654,1
0,0,6,6,17.1,43.9,27.6,11.5,581883,380471,121447,8886,3049,109512,79965,22445,25925,16951,5411,396,136,4879,3563,254921,144434,47492,36083,11409,62995,25356,37639,8968,5684,3284,990,2294,28426,25411,16408,1
0,0,1,1,17.5,39.3,30.7,12.6,649808,447606,119254,8512,3185,107557,82948,22500,28880,19894,5300,378,142,4780,3687,233797,145175,46503,36286,10217,42119,5426,36693,7842,5551,2291,421,1870,29813,26153,19622,0
0,0,6,4,27.8,40.9,22.3,9,495790,295742,125394,12707,3308,109379,74654,21848,22693,13536,5739,582,151,5006,3417,272881,172643,57167,44250,12917,43071,11918,31153,9442,6621,2821,950,1871,28901,26075,16650,1
0,0,7,9,27.7,34.3,28,10.1,518163,316217,127082,13277,3531,110274,74864,22608,22919,13987,5621,587,156,4878,3311,287720,191625,66873,52278,14595,29222,4412,24810,8598,6635,1963,479,1484,33464,28881,16718,0
0,0,6,5,19.6,40.4,25.8,14.2,769108,505420,153810,12725,3691,137394,109878,30795,24975,16412,4995,413,120,4462,3568,447231,292487,92070,70695,21375,62674,25037,37637,12944,10017,2927,565,2362,34551,29199,15934,5
0,0,7,8,23.9,30.2,33.9,12.1,663635,368848,189712,21520,3711,164481,105075,25526,25998,14450,7432,843,145,6444,4116,446334,315705,94944,72321,22623,35685,-649,36334,12776,9916,2860,399,2461,34935,31838,14764,1
0,0,2,2,12.2,35.3,31.4,21.1,1223066,890757,153280,9728,3797,139755,179029,37032,33027,24054,4139,263,103,3774,4834,500594,321009,93195,69101,24094,86390,14703,71687,15602,11261,4341,747,3594,32085,28506,19946,20
0,0,5,8,13.1,33.4,26.7,26.9,807318,510664,152318,15704,3858,132756,144336,32848,24577,15546,4637,478,117,4042,4394,602954,393325,152830,127782,25048,56799,23079,33720,17434,14401,3033,614,2419,34585,27312,13940,6
0,0,1,1,12.8,32.6,34.2,20.4,1108950,810526,131158,5373,3939,121846,167266,31007,35765,26140,4230,173,127,3930,5394,363083,245508,70482,52198,18284,47093,4313,42780,12162,8783,3379,500,2879,29854,27953,14859,0
0,0,6,6,19.7,40.6,27.9,11.8,891421,567481,189045,15216,3952,169877,134895,30548,29181,18577,6188,498,129,5561,4416,417657,247220,75494,56916,18578,94943,44570,50373,13806,9295,4511,1162,3349,30252,26597,15041,0
0,0,6,4,28.7,37.3,25.4,8.6,805197,500836,180975,16447,4228,160300,123386,33588,23973,14911,5388,490,126,4773,3674,572665,389808,126889,99361,27528,55968,10923,45045,15486,12254,3232,686,2546,36980,31811,17692,2
0,0,1,1,22.6,35,29.4,13,1129910,776091,181493,11278,4468,165747,172326,36681,30804,21158,4948,307,122,4519,4698,534847,342033,106185,80429,25756,86629,29807,56822,16798,12735,4063,800,3263,31840,26858,17414,0
0,0,4,3,19.8,36.7,30.4,13.2,984106,659173,183591,12131,4568,166892,141342,35635,27616,18498,5152,340,128,4683,3966,656675,460161,133789,99872,33917,62725,10171,52554,17997,13896,4101,721,3380,36488,33115,15549,4
0,0,4,5,21.9,41.2,24.2,12.6,1180140,827111,197981,15638,4583,177760,155048,39062,30212,21174,5068,400,117,4551,3969,815480,539821,157340,119230,38110,118319,52538,65781,19738,15380,4358,1089,3269,41315,35099,20123,4
0,0,6,5,15.9,39,29.4,15.7,1041192,705193,183133,13708,4618,164807,152866,34977,29768,20162,5236,392,132,4712,4370,635736,445496,126156,92964,33192,64084,11170,52914,17851,13665,4186,948,3238,35613,32601,16342,10
0,0,6,6,22.9,40.9,24.9,11.2,760662,458755,179488,15231,4710,159547,122419,30288,25114,15146,5926,503,156,5268,4042,475860,311706,98037,75231,22806,66117,17740,48377,14182,10734,3448,788,2660,33554,29039,18187,0
0,0,7,8,16.6,38.1,30.2,15.1,1015278,667150,162264,14018,4835,143411,185864,34365,29544,19414,4722,408,141,4173,5409,869201,613142,167804,120180,47624,88255,16848,71407,25552,20606,4946,944,4002,34017,29756,17843,14
0,0,4,5,20.1,37.1,22.8,19.9,979320,612237,199380,20361,4907,174112,167703,36101,27127,16959,5523,564,136,4823,4645,690881,473113,141186,105786,35400,76582,22101,54481,19160,15585,3575,584,2991,36059,30357,18215,1
0,0,6,5,19,43.6,26.8,10.5,967597,612518,214529,17169,4981,192379,140550,35165,27516,17418,6101,488,142,5471,3997,522381,334710,105235,79584,25651,82436,23386,59050,15695,11679,4016,688,3328,33283,28659,17743,6
0,0,7,8,23,32.9,30.4,13.7,1139402,750711,233858,26484,5304,202070,154833,39624,28755,18946,5902,668,134,5100,3908,1021280,665003,187508,137305,50203,168769,8852,159917,24970,20480,4490,975,3515,40900,32471,45496,4
0,0,6,5,21.7,38,28.9,11.4,976865,616465,225264,19192,5364,200708,135136,37452,26083,16460,6015,512,143,5359,3608,384935,242239,84218,67622,16596,58478,13490,44988,13068,9391,3677,843,2834,29456,25795,15874,0
0,0,4,3,20.9,35.9,31.1,12.1,1108184,651807,299152,28789,5852,264511,157225,39941,27746,16319,7490,721,147,6623,3936,670132,444998,139747,103264,36483,85387,4537,80850,19591,14735,4856,891,3965,34206,30200,20391,1
0,0,5,8,17.1,32.6,29.5,20.8,1412145,907833,258712,26285,6205,226222,245600,53016,26636,17124,4880,496,117,4267,4633,1162989,802997,267742,207831,59911,92250,16566,75684,34343,29329,5014,578,4436,33864,27379,17061,1
0,0,2,2,15.5,37.2,31.6,15.7,1530044,1036627,259424,21367,6330,231727,233993,50572,30255,20498,5130,423,125,4582,4627,661311,416805,134705,104140,30565,109801,30030,79771,21068,15203,5865,1147,4718,31389,27416,16908,7
0,0,5,9,23.3,34.4,30.9,11.3,974715,550570,285159,29534,6337,249288,138986,39587,24622,13908,7203,746,160,6297,3511,436126,286460,98270,75566,22704,51396,2975,48421,14686,10499,4187,636,3551,29697,27285,13636,1
0,0,4,5,15.9,38.3,30.2,15.6,1416931,924277,263973,27011,6569,230393,228681,48105,29455,19214,5487,562,137,4789,4754,1005353,706191,196957,140609,56348,102205,12664,89541,26572,20655,5917,937,4980,37835,34190,17980,20
0,0,4,5,16.9,36.4,29.7,17,1593414,1136817,241563,20671,7008,213884,215034,52893,30125,21493,4567,391,132,4044,4065,946715,662277,191037,143638,47399,93401,6364,87037,24312,18149,6163,999,5164,38940,36491,16855,7
0,0,5,8,16.3,37.5,28.6,17.6,2009816,1289904,370293,33633,7137,329523,349619,66920,30033,19275,5533,503,107,4924,5224,1558326,1085913,306854,225926,80928,165559,26613,138946,42974,35595,7379,1071,6308,36262,30507,22027,5
0,0,1,1,17.9,41.6,28.7,11.8,1348031,877644,272405,21603,7164,243638,197982,48418,27842,18126,5626,446,148,5032,4089,566627,364775,112124,85212,26912,89728,24618,65110,18348,13031,5317,963,4354,30882,27993,14954,0
0,0,5,8,14.8,24.9,28.4,32,1567248,1001062,284036,44519,7291,232226,282150,60006,26118,16683,4733,742,122,3870,4702,1329210,888798,341132,284048,57084,99280,1566,97714,37343,31402,5941,645,5296,35595,28304,18451,3
0,0,1,1,13.1,38.9,32.7,15.2,1568004,1201291,173599,11414,8017,154168,193114,44181,35490,27190,3929,258,181,3489,4371,1051397,717084,198791,146407,52384,135522,9649,125873,20892,16524,4368,351,4017,50325,43397,31335,2
0,0,2,2,19.2,38.2,28,14.5,1531090,1140311,188691,17318,8161,163212,202088,49725,30791,22932,3795,348,164,3282,4064,826490,596271,160995,112313,48682,69224,1077,68147,18872,14445,4427,424,4003,43795,41279,17024,7
0,0,4,5,20.2,37.8,30.7,11.3,1681973,1052162,350380,26643,8665,315072,279431,59094,28463,17805,5929,451,147,5332,4729,978473,676511,210236,158991,51245,91726,16970,74756,28176,22808,5368,885,4483,34727,29661,16675,9
0,0,5,8,20.2,32.3,30.3,17.2,1878491,1218515,381843,38114,9049,334680,278133,63875,29409,19077,5978,597,142,5240,4354,1217649,829609,268454,204635,63819,119586,3400,116186,34097,27560,6537,522,6015,35711,30102,19316,9
0,0,4,5,18.2,36.7,30.6,14.6,1462969,877593,371545,31621,9467,330457,213831,53513,27339,16400,6943,591,177,6175,3996,972811,660240,200350,142852,57498,112221,23430,88791,26880,22099,4781,719,4062,36191,29876,21859,6
0,0,1,1,10.1,30.1,34.5,25.3,2711788,2169287,217794,16268,10649,190877,324707,81107,33435,26746,2685,201,131,2353,4003,1148922,811595,211878,153287,58591,125449,4198,121251,29539,21100,8439,333,8106,38895,38464,14958,19
0,0,3,2,21.3,38.4,27.9,12.5,2201894,1380552,503698,67257,13185,423256,317644,82728,26616,16688,6089,813,159,5116,3840,1541714,1080709,333014,249659,83355,127991,17286,110705,40190,32746,7444,787,6657,38361,33003,16630,5
0,0,1,1,12.5,29.9,30.8,26.8,2899654,2106357,352416,32308,13565,306543,440881,98438,29457,21398,3580,328,138,3114,4479,1847009,1270440,417325,331621,85704,159244,8033,151211,48933,39424,9509,710,8799,37746,32225,17185,11
0,0,2,2,15,34.4,32.5,18.1,4301532,3013847,655337,52918,16288,586131,632348,130784,32890,23044,5011,405,125,4482,4835,3593954,2760487,646211,452865,193346,187256,19523,167733,72780,61547,11233,785,10448,49381,44852,16054,53
0,0,3,2,16.8,38,28.2,16.9,3640957,2437681,661614,75169,16313,570132,541662,111083,32777,21945,5956,677,147,5132,4876,2986249,2213398,563885,395766,168119,208966,19549,189417,65139,56124,9015,540,8475,45844,39438,22350,17
0,0,3,2,20.2,35.8,29.1,15,3122240,2103730,618522,69357,17048,532117,399988,107917,28932,19494,5731,643,158,4931,3706,1980389,1442183,409659,300493,109166,128547,18159,110388,53554,44236,9318,626,8692,36979,32602,12700,21
0,0,4,3,18.6,38.6,29.5,13.3,3444126,2356689,596757,47381,17294,532082,490680,112565,30597,20936,5301,421,154,4727,4359,2158009,1502133,432687,319494,113193,223189,13941,209248,56444,46091,10353,1293,9060,38233,32591,23096,7
0,0,3,2,9.3,28.2,26.3,36.2,5501054,4207596,547415,58491,17782,471142,746043,160299,34317,26248,3415,365,111,2939,4654,5138583,3741568,977182,719449,257733,419833,46504,373329,109996,93554,16442,1213,15229,46716,39994,24514,23
0,0,2,2,17.4,34,31.4,17.1,4962898,3344785,794607,86250,18115,690242,823506,147067,33746,22743,5403,586,123,4693,5600,4883398,3435841,902922,656614,246308,544635,5556,539079,95169,83551,11618,570,11048,51313,41123,48794,12
0,0,3,2,9,24.2,28.7,38,5855109,3966787,655112,84507,21153,549452,1233210,190659,30710,20806,3436,443,111,2882,6468,5024229,3497713,1179627,945456,234171,346889,30998,315891,123954,105179,18775,1090,17685,40533,33255,17862,54
0,0,2,2,16.2,29.5,31,23.3,6287629,4326552,956995,126410,23592,806993,1004082,182868,34383,23659,5233,691,129,4413,5491,5541349,4247109,1036503,719560,316943,257737,9687,248050,120606,106020,14586,719,13867,45946,40060,17888,51
0,0,3,2,11.9,31,28.5,28.6,6450247,4386929,927620,112719,23859,791042,1135698,192432,33520,22797,4821,586,124,4111,5902,5526273,3938194,1167037,893580,273457,421042,41442,379600,126845,107034,19811,866,18945,43567,36794,20037,14
0,0,1,1,15.7,34,31,19.2,8370877,5738282,1436315,148600,39829,1247886,1196280,264759,31617,21674,5425,561,150,4713,4518,4968735,3532065,1008404,738417,269987,428266,8320,419946,123227,101066,22161,950,21211,40322,34948,19799,44
0,0,1,1,10.8,28.4,33.1,27.7,11682587,9178410,924893,57134,41525,826234,1579284,294280,39699,31189,3143,194,141,2808,5367,5473263,3860981,1030219,732799,297420,582063,-2786,584849,136431,104696,31735,734,31001,40117,36878,18865,125
0,0,1,1,19.1,29.1,32.5,19.3,8129164,5297814,1501231,222071,42033,1237127,1330119,261255,31116,20278,5746,850,161,4735,5091,5268591,3773999,1124494,827302,297192,370098,5160,364938,124941,106166,18775,682,18093,42169,35548,20170,21
0,0,2,2,18.6,32.8,29.2,19.4,8662622,5992693,1454360,182532,44753,1227075,1215569,286178,30270,20940,5082,638,156,4288,4248,6987914,5207342,1380338,971770,408568,400234,-1396,401630,170380,144080,26300,646,25654,41014,36142,15656,51
0,0,1,1,19.8,25,27.5,27.7,16760183,12901228,1560707,158930,69192,1332585,2298248,475384,35256,27139,3283,334,146,2803,4835,11591071,8455077,2178984,1536173,642811,957010,1652,955358,256145,217962,38183,516,37667,45252,38792,25363,126
0,0,1,1,13.4,21.4,26.6,38.6,36714530,25932987,2365034,213535,84358,2067141,8416509,684419,53643,37891,3456,312,123,3020,12297,24622342,18342575,4354463,3036204,1318259,1925304,-1358,1926662,443365,365290,78075,257,77818,55535,50214,24759,407
0,0,1,1,13.1,29.1,32.3,25.5,22037359,17384140,2107290,195503,94358,1817429,2545929,627610,35113,27699,3358,312,150,2896,4057,9940928,7041944,1889005,1360183,528822,1009979,1651,1008328,238180,183076,55104,671,54433,41737,38465,18524,176
0,0,1,1,10,20.6,27.8,41.7,45897775,34561183,3304522,222421,116611,2965490,8032070,911378,50361,37922,3626,244,128,3254,8813,40665969,30227234,6634783,4357363,2277420,3803952,190,3803762,724100,615491,108609,42,108567,56161,49111,35036,357
0,0,1,1,22.3,24.2,25.5,28,210964199,140167133,28568754,4015269,808024,23745461,42228312,5207615,40511,26916,5486,771,155,4560,8109,186077419,134825615,31132243,21482032,9650211,20119561,3737,20115824,3221241,2688964,532277,130,532147,57766,50140,37801,938
0,0,0,0,18.6,27.7,27.6,26.1,477013210,329758834,61767044,7233309,1822941,52710794,85487332,12609903,37828,26151,4898,574,145,4180,6779,370187199,267015631,65814715,46356907,19457808,37356853,1281796,36075057,7334790,6045861,1288929,61040,1227889,50470,44165,29380,0
0,0,1,1,21.6,44.7,22.1,11.6,242861,199407,26443,1829,656,23958,17011,5943,40865,33553,4449,308,110,4031,2862,163923,54855,10259,6630,3629,98809,236,98573,2367,1816,551,171,380,69253,30206,259403,1
0,0,8,7,15,46.7,24.3,14,251530,181786,41636,2571,835,38230,28108,8626,29160,21074,4827,298,97,4432,3259,95514,58783,15827,11385,4442,20904,12048,8856,2944,2098,846,324,522,32444,28019,16966,1
0,0,8,4,20.1,45.6,23.3,11.1,201483,140624,35128,2756,846,31526,25731,7378,27309,19060,4761,374,115,4273,3488,77573,45774,13063,9541,3522,18736,5653,13083,2632,1738,894,207,687,29473,26337,19044,1
0,0,3,2,13.7,48.1,25.1,13,260099,173585,44678,3189,943,40546,41836,8915,29175,19471,5012,358,106,4548,4693,121815,71789,19666,14327,5339,30360,13214,17146,4042,2707,1335,336,999,30137,26520,17163,0
0,0,8,4,28.6,44.4,19.3,7.6,230411,160996,45373,4000,1061,40312,24042,10165,22667,15838,4464,394,104,3966,2365,101072,75324,15279,10002,5277,10469,1367,9102,3534,2576,958,363,595,28600,29241,15297,0
0,0,6,6,25.8,42.3,23.1,8.8,297779,197534,54192,4737,1146,48309,46053,10323,28846,19135,5250,459,111,4680,4461,509052,362155,114352,87468,26884,32545,7402,25143,8489,7190,1299,270,1029,59966,50369,24434,1
0,0,6,5,24.4,45.5,21.7,8.4,327842,213925,75093,4758,1364,68971,38824,12879,25456,16610,5831,369,106,5355,3015,156684,110836,30510,22743,7767,15338,3598,11740,4192,3070,1122,273,849,37377,36103,13828,0
0,0,6,4,20.2,45.1,24.4,10.3,372619,238208,72183,5488,1373,65322,62228,13682,27234,17410,5276,401,100,4774,4548,231938,155417,41533,30248,11285,34988,16304,18684,6729,4940,1789,454,1335,34468,31461,13996,1
0,0,1,1,21.3,49.8,19.3,9.6,405161,290688,71257,4869,1484,64904,43216,14485,27971,20068,4919,336,102,4481,2984,199889,125957,34051,24632,9419,39881,19424,20457,5921,4560,1361,342,1019,33759,27622,20076,0
0,0,8,4,29.4,45.2,17,8.4,246969,154987,61999,6007,1611,54381,29983,11012,22427,14074,5630,545,146,4938,2723,83660,52482,16648,12637,4011,14530,605,13925,3742,2236,1506,342,1164,22357,23471,11963,0
0,0,6,4,20.4,50.9,18.4,10.3,525637,363685,93300,6280,1743,85277,68652,17826,29487,20402,5234,352,98,4784,3851,292335,177630,48184,34846,13338,66521,29282,37239,8182,6008,2174,515,1659,35729,29566,22447,0
0,0,1,1,16.4,38.9,26.3,18.5,474837,325231,72527,4393,1749,66385,77079,15283,31070,21281,4746,287,114,4344,5043,130439,76113,20979,14958,6021,33347,134,33213,6000,3418,2582,166,2416,21740,22268,13747,1
0,0,6,6,19.3,47.5,23.1,10.1,483305,320931,97437,6514,1850,89073,64937,17436,27719,18406,5588,374,106,5109,3724,261659,169336,50596,38243,12353,41727,18124,23603,8003,6058,1945,423,1522,32695,27952,15508,0
0,0,6,6,18.7,49.5,21.5,10.3,352431,221413,84193,6295,1881,76017,46825,13392,26317,16533,6287,470,140,5676,3496,181703,123897,34497,25093,9404,23309,3112,20197,5641,4355,1286,221,1065,32211,28449,18964,0
0,0,6,6,19.5,45.6,23.3,11.6,409403,252954,98735,6567,2021,90147,57714,17396,23534,14541,5676,378,116,5182,3318,148597,89647,27469,20614,6855,31481,6754,24727,5482,3718,1764,405,1359,27106,24112,18195,0
0,0,3,2,16.8,47.6,22.6,12.9,583601,412637,92626,5612,2106,84908,78338,20274,28786,20353,4569,277,104,4188,3864,243866,152566,40095,28504,11591,51205,23589,27616,7968,5807,2161,439,1722,30606,26273,16037,1
0,0,3,2,16.3,48.4,22.9,12.4,508053,363779,85055,4678,2134,78243,59219,16411,30958,22167,5183,285,130,4768,3608,219029,142913,38359,27619,10740,37757,12255,25502,6487,4544,1943,338,1605,33764,31451,15889,8
0,0,7,9,19.8,49.2,20.7,10.3,557078,366808,108873,8409,2176,98288,81397,20540,27122,17858,5301,409,106,4785,3963,320173,223282,57495,40683,16812,39396,6517,32879,10352,7411,2941,550,2391,30929,30128,13751,0
0,0,6,9,25.2,45.5,19.7,9.6,501072,324055,100156,6318,2196,91642,76861,19260,26016,16825,5200,328,114,4758,3991,302869,216055,58583,42908,15675,28231,3962,24269,8551,6681,1870,398,1472,35419,32339,16487,0
0,0,3,2,18.8,45.2,24.8,11.2,450236,299987,96814,6862,2321,87631,53435,16603,27118,18068,5831,413,140,5278,3218,274143,192229,48473,34681,13792,33441,1768,31673,6586,5135,1451,218,1233,41625,37435,25688,0
0,0,8,7,18.8,42.8,25.4,13,602699,434459,97123,6363,2358,88402,71117,20896,28843,20791,4648,305,113,4231,3403,344367,239733,61613,43506,18107,43021,9437,33584,10234,7822,2412,539,1873,33649,30649,17931,2
0,0,6,6,21.5,49.5,19.2,9.9,557777,383425,115488,8287,2430,104771,58864,21595,25829,17755,5348,384,113,4852,2726,370637,237103,64548,46511,18037,68986,27032,41954,11227,8597,2630,760,1870,33013,27580,22435,2
0,0,7,8,28.2,39.9,22.2,9.7,843332,547246,158211,12864,2467,142880,137875,30452,27694,17971,5195,422,81,4692,4528,502087,320239,83015,58436,24579,98833,27672,71161,15866,11882,3984,900,3084,31645,26952,23074,1
0,0,6,3,20.9,47.5,20.1,11.5,747473,519946,122447,9483,2498,110466,105080,25374,29458,20491,4826,374,98,4354,4141,593314,410852,108097,77196,30901,74365,27609,46756,16133,13321,2812,529,2283,36776,30842,20480,3
0,0,2,2,15.6,41.8,27.8,14.8,848117,595196,124434,8104,2636,113694,128487,26488,32019,22470,4698,306,100,4292,4851,567703,411527,111395,82674,28721,44781,12201,32580,11440,9288,2152,351,1801,49624,44307,18090,6
0,0,6,4,26.2,45.3,18.4,10.2,462183,283647,114274,10516,2679,101079,64262,19744,23409,14366,5788,533,136,5119,3255,261368,183989,46705,31886,14819,30674,5308,25366,8787,6795,1992,438,1554,29745,27077,16323,1
0,0,3,2,19.2,44.4,27,9.4,515504,325019,124452,9470,2688,112294,66033,21689,23768,14985,5738,437,124,5177,3045,251238,159659,49613,37890,11723,41966,8932,33034,7821,5828,1993,382,1611,32124,27395,20505,4
0,0,6,3,28.6,42.5,20,8.8,596493,402793,131155,14791,2740,113624,62545,23889,24969,16861,5490,619,115,4756,2618,316872,225942,63581,46211,17370,27349,4339,23010,10268,8039,2229,338,1891,30860,28106,12168,3
0,0,6,6,17.9,47.7,24,10.5,688271,447886,138044,8452,2765,126827,102341,24861,27685,18016,5553,340,111,5101,4117,381587,258062,68048,48293,19755,55477,20456,35021,12252,9097,3155,500,2655,31145,28368,13191,3
0,0,2,2,12.7,46.5,26.5,14.3,786647,546144,126734,7886,2777,116071,113769,27820,28276,19631,4555,283,100,4172,4089,513358,363292,99683,72633,27050,50383,14354,36029,14819,11755,3064,563,2501,34642,30905,14406,11
0,0,3,2,25.1,43.4,22.3,9.2,563273,382707,112859,9812,2844,100203,67707,21975,25632,17416,5136,447,129,4560,3081,229051,143853,46657,35869,10788,38541,2483,36058,7363,5057,2306,517,1789,31108,28446,20155,4
0,0,6,6,28,43.4,20.1,8.4,528573,331068,140983,11645,2890,126448,56522,23394,22594,14152,6026,498,124,5405,2416,200452,121171,34704,25248,9456,44577,5687,38890,7000,4711,2289,513,1776,28636,25721,21898,0
0,0,1,1,23.9,44.2,19.4,12.5,708745,469228,110357,8558,2988,98811,129160,23049,30749,20358,4788,371,130,4287,5604,219713,127888,35683,25847,9836,56142,10188,45954,7594,4991,2603,670,1933,28932,25624,23773,4
0,0,6,4,21.1,46.8,20.6,11.5,845423,605837,125669,8759,3063,113847,113917,28040,30151,21606,4482,312,109,4060,4063,687317,496996,136389,99620,36769,53932,12248,41684,18229,14554,3675,782,2893,37705,34148,14409,14
0,0,6,5,20,45,24.3,10.7,902316,638484,139001,9469,3091,126441,124831,33867,26643,18853,4104,280,91,3733,3686,714883,457665,127668,92683,34985,129550,16545,113005,20780,15712,5068,1118,3950,34402,29128,28609,1
0,0,6,6,39.8,33.9,17.5,8.9,884371,659938,117206,8828,3314,105064,107227,36283,24374,18189,3230,243,91,2896,2955,665458,442730,117339,83760,33579,105389,14265,91124,18704,13348,5356,1332,4024,35578,33168,22645,2
0,0,1,1,17.6,46.4,23,13,942245,681087,141773,9559,3348,128866,119385,31763,29665,21443,4463,301,105,4057,3759,579734,384194,96134,66574,29560,99406,36937,62469,16279,12773,3506,565,2941,35612,30079,21241,3
0,0,2,2,19.1,41,27.4,12.4,1011309,716244,171189,10208,3381,157600,123876,33268,30399,21530,5146,307,102,4737,3724,986489,734091,187097,134578,52519,65301,16911,48390,19761,16808,2953,486,2467,49921,43675,19615,4
0,0,1,1,24.8,44.1,20.8,10.2,698460,482432,137615,12244,3405,121966,78413,27893,25041,17296,4934,439,122,4373,2811,290546,191306,54763,39927,14836,44477,4238,40239,10135,6895,3240,816,2424,28668,27746,16600,1
0,0,7,8,19.8,44.4,21.3,14.5,1481584,950893,185191,9035,3413,172743,345500,41265,35904,23044,4488,219,83,4186,8373,1334038,974742,230452,155816,74636,128844,32291,96553,34379,29623,4756,635,4121,38804,32905,23430,2
0,0,2,2,13.8,45.4,27.5,13.3,967452,704467,141538,8041,3499,129998,121447,32182,30062,21890,4398,250,109,4039,3774,536948,379993,101239,72767,28472,55716,8322,47394,16366,12229,4137,719,3418,32809,31073,13866,2
0,0,6,3,14.3,46.9,24.1,14.7,1077431,747467,187888,13799,3620,170469,142076,38105,28275,19616,4931,362,95,4474,3729,845274,611977,152330,106341,45989,80967,23673,57294,21774,17897,3877,611,3266,38820,34194,17543,7
0,0,6,5,23.8,46.9,20.9,8.4,713115,474272,172507,13069,3622,155816,66336,28352,25152,16728,6084,461,128,5496,2340,361498,257930,68546,48351,20195,35022,5915,29107,11233,8690,2543,558,1985,32182,29681,14663,0
0,0,6,3,19,40.2,24.5,16.4,898128,577225,185957,13717,3627,168613,134946,31998,28068,18039,5812,429,113,5269,4217,608715,444714,123801,90677,33124,40200,1458,38742,17385,14402,2983,652,2331,35014,30879,16620,2
0,0,3,2,17.7,45.6,23.9,12.8,672432,436330,148770,12512,3633,132625,87332,27097,24816,16103,5490,462,134,4894,3223,327771,218812,64743,47613,17130,44216,7499,36717,11117,8243,2874,537,2337,29484,26545,15711,1
0,0,6,6,20.4,47.5,22.2,9.9,685067,440770,155008,11579,3756,139673,89289,26517,25835,16622,5846,437,142,5267,3367,342447,220858,61469,44546,16923,60120,17491,42629,10528,7476,3052,688,2364,32527,29542,18033,2
0,0,6,5,19.9,50.3,19.6,10.1,889935,604555,166295,12790,3807,149698,119085,33237,26775,18189,5003,385,115,4504,3583,535097,376545,99601,70886,28715,58951,18940,40011,15293,12114,3179,550,2629,34990,31083,15219,9
0,0,4,5,18.3,37.2,30,14.4,1086200,661215,253702,19656,3886,230160,171283,38543,28182,17155,6582,510,101,5972,4444,735381,498496,143078,105715,37363,93807,24053,69754,21432,18062,3370,439,2931,34312,27599,23799,0
0,0,7,8,26.3,46.5,19.4,7.8,669285,421667,165852,12991,4010,148851,81766,24700,27097,17072,6715,526,162,6026,3310,445776,318862,84581,61168,23413,42333,6349,35984,11646,9445,2201,343,1858,38277,33760,19367,4
0,0,7,8,15.7,43,25.8,15.5,940097,631988,149084,10833,4137,134114,159025,33926,27710,18628,4394,319,122,3953,4687,630046,453156,121040,85702,35338,55850,3093,52757,20205,16016,4189,618,3571,31183,28294,14774,12
0,0,4,5,20.2,46.7,21.7,11.5,1191803,843193,199955,14987,4187,180781,148655,41683,28592,20229,4797,360,100,4337,3566,972128,692846,189366,137509,51857,89916,25309,64607,25750,21372,4378,707,3671,37753,32418,17599,5
0,0,1,1,11.7,37.8,22.8,27.6,2266777,1572862,203774,10916,4353,188505,490141,51261,44220,30683,3975,213,85,3677,9562,940702,640506,154177,104830,49347,146019,16858,129161,26342,19283,7059,513,6546,35711,33216,19731,20
0,0,3,2,20.8,43.4,25.3,10.5,863460,552570,185599,13808,4392,167399,125291,33320,25914,16584,5570,414,132,5024,3760,342101,229179,59689,42160,17529,53233,12006,41227,11759,8055,3704,710,2994,29093,28452,13770,3
0,0,6,5,15,46.7,24.1,14.2,1095877,763957,184861,11754,4523,168584,147059,37650,29107,20291,4910,312,120,4478,3906,684078,497270,129894,91740,38154,56914,10313,46601,20611,16490,4121,615,3506,33190,30156,13292,7
0,0,6,5,18.3,46,22,13.7,939513,583753,202857,11456,4568,186833,152903,33806,27791,17268,6001,339,135,5527,4523,583176,418852,111356,79242,32114,52968,12112,40856,17982,14184,3798,685,3113,32431,29530,13124,2
0,0,1,1,18.8,48.2,19.9,13.1,941222,658163,160469,10084,4605,145780,122590,37780,24913,17421,4247,267,122,3859,3245,527184,381894,101051,71164,29887,44239,7700,36539,17334,13420,3914,740,3174,30413,28457,11512,1
0,0,6,5,20.2,41.1,23.8,14.9,1278302,902355,203155,15190,4626,183339,172792,46549,27461,19385,4364,326,99,3939,3712,823293,580705,152033,107573,44460,90555,12697,77858,24670,19423,5247,754,4493,33372,29898,17329,9
0,0,6,5,18.1,46.2,25.3,10.4,916776,611321,179206,15439,4640,159127,126249,37445,24483,16326,4786,412,124,4250,3372,518822,355298,105191,76543,28648,58333,19090,39243,15056,11714,3342,584,2758,34459,30331,14229,2
0,0,4,5,18.2,45.5,24.3,12,1063823,690354,224179,16072,4677,203430,149290,39637,26839,17417,5656,405,118,5132,3766,674163,482229,132670,95907,36763,59264,17579,41685,20079,16676,3403,688,2715,33576,28918,15354,5
0,0,1,1,20.2,44.7,22.4,12.7,1331709,948288,213731,14748,4698,194285,169690,43482,30627,21809,4915,339,108,4468,3903,839138,601937,151790,106667,45123,85411,21206,64205,22868,18430,4438,552,3886,36695,32661,16522,10
0,0,1,1,19.7,41,26.2,13.1,1128319,781920,170514,13123,4824,152567,175885,37354,30206,20933,4565,351,129,4084,4709,530314,359033,85278,58877,26401,86003,5281,80722,17655,12494,5161,1020,4141,30038,28736,19493,2
0,0,4,5,15.3,45.9,26.4,12.4,1207591,847269,183828,13337,5398,165093,176494,41494,29103,20419,4430,321,130,3979,4253,1099394,841717,205156,140882,64274,52521,4603,47918,27479,22831,4648,941,3707,40009,36867,12926,5
0,0,2,2,13.7,33.6,30.9,21.8,1946876,1419119,246138,13617,5536,226985,281619,56066,34725,25312,4390,243,99,4049,5023,778348,528181,130069,91659,38410,120098,5875,114223,21085,15152,5933,350,5583,36915,34859,20459,14
0,0,6,5,22.7,43.7,22.6,11.1,1219160,900981,188108,14964,5673,167471,130071,47292,25779,19051,3978,316,120,3541,2750,897862,642606,176726,127791,48935,78530,4997,73533,25175,20639,4536,985,3551,35665,31136,20708,8
0,0,1,1,18,41.2,25.4,15.4,1620654,1201643,218421,14096,5856,198469,200590,48421,33470,24817,4511,291,121,4099,4143,798580,510311,126075,88842,37233,162194,518,161676,20914,15909,5005,539,4466,38184,32077,36202,9
0,0,1,1,12.2,37.4,28.2,22.2,2290579,1705535,262766,13948,6115,242703,322278,63045,36332,27053,4168,221,97,3850,5112,1008340,711178,169675,116637,53038,127487,12033,115454,28332,20502,7830,565,7265,35590,34688,15892,6
0,0,4,5,22.6,46.3,20.3,10.7,1246272,817978,258139,18553,6886,232700,170155,46233,26956,17693,5583,401,149,5033,3680,666032,483638,124582,88749,35833,57812,2043,55769,20271,15301,4970,722,4248,32856,31608,13128,7
0,0,4,5,18.4,42.1,24.7,14.9,2396929,1717976,317312,20886,6942,289484,361641,75934,31566,22625,4179,275,91,3812,4763,1960386,1440390,394734,291005,103729,125262,13437,111825,45842,37292,8550,1045,7505,42764,38625,14900,44
0,0,3,2,16.2,36.2,25.6,22,2441382,1701661,348073,26448,7050,314575,391648,73660,33144,23102,4725,359,96,4271,5317,2286163,1727290,407129,280198,126931,151744,9224,142520,51636,44745,6891,556,6335,44275,38603,22497,39
0,0,1,1,19.3,45,23.1,12.6,2120047,1595603,301405,24546,7391,269468,223039,68037,31160,23452,4430,361,109,3961,3278,736552,492996,127064,89184,37880,116492,12633,103859,23319,16611,6708,557,6151,31586,29679,16885,7
0,0,1,1,17.6,33.1,28.9,20.4,2534817,1748783,380829,32986,7656,340187,405205,71905,35252,24321,5296,459,106,4731,5635,1399048,1010290,250887,173788,77099,137871,-683,138554,38839,31320,7519,245,7274,36022,32257,19048,4
0,0,4,3,20.4,44.4,23.5,11.7,1332346,853361,295474,20575,8374,266525,183511,48064,27720,17755,6148,428,174,5545,3818,632000,441445,118193,85138,33055,72362,12328,60034,19043,14450,4593,669,3924,33188,30550,15299,1
0,0,5,8,21.9,39.5,24.9,13.7,1927098,1217045,435074,35213,9114,390747,274979,69793,27612,17438,6234,505,131,5599,3940,1448067,1056708,271904,190778,81126,119455,13377,106078,40723,34349,6374,757,5617,35559,30764,18885,8
0,0,1,1,20.1,36.5,29,14.3,3068779,2139613,526122,42158,11035,472929,403044,101781,30151,21022,5169,414,108,4647,3960,2113506,1547683,399773,279901,119872,166050,2755,163295,58099,48776,9323,537,8786,36378,31730,18586,4
0,0,1,1,11.5,37.2,28.2,23.1,4306440,3339039,427393,21713,11338,394342,540008,128082,33623,26070,3337,170,89,3079,4216,1946534,1400510,344281,235412,108869,201743,5542,196201,57133,44843,12290,614,11676,34070,31231,16804,14
0,0,4,5,20.8,41.9,23.2,14.1,1799417,1098939,456854,37939,11973,406942,243624,70803,25414,15521,6452,536,169,5748,3441,1271477,933152,241681,170599,71082,96644,13392,83252,34839,29367,5472,465,5007,36496,31776,16627,7
0,0,1,1,14.3,36.2,26.4,23.1,4318183,3193046,516915,33671,12256,470988,608222,126769,34063,25188,4078,266,97,3715,4798,1924865,1362289,330432,224937,105495,232144,7541,224603,58030,45039,12991,509,12482,33170,30247,17994,23
0,0,3,2,19.4,41,25.6,14,3134370,2118854,562801,49949,12601,500251,452715,109541,28614,19343,5138,456,115,4567,4133,2105872,1544253,388237,269166,119071,173382,14400,158982,57591,48699,8892,724,8168,36566,31710,19464,11
0,0,3,2,11.5,26.2,22.7,39.6,3533474,2291316,472209,34338,12639,425232,769949,128121,27579,17884,3686,268,99,3319,6010,2890152,2081769,608925,452942,155983,199458,700,198758,83544,70275,13269,446,12823,34594,29623,15500,20
0,0,3,2,19,34.8,24.8,21.4,2884553,1802292,612215,54995,13316,543904,470046,105245,27408,17125,5817,523,127,5168,4466,2451009,1767759,461767,325322,136445,221483,6270,215213,63311,55709,7602,429,7173,38714,31732,30003,7
0,0,3,2,16.7,38,27.3,18.1,2559067,1727407,492640,41865,14132,436643,339020,84382,30327,20471,5838,496,167,5175,4018,2633398,2019864,493207,347900,145307,120327,13292,107035,51636,44437,7199,476,6723,50999,45455,15921,42
0,0,3,2,12.2,30.5,24.1,33.2,4310504,2973272,566893,49388,15033,502472,770339,158834,27138,18719,3569,311,95,3164,4850,3976072,2962964,796886,580302,216584,216222,13125,203097,96899,83787,13112,612,12500,41033,35363,16248,68
0,0,1,1,11.7,38,27.7,22.6,5532266,4087972,676636,41404,15485,619747,767658,156024,35458,26201,4337,265,99,3972,4920,2911569,2132020,494489,335366,159123,285060,8123,276937,73124,59411,13713,473,13240,39817,35886,20917,13
0,0,3,2,18.4,37.2,24,20.4,3178503,2055686,658635,56507,16581,585547,464182,118170,26898,17396,5574,478,140,4955,3928,2299854,1670800,438357,311837,126520,190697,12257,178440,62542,53538,9004,591,8413,36773,31208,21210,9
0,0,1,1,5.8,19.8,25.6,48.9,11151102,8453655,636351,34790,18037,583524,2061096,235039,47444,35967,2707,148,77,2483,8769,6030766,4326980,915515,595679,319836,788271,2613,785658,136375,103711,32664,539,32125,44222,41722,24456,190
0,0,3,2,24.3,37,23.2,15.5,5864112,4240789,800618,80991,18556,701071,822705,192242,30504,22060,4165,421,97,3647,4280,6432501,4810887,1229348,863221,366127,392266,29517,362749,150926,132000,18926,1383,17543,42620,36446,20678,47
0,0,2,2,16.9,35.7,28.1,19.3,5784673,3755858,1002191,86150,18785,897256,1026624,175769,32911,21368,5702,490,107,5105,5841,5557641,4061833,981023,673433,307590,514785,5348,509437,130092,115462,14630,267,14363,42721,35179,35469,28
0,0,3,2,19.9,40,25.7,14.4,3601937,2369718,773333,63378,21763,688192,458886,130871,27523,18107,5909,484,166,5259,3506,2018574,1472006,365745,254593,111152,180823,11649,169174,56496,46019,10477,703,9774,35730,31987,17309,27
0,0,2,2,17.6,32.5,26.3,23.6,8547519,5882058,1296583,128522,27905,1140156,1368878,264863,32271,22208,4895,485,105,4305,5168,6558878,4705709,1109265,753393,355872,743904,6073,737831,157997,135285,22712,667,22045,41513,34784,33469,65
0,0,2,2,14.3,31.9,31,22.7,10854813,7445129,1589427,152910,36852,1399665,1820257,343238,31625,21691,4631,445,107,4078,5303,9215430,6992431,1645294,1112395,532899,577705,7312,570393,225750,194021,31729,1384,30345,40821,36040,18797,88
0,0,1,1,19.3,37.3,27.2,16.2,14856386,10155868,2737108,326629,58754,2351725,1963410,489530,30348,20746,5591,667,120,4804,4011,10228658,7656473,1807493,1234902,572591,764692,5785,758907,242116,207569,34547,372,34175,42247,36886,22206,31
0,0,1,1,18.4,29.6,26.6,25.4,30683096,21282321,4380696,542082,104398,3734216,5020079,873310,35134,24370,5016,621,120,4276,5748,36032901,26743779,6058367,4085701,1972666,3230755,1218,3229537,701657,624407,77250,225,77025,51354,42831,41928,73
0,0,9,12,15.5,35.2,30.8,18.4,94595,62982,17262,759,33,16470,14351,2840,33308,22177,6078,267,12,5799,5053,72383,28038,7892,5841,2051,36453,12147,24306,2145,1321,824,335,489,33745,21225,49706,0
0,0,9,12,13.3,38.7,30.5,17.5,93523,59920,16785,769,43,15973,16818,2881,32462,20798,5826,267,15,5544,5838,63731,31914,9012,6591,2421,22805,15540,7265,2115,1377,738,236,502,30133,23176,14472,0
0,0,9,12,12.2,36.6,35.3,15.9,90709,60570,15031,519,45,14467,15108,2618,34648,23136,5741,198,17,5526,5771,61993,24847,6103,4327,1776,31043,22151,8892,1799,986,813,324,489,34460,25200,18184,0
0,0,9,12,22.3,32.9,29.4,15.5,44256,64390,11895,849,48,10998,13207,2361,37904,27272,5038,360,20,4658,5594,69311,28010,6455,4388,2067,34846,28115,6731,1554,968,586,239,347,44602,28936,19398,0
0,0,9,12,22,31,30.1,16.9,81870,54985,10176,799,59,9318,16709,2252,36354,24416,4519,355,26,4138,7420,56757,23166,5347,3696,1651,28244,19403,8841,1459,898,561,252,309,38901,25797,28612,0
0,0,9,12,12.4,39.5,34.3,13.8,90658,49903,22294,1113,61,21120,18461,3271,27716,15256,6816,340,19,6457,5644,45106,20620,6354,4828,1526,18132,8737,9395,1975,1040,935,469,466,22838,19827,20161,0
0,0,9,10,13.1,30.7,36.6,19.7,60547,38595,10652,498,61,10093,11300,2038,29709,18938,5227,244,30,4952,5545,33920,14734,3967,2923,1044,15219,9251,5968,1250,651,599,307,292,27136,22633,20438,0
0,0,9,10,12.6,27.6,37.8,22.1,68328,41251,14162,666,63,13433,12915,2298,29734,17951,6163,290,27,5846,5620,39853,21137,5740,4215,1525,12976,7031,5945,1415,834,581,230,351,28165,25344,16937,1
0,0,9,12,16.4,34.1,32.1,17.4,83863,50591,20764,747,75,19942,12508,2762,30363,18317,7518,270,27,7220,4529,53711,27495,7113,5061,2052,19103,8800,10303,2093,1136,957,393,564,25662,24203,18268,0
0,0,9,10,18.8,32.3,32.6,16.3,114778,79242,19014,1120,85,17809,16522,3194,35936,24810,5953,351,27,5576,5173,76413,30583,7610,5255,2355,38220,30615,7605,1885,1192,693,315,378,40537,25657,20119,0
0,0,9,10,15.7,37.6,32.6,14,77454,45066,18900,844,86,17970,13488,3025,25605,14898,6248,279,28,5940,4459,47117,26528,7492,5504,1988,13097,7897,5200,2067,1256,811,351,460,22795,21121,11304,0
0,0,9,12,15.6,36.5,30.1,17.9,101122,60422,20757,662,90,20005,19943,3177,31829,19019,6534,208,28,6297,6277,65444,34353,8836,6322,2514,22255,13398,8857,2462,1331,1131,455,676,26582,25810,13102,0
0,0,9,12,15.3,34.5,34.2,15.9,75064,40328,19514,739,94,18681,15222,2697,27832,14953,7235,274,35,6927,5644,44133,21992,6024,4375,1649,16117,7319,8798,1703,985,718,301,417,25915,22327,21098,0
0,0,9,12,14.2,32.8,32,21,150117,89619,31546,1729,107,29710,28952,4984,30120,17981,6329,347,21,5961,5809,99124,51781,13387,9417,3970,33956,20178,13778,3223,1992,1231,373,858,30755,25994,16058,0
0,0,7,9,19.5,32,30.9,17.5,174047,116191,24110,1874,134,22102,33746,5592,31124,20778,4312,335,24,3952,6035,120735,61157,15142,10630,4512,44436,31539,12897,3197,2157,1040,340,700,37765,28353,18424,0
0,0,9,10,24.2,27.7,33.1,15,124462,87493,17183,1791,140,15252,19786,4147,30013,21098,4143,432,34,3678,4771,81180,37130,9579,6865,2714,34471,27154,7317,2067,1380,687,272,415,39274,26906,17631,0
0,0,9,10,14.8,30,36.3,18.9,92022,55561,21277,1027,141,20109,15184,3088,29800,17993,6890,333,46,6512,4917,61933,30656,8063,5824,2239,23214,13487,9727,2097,1310,787,332,455,29534,23402,21378,0
0,0,9,10,19.7,28.5,32.2,19.6,140377,91951,24107,1370,143,22594,24319,4586,30610,20050,5257,299,31,4927,5303,82149,36807,9524,6864,2660,35818,25868,9950,2498,1508,990,352,638,32886,24408,15596,0
0,0,8,5,12.9,39.7,27.8,19.6,104388,77762,14918,964,161,13793,11708,2962,35242,26253,5036,325,54,4657,3953,42633,20993,5908,4181,1727,15732,10249,5483,1474,921,553,216,337,28923,22794,16270,0
0,0,9,10,17.2,32.5,34,16.4,102003,62462,23628,1275,163,22190,15913,3384,30143,18458,6982,377,48,6557,4702,62164,32732,8644,6219,2425,20788,12291,8497,2169,1245,924,415,509,28660,26291,16694,0
0,0,9,12,11.4,41.4,32.4,14.9,130256,73763,32612,1599,167,30846,23881,5238,24868,14082,6226,305,32,5889,4559,78064,46573,13394,9928,3466,18097,8911,9186,3488,2279,1209,557,652,22381,20436,14089,0
0,0,9,10,18.1,34.5,29.7,17.6,117843,81728,16821,1232,185,15404,19294,3300,35710,24766,5097,373,56,4668,5847,88368,42213,10818,7843,2975,35337,29464,5873,2172,1535,637,267,370,40685,27500,15873,0
0,0,9,12,14.5,35.7,33.9,16,66508,34131,19020,754,188,18078,13357,2880,23093,11851,6604,262,65,6277,4638,35756,21526,5523,3954,1569,8707,3036,5671,1690,963,727,364,363,21157,22353,15623,0
0,0,7,11,11.9,36.2,35.1,16.9,192388,124281,35632,1554,190,33888,32475,6443,29860,19289,5530,241,29,5260,5040,151385,94062,23791,16572,7219,33532,17517,16015,4887,3616,1271,355,916,30977,26013,17484,0
0,0,9,10,17.1,29.1,35.4,18.4,149948,98420,27607,1734,195,25678,23921,4473,33523,22003,6172,388,44,5741,5348,95607,35092,9525,6876,2649,50990,23337,27653,2680,1585,1095,463,632,35674,22140,43755,0
0,0,9,10,26.4,25.8,31.5,16.3,191387,149221,20973,1730,195,19048,21193,5882,32538,25369,3566,294,33,3238,3603,149622,70951,16914,11602,5312,61757,40772,20985,4244,2805,1439,368,1071,35255,25294,19594,0
0,0,9,10,12.9,41.5,30.3,15.4,24382,83841,32379,1750,225,30404,25014,5352,26389,15665,6050,327,42,5681,4674,88293,53722,14597,10524,4073,19974,2536,17438,3457,2180,1277,385,892,25540,24643,19549,0
0,0,7,11,7.3,30.3,37.4,25,224995,151582,38753,2160,233,36360,34660,7768,28964,19514,4989,278,30,4681,4462,174235,103552,26455,18493,7962,44228,21655,22573,6169,4476,1693,376,1317,28244,23135,17140,1
0,0,9,10,15,35.6,32,17.4,84242,49697,19725,1149,234,18342,14820,3443,24468,14434,5729,334,68,5327,4304,40738,20486,6107,4545,1562,14145,9721,4424,1854,1046,808,397,411,21973,19585,10764,1
0,0,9,12,15.4,38,29.9,16.7,116523,64000,26700,1112,237,25351,25823,4128,28227,15504,6468,269,57,6141,6256,69048,34212,9710,7108,2602,25126,13982,11144,2607,1622,985,430,555,26486,21092,20079,1
0,0,8,7,16.2,39.1,30.7,14,207228,135148,38953,2380,242,36331,33127,6166,33608,21918,6317,386,39,5892,5373,135550,61379,16661,11904,4757,57510,32626,24884,3957,2538,1419,423,996,34256,24184,24984,0
0,0,7,11,28.5,28,28.3,15.2,229322,170953,29139,2863,261,26015,29230,7687,29832,22239,3791,372,34,3384,3803,199677,115403,27484,18992,8492,56790,36342,20448,4696,3542,1154,256,898,42521,32581,22771,1
0,0,9,12,15.2,40.3,29,15.5,107468,62224,25301,1359,265,23677,19943,4035,26634,15421,6270,337,66,5868,4943,64379,32907,9083,6557,2526,22389,11049,11340,2656,1665,991,359,632,24239,19764,17943,2
0,0,9,10,19,40.8,27.9,12.3,108989,55084,29972,1895,271,27806,23933,3989,27322,13809,7514,475,68,6971,6000,41417,22049,6581,4801,1780,12787,1559,11228,1947,1112,835,315,520,21272,19828,21592,0
0,0,7,11,15.6,36.8,31.4,16.1,169757,100481,34349,2139,273,31937,34927,5642,30088,17809,6088,379,48,5661,6191,110893,64118,20805,15884,4921,25970,18011,7959,3838,2600,1238,442,796,28893,24661,9999,0
0,0,7,11,13.4,35.9,35.7,15,168614,99051,40756,2431,276,38049,28807,6155,27395,16093,6622,395,45,6182,4680,110335,66388,16882,11782,5100,27065,17842,9223,3976,2795,1181,342,839,27750,23752,10993,0
0,0,6,6,19.1,38.6,27.8,14.5,195839,116154,50072,3050,341,46681,29613,7222,27117,16083,6933,422,47,6464,4100,91822,47955,12870,9135,3735,30997,10295,20702,3521,2077,1444,481,963,26078,23089,21497,1
0,0,7,9,16.9,35.8,30.6,16.7,207331,115173,50988,2520,352,48116,41170,6930,29918,16619,7358,364,51,6943,5941,126526,68823,19584,14288,5296,38119,5184,32935,4614,2880,1734,469,1265,27422,23897,26036,0
0,0,7,9,15.2,29.8,33.2,21.8,192809,124818,36022,1983,414,33625,31969,7027,27438,17763,5126,282,59,4785,4549,150294,90595,25772,19108,6664,33927,22435,11492,4701,3605,1096,355,741,31971,25130,15509,1
0,0,7,9,15.2,35.5,32.9,16.4,172708,103029,37777,1476,438,35863,31902,6404,26969,16088,5899,230,68,5600,4982,108238,64236,17579,12770,4809,26423,10938,15485,3577,2532,1045,362,683,30259,25370,22672,0
0,0,9,12,16.6,40.2,31.8,11.4,82717,46012,24607,1541,442,22624,12098,3523,23479,13060,6985,437,125,6422,3434,37891,18461,5276,3826,1450,14154,6539,7615,1549,818,731,286,445,24462,22568,17112,0
0,0,6,6,15.3,33.7,33.2,17.8,245048,160179,45152,2314,463,42375,39717,8249,29706,19418,5474,281,56,5137,4815,128902,72523,18023,12401,5622,38356,23378,14978,4671,2809,1862,754,1108,27596,25818,13518,1
0,0,7,11,13.7,27.7,37.5,21,288174,181906,52574,3134,509,48931,53694,9618,29962,18913,5466,326,53,5087,5583,206069,122366,30381,20663,9718,53322,26875,26447,6423,4538,1885,462,1423,32083,26965,18585,1
0,0,7,9,14.9,45.7,26.2,13.2,335421,218910,61898,3284,551,58063,54613,10270,32660,21315,6027,320,54,5654,5318,254832,155001,41080,26765,14315,58751,48010,10741,7630,5398,2232,813,1419,33399,28715,7569,0
0,0,3,2,10.1,45.5,27.1,17.3,229942,131704,32718,1653,575,30490,65520,6925,33205,19019,4725,239,83,4403,9461,57260,36486,9564,6585,2979,11210,-430,11640,2848,1593,1255,560,695,20105,22904,16748,0
0,0,7,9,14.5,38.1,29.4,18,246639,141097,61952,3467,578,57907,43590,9741,25320,14485,6360,356,59,5945,4475,153915,95105,26082,18571,7511,32728,15303,17425,5798,4229,1569,417,1152,26546,22489,15126,0
0,0,6,6,15.6,38.6,27.9,17.9,352863,231314,71845,3360,600,67885,49704,13012,27118,17777,5521,258,46,5217,3820,188247,94927,25523,18039,7484,67797,43175,24622,6738,4322,2416,866,1550,27938,21964,15885,0
0,0,3,2,19.8,36.7,28.6,14.8,200859,134788,40984,2912,627,37445,25087,7868,25529,17131,5209,370,80,4759,3188,121082,76207,20324,14394,5930,24551,15693,8858,3848,2665,1183,443,740,31466,28595,11970,0
0,0,7,9,13,39.5,31,16.5,261252,163819,46542,2612,665,43265,50891,8444,30939,19401,5512,309,79,5124,6027,126418,78053,21562,15301,6261,26803,12346,14457,5011,3571,1440,488,952,25228,21857,15186,0
0,0,9,8,13.8,37.9,32,16.3,163541,111696,28885,1634,669,26582,22960,6097,26823,18320,4738,268,110,4360,3766,63504,34371,9410,6746,2664,19723,8987,10736,2775,1534,1241,451,790,22884,22406,13590,1
0,0,7,9,18.9,37.2,33,10.9,263739,160342,62479,4917,782,56780,40918,9772,26989,16408,6394,503,80,5810,4187,192266,130253,36328,25532,10796,25685,10758,14927,6027,4556,1471,475,996,31901,28589,14987,0
0,0,7,9,16.6,33.6,32.2,17.5,251499,152216,57994,3663,792,53539,41289,10396,24192,14642,5578,352,76,5150,3972,147466,90823,23815,17073,6742,32828,16124,16704,5273,3674,1599,463,1136,27966,24720,14704,0
0,0,6,6,15.4,39.1,26.5,19,299598,188652,62858,4909,810,57139,48088,10087,29701,18702,6232,487,80,5665,4767,210626,133888,32926,22733,10193,43812,22915,20897,6754,5155,1599,508,1091,31185,25972,19154,0
0,0,7,8,36.3,26.9,23.3,13.6,553109,401281,81433,11717,896,68820,70395,22334,24765,17967,3646,525,40,3081,3152,506117,360290,85381,57919,27462,60446,13765,46681,14386,12177,2209,266,1943,35181,29588,24025,0
0,0,6,4,18.1,42.3,27.9,11.7,30080,125101,47890,3270,1140,43480,28018,8087,24856,15469,5922,404,141,5377,3465,92172,50644,13784,9757,4027,27744,9254,18490,3836,2151,1685,613,1072,24028,23544,17248,0
0,0,5,8,12.8,29.9,28.1,29.2,814384,540503,128961,7318,1176,120467,144920,27429,29691,19706,4702,267,43,4392,5283,624212,425997,107679,75149,32530,90536,9422,81114,21447,16291,5156,615,4541,29105,26149,17863,2
0,0,6,4,13.1,40.6,26.2,20.1,276418,185534,52707,3135,1281,48291,38177,8622,32060,21519,6113,364,149,5601,4428,247585,163251,47635,35618,12017,36699,9030,27669,6116,4306,1810,570,1240,40482,37912,22314,0
0,0,5,8,30.1,23.1,30.3,16.4,825774,584205,122926,15484,1420,106022,118643,32354,25523,18057,3799,479,44,3277,3667,692442,477162,115843,79801,36042,99437,31473,67964,19734,16726,3008,566,2442,35089,28528,27831,4
0,0,7,8,17.7,31.4,34.2,16.6,825434,494301,161198,10945,1591,148662,169935,27536,29977,17951,5854,397,58,5399,6171,557940,387434,94728,64361,30367,75778,16276,59502,18297,13878,4419,613,3806,30494,27917,15634,3
0,0,7,9,16.5,35.1,33.3,15,43308,261943,100860,8205,1624,91031,61823,16591,25594,15788,6079,495,98,5487,3726,319114,214842,55848,38223,17625,48424,15393,33031,10510,8037,2473,678,1795,30363,26732,18402,2
0,0,6,5,14.1,32.1,31.6,22.2,965659,669273,149771,7325,1757,140689,146615,29375,32873,22784,5099,249,60,4789,4991,764560,481298,125205,87807,37398,158057,33457,124600,21057,15830,5227,999,4228,36309,30404,29470,4
0,0,6,4,15.8,31.7,34.7,17.8,451222,300616,93861,8022,1777,84062,56745,15002,30077,20038,6257,535,118,5603,3782,340049,189293,48418,32581,15837,102338,-1633,103971,9599,7248,2351,796,1555,35425,26117,66862,3
0,0,8,6,16.3,46.2,22.9,14.6,33667,186167,166,1670,1834,98232,59942,10367,29182,17958,5067,271,37,4760,6157,209991,133282,34390,23927,10463,42319,27035,15284,7144,5147,1997,902,1095,29394,25895,13958,2
0,0,6,5,10.8,37.4,29.1,22.7,568160,407103,74700,5344,1844,67512,86357,19444,29220,20937,3842,275,95,3472,4441,342038,247234,61906,42654,19252,32898,4341,28557,11703,8703,3000,725,2275,29227,28408,12553,2
0,0,6,3,15.3,41.5,25.1,18,424661,265073,82944,6779,1928,74237,76644,16865,25180,15717,4918,402,114,4402,4545,279415,200860,54687,37808,16879,23868,8026,15842,9094,7351,1743,586,1157,30725,27324,13692,3
0,0,7,9,13.6,39.3,31.9,15.2,595603,400100,99954,6084,1955,91915,95549,19285,30884,20747,5183,315,101,4766,4955,307378,192610,54394,38274,16120,60374,30134,30240,10516,7745,2771,885,1886,29230,24869,16034,1
0,0,3,2,12.3,45.9,26.4,15.4,368301,255543,65564,4958,2069,58537,47194,13362,27563,19125,4907,371,155,4381,3532,188791,130117,30865,20063,10802,27809,3497,24312,7266,5006,2260,997,1263,25983,25992,19249,0
0,0,6,6,19.7,38.9,30.2,11.3,508136,315402,127159,13379,2165,111615,65575,21750,23363,14501,5846,615,100,5132,3015,262411,179857,47923,33123,14800,34631,7551,27080,9018,6554,2464,686,1778,29099,27442,15231,1
0,0,5,8,32.6,24.9,28.3,14.3,914276,656119,128142,21541,2182,104419,130015,36754,24876,17852,3486,586,59,2841,3537,747910,507804,121740,83507,38233,118366,38909,79457,21823,18224,3599,379,3220,34272,27865,24676,1
0,0,5,8,6.2,22.5,30.9,40.5,31445,1221926,140,1614,2521,219437,160286,64751,27574,18871,2858,184,38,2636,5844,1205910,863554,236116,170143,65973,106240,7025,99215,37094,31448,5646,438,5208,32510,27460,19050,11
0,0,3,2,11.1,42.5,28.4,17.9,536033,378250,83958,4867,2548,76543,73825,19159,27978,19743,4382,254,133,3995,3853,156772,105387,26998,18554,8444,24387,2332,22055,6728,3863,2865,974,1891,23301,27281,11663,0
0,0,2,2,14.7,30.1,32.2,23,960763,643183,177663,10719,2581,164363,139917,33566,28623,19162,5293,319,77,4897,4168,614916,434184,104388,68062,36326,76344,15597,60747,19776,15166,4610,721,3889,31094,28629,15620,1
0,0,4,5,14.6,31.1,36.1,18.3,942901,588717,208414,16765,2708,188941,145770,35928,26244,16386,5801,467,75,5259,4057,615167,440947,114502,78425,36077,59718,11572,48146,19676,15309,4367,896,3471,31265,28803,13871,5
0,0,2,2,13.7,37.8,32.9,15.7,716554,496741,128409,9040,2719,116650,91404,24795,28899,20034,5179,365,110,4705,3686,316371,181907,50645,34983,15662,83819,40211,43608,10212,6806,3406,960,2446,30980,26727,17828,3
0,0,5,8,18.2,31.9,27,23,876633,575588,157635,14268,2777,140590,143410,35936,24394,16017,4387,397,77,3912,3991,693435,506230,131004,91167,39837,56201,11091,45110,23147,19250,3897,802,3095,29958,26298,14575,4
0,0,5,8,14,30,38.9,17.1,898045,588491,117577,20035,3045,94497,191977,27099,33139,21716,4339,739,112,3487,7084,1176675,844765,294658,222965,71693,37252,2908,34344,24839,23018,1821,202,1619,47372,36700,21213,0
0,0,3,2,14.5,42.3,28.9,14.3,438956,287869,87241,6244,3386,77611,63846,16869,26021,17065,5172,370,201,4601,3785,121764,77971,22010,15717,6293,21783,1939,19844,6252,3500,2752,903,1849,19476,22277,10732,1
0,0,5,8,18.8,30.2,35,16,909771,547245,226679,20429,3482,202768,135847,35034,25968,15620,6470,583,99,5788,3878,664577,465212,126170,86549,39621,73195,3968,69227,21360,17195,4165,873,3292,31113,27055,21029,0
0,0,7,8,17,31.9,35.3,15.9,604890,350872,165775,12402,3595,149778,88243,21913,27604,16012,7565,566,164,6835,4027,382201,264942,71198,49027,22171,46061,7744,38317,13131,10313,2818,875,1943,29107,25690,19721,0
0,0,1,1,14.7,39.5,29.3,16.5,703569,488193,129073,10600,3660,114813,86303,25527,27562,19125,5056,415,143,4498,3381,411001,291742,70398,46420,23978,48861,1190,47671,14205,10453,3752,903,2849,28934,27910,16733,5
0,0,1,1,12.5,36.7,31.5,19.4,954041,685860,135697,9540,3927,122230,132484,30758,31018,22299,4412,310,128,3974,4307,352054,247554,61181,40876,20305,43319,-3180,46499,13387,9033,4354,1310,3044,26298,27406,15276,3
0,0,5,8,13,34.5,32.1,20.4,1729155,1177637,255180,21011,4280,229889,296338,54361,31809,21663,4694,387,79,4229,5451,1463216,972791,243199,165151,78048,247226,14620,232606,38581,32239,6342,650,5692,37926,30174,40865,5
0,0,4,5,15.5,30.7,30,23.9,989120,579434,222080,20793,4445,196842,187606,38638,25600,14996,5748,538,115,5095,4855,689196,503788,134012,92836,41176,51396,6538,44858,23412,19535,3877,776,3101,29438,25789,14466,3
0,0,7,11,16.9,35.8,32.1,15.2,38817,219427,161,4372,5985,21160964,14256293,13733,26171,15978,6030,542,93,5395,4163,247970,161721,44149,31113,13036,42100,4683,37417,8271,6353,1918,540,1378,29981,25456,27153,3
0,0,4,5,17.3,30.6,34.9,17.3,1776136,1126167,353628,28336,6298,318994,296341,63778,27849,17658,5545,444,99,5002,4646,1230199,854851,209678,142714,66964,165670,30086,135584,37170,29386,7784,1400,6384,33097,29090,21238,3
0,0,9,10,18.8,38.1,27.9,15.2,44279,99061,134,4319,7129,10690545,7197869,6022,26993,16450,6166,306,59,5801,4377,88815,49457,13738,10055,3683,25620,17273,8347,3790,2421,1369,685,684,23434,20428,12203,0
0,0,2,2,12.7,32.3,34.6,20.4,1938108,1389476,276797,19454,7411,249932,271835,62547,30986,22215,4425,311,118,3996,4346,762522,492966,138766,99820,38946,130790,20950,109840,26518,18448,8070,1199,6871,28755,26722,15986,9
0,0,3,2,7.6,22.3,27.4,42.7,3039109,2120313,337569,24609,8414,304546,581227,105681,28757,20063,3194,233,80,2882,5500,2089959,1523323,390905,271234,119671,175731,-538,176269,67579,55103,12476,848,11628,30926,27645,15159,16
0,0,3,2,11.9,33.6,28.4,26,5525473,3616794,965345,78018,21671,865656,943334,171893,32145,21041,5616,454,126,5036,5488,4751117,3599959,841091,555941,285150,310067,3797,306270,118042,100960,17082,783,16299,40249,35657,18791,3
0,0,1,1,26,34.3,27.7,12,3671464,2489628,801468,104723,25950,670795,380368,154356,23786,16129,5192,678,168,4346,2464,4387405,3347445,787779,511353,276426,252181,589,251592,93701,84614,9087,155,8932,46823,39561,28167,3
0,0,1,1,5.1,17.5,29.6,47.7,22317312,16119382,1662442,77209,46378,1538855,4535488,504441,44242,31955,3296,153,92,3051,8991,16845798,13805020,2807995,1734239,1073756,232783,2401,230382,393159,321310,71849,527,71322,42847,42965,3230,186
0,0,2,2,14.9,29.3,30.4,25.4,15724088,10018368,2127623,241076,58076,1828471,3578097,467113,33662,21447,4555,516,124,3914,7660,12918431,9846638,2363557,1579224,784333,708236,23018,685218,310342,260392,49950,1201,48749,41626,37815,14056,75
0,0,9,12,49.1,30.8,13.8,6.3,149521,73151,60173,10137,698,49338,16197,7823,19113,9351,7692,1296,89,6307,2070,77110,50707,16892,12747,4145,9511,-211,9722,2626,2001,625,160,465,29364,25341,20908,0
0,0,7,8,30.5,39,19.1,11.5,180479,103517,53237,7320,731,45186,23725,7090,25455,14600,7509,1032,103,6373,3346,129424,73821,24580,18441,6139,31023,23939,7084,3639,2976,663,147,516,35566,24805,13729,1
0,0,9,10,44,36.4,12.5,7.1,136060,63249,56087,6453,801,48833,16724,7066,19256,8951,7938,913,113,6911,2367,61623,39223,13168,10152,3016,9232,2442,6790,2889,1788,1101,440,661,21330,21937,10272,0
0,0,8,7,32,36.5,21.4,10.1,183189,103182,49811,2680,821,46310,30196,8327,21999,12391,5982,322,99,5561,3626,87259,55851,18356,14291,4065,13052,4134,8918,3242,2409,833,251,582,26915,23184,15323,0
0,0,6,6,33,40.2,19.4,7.3,226706,138292,61974,5040,823,56111,26440,9138,24809,15134,6782,552,90,6140,2893,93150,47709,15345,11671,3674,30096,15033,15063,3568,2122,1446,641,805,26107,22483,18712,0
0,0,9,8,42,37.6,13.7,6.6,202829,123966,59397,7546,854,50997,19466,10094,20094,12281,5884,748,85,5052,1928,104969,65431,22279,17244,5035,17259,1163,16096,4624,2592,2032,856,1176,22701,25243,13687,0
0,0,3,2,22.8,45.7,23.3,8.1,211328,150695,40736,3958,893,35885,19897,8508,24839,17712,4788,465,105,4218,2339,257301,190052,50990,36955,14035,16259,5451,10808,5229,4298,931,353,578,49207,44219,18699,0
0,0,8,7,46,29.7,15.3,9,259874,131386,100864,18193,955,81716,27624,13536,19199,9706,7452,1344,71,6037,2041,176190,130384,34498,25184,9314,11308,-68,11376,3986,3474,512,15,497,44202,37531,22889,0
0,0,1,1,29.3,40.9,22.2,7.6,18424,137910,42374,4611,958,36805,18886,8788,22664,15693,4822,525,109,4188,2149,48037,29340,9591,7488,2103,9106,-422,9528,2218,1030,1188,463,725,21658,28485,13142,2
0,0,9,8,25.7,40.8,25.1,8.4,253754,162644,61759,4549,970,56240,29351,9650,26296,16854,6400,471,101,5828,3042,129480,78902,21081,14969,6112,29497,11267,18230,4007,2630,1377,441,936,32313,30001,19476,0
0,0,1,1,30.4,40.6,19.5,9.5,221190,154984,45063,5002,974,39087,21143,8533,25922,18163,5281,586,114,4581,2478,64482,38949,11448,8642,2806,14085,-62,14147,2820,1505,1315,555,760,22866,25880,18614,0
0,0,9,8,23.7,40.4,25.3,10.6,230739,156593,50999,4389,976,45634,23147,8269,27904,18937,6167,531,118,5519,2799,179518,118369,29002,20408,8594,32147,23852,8295,4087,2974,1113,427,686,43924,39801,12092,0
0,0,9,12,47.4,31,13.7,7.8,112934,56789,44314,8280,982,35052,11831,6867,16446,8270,6453,1206,143,5104,1723,32464,22168,7573,5974,1599,2723,-777,3500,1652,933,719,396,323,19651,23760,10836,0
0,0,9,12,47.5,30.1,16,6.3,250136,128551,103307,16527,988,85792,18278,11797,21203,10897,8757,1401,84,7272,1549,102820,72947,20152,14966,5186,9721,-105,9826,2741,2247,494,19,475,37512,32464,20686,0
0,0,8,4,32.1,41.2,17.6,9.1,252562,168634,54698,6580,1022,47096,29230,10900,23171,15471,5018,604,94,4321,2682,79463,48047,15424,11955,3469,15992,1240,14752,3547,1753,1794,737,1057,22403,27408,13956,0
0,0,8,4,31.2,38.5,17,13.3,298011,196673,62080,6052,1058,54970,39258,11339,26282,17345,5475,534,93,4848,3462,144155,92888,27643,20360,7283,23624,8257,15367,5185,3329,1856,994,862,27802,27903,17827,0
0,0,6,4,31.9,37.6,22.3,8.3,612072,525902,60190,6451,1085,52654,25980,10511,58232,50033,5726,614,103,5009,2472,690459,256352,69968,50069,19899,364139,620,363519,8130,7027,1103,291,812,84927,36481,447683,0
0,0,9,9,42.2,34.6,14.8,8.4,242541,137592,80015,9958,1094,68963,24934,11425,21229,12043,7004,872,96,6036,2182,136318,83082,27092,20569,6523,26144,5287,20857,5610,3525,2085,856,1229,24299,23569,16971,0
0,0,3,2,29.2,38.6,23.6,8.7,282898,200654,56504,5350,1151,50003,25740,9811,28835,20452,5759,545,117,5097,2624,129926,48074,14331,10614,3717,67521,54754,12767,3164,1982,1182,367,815,41064,24255,15665,1
0,0,2,2,29.1,43.5,20.3,7.1,383515,266065,81141,7488,1160,72493,36309,14004,27386,18999,5794,535,83,5177,2593,249734,134294,36810,26818,9992,78630,58245,20385,5500,3977,1523,505,1018,45406,33768,20025,0
0,0,8,7,38.6,36.2,16.1,9.1,249834,145085,74658,7508,1174,65976,30091,11406,21904,12720,6546,658,103,5784,2638,88098,47377,15349,11816,3533,25372,9401,15971,4178,2254,1924,977,947,21086,21019,16865,0
0,0,8,7,36.5,36.7,17.6,9.2,334343,238337,62172,7059,1196,53917,33834,11965,27943,19920,5196,590,100,4506,2828,158275,65230,20833,15402,5431,72212,42929,29283,4621,2971,1650,643,1007,34251,21956,29079,0
0,0,9,10,47.1,33.4,12.8,6.8,250413,146347,82743,15194,1221,66328,21323,13596,18418,10764,6086,1118,90,4878,1568,113455,70680,26614,21177,5437,16161,843,15318,4649,3015,1634,617,1017,24404,23443,15062,0
0,0,6,6,26.9,41.2,21.9,10,336743,209539,83276,7786,1309,74181,43928,12816,26275,16350,6498,608,102,5788,3428,183763,114065,32847,24028,8819,36851,17673,19178,5847,4307,1540,564,976,31429,26484,19650,1
0,0,8,6,39.3,40.4,13.9,6.4,294963,188912,75563,8962,1389,65212,30488,12900,22865,14644,5858,695,108,5055,2363,135541,81340,25008,18695,6313,29193,15622,13571,4623,3137,1486,673,813,29319,25929,16692,0
0,0,8,5,41,34.5,14.5,10.1,252695,159289,68100,10955,1403,55742,25306,11538,21901,13806,5902,949,122,4831,2193,84794,54056,16827,12433,4394,13911,2517,11394,3584,2196,1388,664,724,23659,24616,15738,0
0,0,7,12,42.5,31.2,16.4,10,305322,146028,129056,23716,1419,103921,30238,14792,20641,9872,8725,1603,96,7025,2044,146382,101890,31084,23501,7583,13408,-291,13699,4415,3627,788,181,607,33156,28092,22568,1
0,0,6,6,43.9,36.5,13.1,6.5,270416,164792,82044,14275,1453,66316,23580,13117,20616,12563,6255,1088,111,5056,1798,112547,71998,22459,17014,5445,18090,869,17221,4235,2944,1291,212,1079,26575,24456,15960,0
0,0,9,10,42.6,36.8,13.3,7.4,322546,183992,105307,13451,1459,90397,33247,15845,20356,11612,6646,849,92,5705,2098,152853,92589,30927,23648,7279,29337,6861,22476,6203,3931,2272,1179,1093,24642,23554,20564,0
0,0,1,1,27.2,46.9,16.2,9.7,346861,239098,66501,7773,1459,57269,41262,14884,23304,16064,4468,522,98,3848,2772,116308,79798,23298,17438,5860,13212,-3556,16768,4820,2821,1999,828,1171,24130,28287,14319,1
0,0,1,1,24.6,40.3,24,11.1,408713,311383,58904,4884,1480,52540,38426,14929,27377,20858,3946,327,99,3519,2574,84941,46216,13917,10351,3566,24808,-420,25228,4007,1881,2126,532,1594,21198,24570,15827,0
0,0,3,2,29,40.2,19.9,10.9,355317,233637,74218,7606,1487,65125,47462,13793,25761,16939,5381,551,108,4722,3441,119322,69104,21157,15681,5476,29061,6957,22104,5180,3008,2172,749,1423,23035,22973,15533,0
0,0,6,6,23.1,42.9,23.1,10.9,447418,300747,88211,7728,1490,78993,58460,15335,29176,19612,5752,504,97,5151,3812,307194,172508,47490,33736,13754,87196,58429,28767,7360,5877,1483,285,1198,41738,29353,24013,2
0,0,6,6,41.5,37.3,14.3,6.9,312847,183428,99789,15538,1514,82737,29630,14780,21167,12411,6752,1051,102,5598,2005,100649,64021,20106,14643,5463,16522,733,15789,4116,2652,1464,410,1054,24453,24141,14980,2
0,0,1,1,26.6,44.5,19.1,9.8,26788,286291,78794,7774,1539,69481,47807,15368,26867,18629,5127,506,100,4521,3111,167428,106836,31327,23466,7861,29265,2469,26796,6561,3910,2651,810,1841,25519,27324,14555,0
0,0,6,6,30.6,35.7,23.2,10.5,369247,236413,83488,9339,1594,72555,49346,16315,22632,14491,5117,572,98,4447,3025,113018,61463,18849,14035,4814,32706,2588,30118,4836,2501,2335,750,1585,23370,24575,19002,1
0,0,6,7,41.8,33,18.5,6.6,315227,168179,115723,17376,1621,96726,31325,15756,20007,10674,7345,1103,103,6139,1988,141718,97284,29328,21729,7599,15106,-47,15153,4704,3402,1302,294,1008,30127,28596,15033,0
0,0,6,6,26.4,41,20.6,11.9,458149,318416,86621,8785,1699,76137,53112,16998,26953,18733,5096,517,100,4479,3125,423625,283224,79342,56820,22522,61059,21121,39938,11281,9225,2056,451,1605,37552,30702,24883,0
0,0,6,5,19.6,43,25.4,12,575323,416584,84754,7340,1725,75689,73985,19987,28785,20843,4240,367,86,3787,3702,203156,137998,42213,31490,10723,22945,-3800,26745,7223,4679,2544,631,1913,28126,29493,13981,0
0,0,8,7,41.8,35.1,16.1,7,376667,234187,100480,13761,1730,84989,42000,18040,20880,12982,5570,763,96,4711,2328,190561,109152,34085,25565,8520,47324,3472,43852,7601,4600,3001,1274,1727,25071,23729,25392,0
0,0,9,10,38.2,34.4,17.8,9.6,363205,196421,119172,15847,1767,101558,47612,17018,21342,11542,7003,931,104,5968,2798,227966,146588,47486,35056,12430,33892,2614,31278,8830,6381,2449,760,1689,25817,22973,18519,0
0,0,9,10,47.4,31,14.9,6.7,293053,131568,133347,24627,1780,106940,28138,17758,16503,7409,7509,1387,100,6022,1585,137822,87394,29484,22704,6780,20944,-1252,22196,4626,3367,1259,129,1130,29793,25956,19642,1
0,0,7,8,42.3,37,12.5,8.3,342208,206509,104482,14119,1802,88561,31217,16911,20236,12212,6178,835,107,5237,1846,137560,89681,27077,20259,6818,20802,744,20058,5368,3669,1699,675,1024,25626,24443,19588,0
0,0,6,6,25.8,42.6,20.9,10.6,466375,311978,92941,9624,1803,81514,61456,18314,25465,17035,5075,525,98,4451,3356,241978,160024,47372,35216,12156,34582,3510,31072,7882,5339,2543,965,1578,30700,29973,19691,0
0,0,7,9,42.2,35.8,14.8,7.2,412001,233827,133684,21334,1817,110533,44490,20516,20082,11397,6516,1040,89,5388,2169,241033,156987,55262,42378,12884,28784,7748,21036,8524,6779,1745,720,1025,28277,23158,20523,0
0,0,8,5,42.6,34.8,16.2,6.4,270668,160980,86166,14225,1823,70118,23522,13861,19527,11614,6216,1026,132,5059,1697,100737,55546,18062,13731,4331,27129,3337,23792,4415,2515,1900,621,1279,22817,22086,18602,0
0,0,6,4,29.5,43.9,17.5,9.1,450222,291840,99596,12982,1824,84790,58786,19251,23387,15160,5174,674,95,4404,3054,306928,204071,59557,43271,16286,43300,11750,31550,9800,7322,2478,936,1542,31319,27871,20460,0
0,0,6,6,35.5,39.2,16.2,9.1,17889,275367,98880,10777,1889,86214,46222,18910,22235,14562,5229,570,100,4559,2444,208807,129398,42101,31543,10558,37308,9664,27644,7802,5067,2735,1070,1665,26763,25537,16603,0
0,0,2,2,24.6,38.7,23.2,13.5,618104,417932,100562,10110,1893,88559,99610,19908,31048,20993,5051,508,95,4448,5004,355864,232906,65595,47325,18270,57363,27648,29715,10238,7807,2431,775,1656,34759,29833,17944,2
0,0,2,2,17.4,29.5,27.3,25.9,947900,684968,98797,7744,1902,89151,164135,23933,39606,28620,4128,324,79,3725,6858,618487,372881,100638,72441,28197,144968,92358,52610,15416,11722,3694,576,3118,40120,31810,16873,3
0,0,6,6,24.2,41.6,20.7,13.5,557230,368292,114700,10934,2086,101680,74238,21229,26249,17349,5403,515,98,4790,3497,364570,255071,71582,52599,18983,37917,1256,36661,10588,7422,3166,973,2193,34432,34367,16717,5
0,0,8,7,31.1,44.2,17.3,7.4,439016,263192,107624,12762,2148,92714,68200,19579,22423,13443,5497,652,110,4735,3483,158608,85842,26942,20371,6571,45824,9827,35997,6778,3756,3022,1324,1698,23400,22855,21200,0
0,0,6,3,26.7,35.8,23.1,14.4,463042,288016,92966,11058,2178,79730,82060,16923,27362,17019,5493,653,129,4711,4849,395597,278723,83875,62523,21352,32999,4633,28366,12036,9734,2302,653,1649,32868,28634,17202,1
0,0,7,11,36.2,35.1,19.4,9.3,561849,322036,178955,24750,2257,151948,60858,23332,24081,13802,7670,1061,97,6512,2608,264348,176942,51888,38147,13741,35518,-577,36095,8399,6870,1529,178,1351,31474,25756,26717,0
0,0,7,8,32,36.1,19.8,12.2,570381,350898,153349,15845,2320,135184,66134,23755,24011,14772,6455,667,98,5691,2784,403392,276953,83157,60637,22520,43282,8274,35008,14193,11197,2996,840,2156,28422,24735,16237,0
0,0,1,1,27.6,44.2,18.8,9.4,593907,424438,114062,14168,2376,97518,55407,23993,24753,17690,4754,591,99,4064,2309,227020,148199,42482,30884,11598,36339,2049,34290,8979,5739,3240,879,2361,25283,25823,14524,0
0,0,7,9,29.1,29,20,21.9,494372,304356,129989,14739,2393,112857,60027,22362,22108,13610,5813,659,107,5047,2684,391721,276704,90023,69391,20632,24994,729,24265,12553,10642,1911,359,1552,31205,26001,15635,0
0,0,7,8,43.4,33.2,14.5,9,602314,296793,234415,37013,2408,194994,71106,29130,20677,10189,8047,1271,83,6694,2441,378868,265792,78692,58472,20220,34384,-173,34557,11765,10206,1559,59,1500,32203,26043,23038,0
0,0,6,6,33,41.4,18.1,7.4,555569,356614,137170,16523,2597,118050,61785,23611,23530,15104,5810,700,110,5000,2617,313683,188182,57151,42359,14792,68350,27179,41171,10025,7399,2626,873,1753,31290,25433,23486,0
0,0,7,9,45.9,32.6,12.8,8.8,627020,327032,234129,45148,2638,186343,65859,31570,19861,10359,7416,1430,84,5903,2086,361809,246548,74747,55377,19370,40514,-778,41292,11661,9370,2291,326,1965,31027,26312,21014,0
0,0,6,6,31.5,39.5,19.5,9.6,696668,467511,148992,15210,2697,131085,80165,26721,26072,17496,5576,569,101,4906,3000,476575,283099,81315,59864,21451,112161,52622,59539,12718,8999,3719,1052,2667,37472,31459,22324,0
0,0,7,9,41.3,34.3,15.6,8.9,628916,297384,263310,38115,2735,222460,68222,30277,20772,9822,8697,1259,90,7347,2253,360715,270002,74528,54222,20306,16185,-235,16420,9911,8922,989,27,962,36395,30262,17069,2
0,0,7,11,41.7,31.4,18.1,8.9,735445,419518,249441,37386,2771,209284,66486,28851,25491,14541,8646,1296,96,7254,2304,624016,465216,122959,87691,35268,35841,-124,35965,16225,14577,1648,46,1602,38460,31914,22450,0
0,0,6,5,29.5,39.3,17.8,13.4,613116,411414,125274,17209,2787,105278,76428,24491,25034,16799,5115,703,114,4299,3121,422140,297386,87767,63928,23839,36987,4560,32427,13851,11010,2841,604,2237,30477,27011,14496,3
0,0,7,8,35.4,40.8,15.4,8.4,521780,325272,137751,18191,2801,116759,58757,24719,21108,13159,5573,736,113,4723,2377,194856,115208,37303,28695,8608,42345,6023,36322,8046,4703,3343,1139,2204,24218,24497,16480,3
0,0,1,1,22.1,39.9,26.7,11.3,675065,454263,115502,12715,2969,99818,105300,29732,22705,15279,3885,428,100,3357,3542,198121,118601,36076,27172,8904,43444,5385,38059,7050,4440,2610,811,1799,28102,26712,21156,0
0,0,7,9,23.1,38,25.2,13.7,856794,547664,189197,12807,3205,173185,119933,30870,27755,17741,6129,415,104,5610,3885,593109,402058,111311,80737,30574,79740,18119,61621,15388,11281,4107,783,3324,38544,35640,18538,0
0,0,7,8,23.4,34.3,23,19.3,761018,466690,155517,14886,3223,137408,138811,27922,27255,16714,5570,533,115,4921,4971,689574,497423,140343,99473,40870,51808,1679,50129,20201,17021,3180,598,2582,34136,29224,19415,2
0,0,2,2,25,36.3,23.2,15.6,1007484,678299,178333,19726,3268,155339,150852,34377,29307,19731,5188,574,95,4519,4388,669062,478128,136072,99529,36543,54862,3916,50946,18763,15096,3667,783,2884,35659,31672,17665,10
0,0,6,6,37.2,37.1,18,7.7,554128,346432,143744,17542,3369,122833,63952,25181,22006,13758,5708,697,134,4878,2540,316795,209393,65788,48552,17236,41614,10649,30965,12224,8503,3721,1392,2329,25916,24626,13295,2
0,0,7,8,22.1,30.3,23.6,24,941359,624458,179150,13479,3384,162287,137751,35788,26304,17449,5006,377,95,4535,3849,707758,450736,144715,110907,33808,112307,34425,77882,21648,17376,4272,751,3521,32694,25940,22119,1
0,0,2,2,19.5,33.3,26.9,20.3,1238013,954967,140528,16187,3433,120908,142518,39637,31234,24093,3545,408,87,3050,3596,1438147,1072410,272017,192437,79580,93720,19950,73770,29294,24504,4790,775,4015,49094,43765,18374,13
0,0,7,8,38.7,31.5,16.5,13.4,798852,428265,279178,38174,3485,237519,91409,36253,22035,11813,7701,1053,96,6552,2521,498050,353807,103411,73648,29763,40832,433,40399,15640,12919,2721,496,2225,31845,27387,18157,1
0,0,1,1,20.9,34.5,25.9,18.7,1165987,843854,146909,13869,3515,129525,175224,37800,30846,22324,3886,367,93,3427,4636,690507,479521,132278,94980,37298,78708,3126,75582,20486,15076,5410,1388,4022,33706,31807,18792,6
0,0,2,2,20.9,32.3,25.2,21.5,1264947,904327,173211,21692,3518,148001,187409,43503,29077,20788,3982,499,81,3402,4308,732406,468015,123935,87285,36650,140456,9310,131146,21652,15944,5708,635,5073,33826,29354,25852,9
0,0,6,5,30.5,40.4,18,11.1,1039797,683887,224804,25491,3561,195752,131106,40320,25789,16961,5575,632,88,4855,3252,794430,533006,156335,113958,42377,105089,24347,80742,25215,19178,6037,1883,4154,31506,27793,19437,0
3,0,5,8,15.4,36,25.6,23,996317,528675,277244,22455,9181,245608,190398,36292,27453,14567,7639,619,253,6768,5246,609681,432495,141206,106867,34339,35980,-141,36121,16995,13467,3528,145,3383,35874,32115,10677,21
3,0,7,11,14,35.1,31,19.8,977642,505577,196164,14261,9341,172562,275901,26280,37201,19238,7464,543,355,6566,10499,521237,374780,106209,74644,31565,40248,-535,40783,14812,10595,4217,288,3929,35190,35373,10380,5
3,0,7,11,18.1,40.6,27.3,13.9,739637,346474,228616,19735,9358,199523,164547,26738,27662,12958,8550,738,350,7462,6154,321483,224850,64964,44333,20631,31669,671,30998,10705,7617,3088,293,2795,30031,29519,11091,0
3,0,8,7,20.2,39.4,27.8,12.6,708402,378937,208452,25925,9734,172793,121013,27120,26121,13973,7686,956,359,6371,4462,318526,220177,70631,51575,19056,27718,-1781,29499,11244,7909,3335,549,2786,28329,27839,10588,4
3,0,7,11,21.7,42.9,24.5,10.9,1179845,660954,301717,19938,9849,271930,217174,33504,35215,19728,9005,595,294,8116,6482,709446,404470,121792,88605,33187,183184,101766,81418,17521,12543,4978,1143,3835,40491,32247,21230,0
3,0,7,11,17.3,35.5,31.3,15.9,864264,462198,249456,22793,9956,216707,152610,28668,30147,16122,8702,795,347,7559,5323,489494,342540,104691,75814,28877,42263,1088,41175,14549,10902,3647,382,3265,33645,31420,12611,2
3,0,7,9,23.9,40.4,26.9,8.8,763762,359132,290324,32538,10169,247617,114306,31064,24587,11561,9346,1047,327,7971,3680,348570,239161,74052,54352,19700,35357,2599,32758,10982,7617,3365,400,2965,31740,31398,11048,1
3,0,7,8,18,38.7,27.9,15.3,904062,519669,252778,28191,10697,213890,131615,32765,27592,15860,7715,860,326,6528,4017,661186,468221,141902,102906,38996,51063,9614,41449,18908,14563,4345,329,4016,34969,32151,10321,3
3,0,5,8,17.6,35.9,31.5,15,1023184,575098,275188,28982,11212,234994,172898,39247,26070,14653,7012,738,286,5988,4405,645643,456262,156117,119819,36298,33264,1168,32096,17753,14136,3617,357,3260,36368,32277,9845,0
3,0,5,8,13.9,35.8,33.2,17.1,1141812,640054,312424,25050,11295,276079,189334,37409,30522,17110,8352,670,302,7380,5061,709393,517556,150411,106041,44370,41426,3566,37860,19432,15437,3995,254,3741,36506,33527,10120,7
3,0,6,5,16.2,36.5,28.2,19.1,1028817,569969,290217,31078,11509,247630,168631,42683,24104,13354,6799,728,270,5802,3951,613898,429609,144808,111416,33392,39481,199,39282,17625,13223,4402,742,3660,34831,32490,10733,1
3,0,2,2,19.6,37.6,30.7,12.1,1626062,1003482,372346,37893,12069,322384,250234,52684,30864,19047,7068,719,229,6119,4750,521040,339767,101992,74928,27064,79281,3517,75764,15298,10439,4859,708,4151,34059,32548,18252,11
3,0,6,5,16.5,42.1,28.4,12.9,1152776,694901,298707,27242,12239,259226,159168,42774,26950,16246,6983,637,286,6060,3721,672740,468354,141066,102831,38235,63320,28891,34429,18679,14014,4665,874,3791,36016,33420,9082,1
3,0,6,5,20,40.8,28.5,10.6,1176346,673974,317254,31996,12321,272937,185118,46305,25404,14555,6851,691,266,5894,3998,708355,512465,150244,108925,41319,45646,1365,44281,19574,14647,4927,982,3945,36189,34988,11225,0
3,0,2,2,13.2,39.3,32.8,14.7,1950501,1242555,361599,32348,12993,316258,346347,59788,32624,20783,6048,541,217,5290,5793,665307,434311,132159,97766,34393,98837,15553,83284,19283,13027,6256,1004,5252,34502,33339,15858,9
3,0,7,11,11,31.3,31.5,26.2,1319492,719638,253879,21238,13199,219442,345975,32852,40165,21905,7728,646,402,6680,10531,894045,618339,166745,114855,51890,108961,-176,109137,24956,18893,6063,249,5814,35825,32728,18771,6
3,0,2,2,21.3,40.4,26.9,11.4,1311579,778818,352759,42450,13591,296718,180002,49153,26684,15845,7177,864,277,6037,3662,575540,399156,116699,84705,31994,59685,13958,45727,16608,11779,4829,815,4014,34654,33887,11392,2
3,0,6,6,16.9,43,28.1,12,1289897,781203,324564,31777,14428,278359,184130,46951,27473,16639,6913,677,307,5929,3922,704259,475422,142844,103246,39598,85993,6380,79613,18443,13250,5193,1450,3743,38186,35881,21270,1
3,0,2,2,10.8,32.9,35.1,21.2,2530497,1778811,374791,26655,15234,332902,376895,74302,34057,23940,5044,359,205,4480,5072,914151,628186,164358,113340,51018,121607,34504,87103,24747,16668,8079,1059,7020,36940,37688,12408,7
3,0,5,8,13.9,33.9,28.3,23.9,1845136,1088744,451328,37998,15643,397687,305064,69328,26615,15704,6510,548,226,5736,4400,1397625,964579,313682,236337,77345,119364,7193,112171,39551,33044,6507,875,5632,35337,29191,19917,6
3,0,6,4,20.3,43.9,25.8,10,1222064,673271,356542,33375,15792,307375,192251,44177,27663,15240,8071,755,357,6958,4352,564867,354750,108813,78938,29875,101304,48513,52791,18031,11906,6125,1310,4815,31328,29796,10964,0
3,0,5,8,11.5,35.3,29.4,23.7,2122507,1292111,485611,36747,17074,431790,344785,66539,31899,19419,7298,552,257,6489,5182,1439357,1052223,302815,218894,83921,84319,242,84077,36151,30228,5923,128,5795,39815,34810,14509,3
3,0,2,2,16.6,40.4,32.3,10.8,1676499,1117014,354162,36852,17182,300128,205323,65167,25726,17141,5435,566,264,4606,3151,862476,594705,181766,132499,49267,86005,31533,54472,24169,18077,6092,1034,5058,35685,32898,10769,10
3,0,4,5,21.4,38.3,27.5,12.7,1766399,1095046,426182,45668,17645,362869,245171,62083,28452,17638,6865,736,284,5845,3949,1177682,836186,244525,176547,67978,96971,9070,87901,28918,22321,6597,898,5699,40725,37462,15424,6
3,0,4,5,11,30,29.7,29.3,3608710,2359625,545285,51787,17971,475527,703800,83605,43164,28223,6522,619,215,5688,8418,2678836,1965534,480981,343624,137357,232321,6730,225591,46547,38054,8493,503,7990,57551,51651,28234,43
3,0,6,6,18.8,41.8,28.8,10.6,1538064,895974,428499,36357,19151,372991,213591,56512,27217,15855,7582,643,339,6600,3780,686112,418945,132291,98187,34104,134876,33163,101713,19762,12909,6853,1161,5692,34719,32454,17869,14
3,0,6,6,18.8,39.9,30.4,10.8,1610379,960986,428598,47591,20123,360884,220795,63635,25306,15102,6735,748,316,5671,3470,766406,528652,159684,116579,43105,78070,18578,59492,22957,16253,6704,1061,5643,33384,32526,10543,4
3,0,2,2,21.1,35.9,28.6,14.3,2421851,1510469,554587,62012,21867,470708,356795,76501,31658,19744,7249,811,286,6153,4664,1295873,893812,265424,193293,72131,136637,21441,115196,33549,24316,9233,1040,8193,38626,36758,14060,9
3,0,5,8,10.7,27.9,35.3,26.1,3040758,1854069,561422,43371,24007,494044,625267,86209,35272,21507,6512,503,278,5731,7253,2532533,1789761,476954,332232,144722,265818,-1453,267271,65908,49381,16527,443,16084,38425,36244,16617,9
3,0,2,2,10.5,30.4,37.4,21.7,3546530,2358709,644322,50228,24904,569190,543499,108021,32832,21836,5965,465,231,5269,5031,2037927,1511567,402968,286606,116362,123392,6046,117346,48695,35924,12771,1064,11707,41851,42077,10024,4
3,0,4,5,15.6,38.4,32.2,13.7,2072129,1312387,494454,43057,25432,425965,265288,71523,28972,18349,6913,602,356,5956,3709,817074,549752,167461,123303,44158,99861,12750,87111,26370,17975,8395,948,7447,30985,30584,11697,5
3,0,4,5,17.7,39.1,27.4,15.8,3641858,2365953,638176,55986,27804,554386,637729,111589,32636,21202,5719,502,249,4968,5715,2004817,1410436,392384,279459,112925,201997,50063,151934,48903,36427,12476,1325,11151,40996,38720,13625,22
3,0,3,2,17.6,37,31.3,14.2,3476231,2016007,876613,80650,28359,767604,583611,108320,32092,18612,8093,745,262,7086,5388,2004739,1469435,391994,276538,115456,143310,15202,128108,49858,39997,9861,717,9144,40209,36739,14010,18
3,0,1,1,15.5,38.5,33.3,12.7,2818737,1899145,548220,40208,30178,477834,371372,89914,31349,21122,6097,447,336,5314,4130,1031553,696888,214761,155817,58944,119904,8429,111475,31460,21758,9702,1099,8603,32789,32029,12958,26
3,0,4,5,16.6,38.5,28.7,16.3,3028120,1935892,668835,53052,32968,582815,423393,101169,29931,19135,6611,524,326,5761,4185,1497109,1071242,304403,218453,85950,121464,8320,113144,41435,30547,10888,1422,9466,36132,35069,11953,18
3,0,3,2,16.8,35.6,31.6,16,4300586,2582267,1062635,132151,34662,895822,655684,137313,31320,18806,7739,962,252,6524,4775,3399264,2584427,665087,464433,200654,149750,765,148985,72227,59790,12437,1004,11433,47064,43225,13031,12
3,0,3,2,18.1,31.9,30.4,19.6,5638651,3444212,1237915,130945,41819,1065151,956524,157380,35828,21885,7866,832,266,6768,6078,3702895,2602888,741629,537350,204279,358378,16128,342250,85422,67275,18147,1088,17059,43348,38690,20063,40
3,0,1,1,8.6,28.3,34.9,28.2,7346726,5396732,909082,43545,42300,823237,1040912,181171,40551,29788,5018,240,233,4544,5745,2663526,1917956,502392,348643,153749,243178,527,242651,72607,51382,21225,655,20570,36684,37327,11796,114
3,0,3,2,15.8,32.9,35.1,16.3,4785759,2970055,1117796,110902,42800,964094,697908,160825,29758,18468,6950,690,266,5995,4340,3104591,2237340,639149,461364,177785,228102,-4776,232878,74162,58536,15626,1021,14605,41862,38222,15945,22
3,0,3,2,16.9,37.3,31.5,14.3,5343286,3651070,969922,80588,44626,844708,722294,152806,34968,23893,6347,527,292,5528,4727,2524420,1816347,486286,343967,142319,221787,347,221440,57260,43405,13855,987,12868,44087,41846,17209,35
3,0,3,2,16.9,35.5,33.7,13.9,4918262,2927220,1314477,177048,50586,1086843,676565,173846,28291,16838,7561,1018,291,6252,3892,3172298,2372031,650875,457330,193545,149392,8712,140680,80353,65567,14786,445,14341,39480,36177,9810,10
3,0,2,2,11.2,25.9,31.7,31.2,9060559,5848665,1573131,171644,55514,1345973,1638763,246862,36703,23692,6373,695,225,5452,6638,6866650,5047568,1340830,944619,396211,478252,13744,464508,148550,122311,26239,681,25558,46225,41268,18175,68
3,0,3,2,18.4,36.2,29.5,15.9,5933010,3428559,1616035,207212,56099,1352724,888416,201966,29376,16976,8002,1026,278,6698,4399,4476996,3311064,896850,628523,268327,269082,27078,242004,106908,88629,18279,1297,16982,41877,37359,14251,27
3,0,1,1,17.2,37.2,33.1,12.6,5444809,3513709,1155516,109468,57497,988551,775584,165959,32808,21172,6963,660,346,5957,4673,2688754,1890909,541615,386513,155102,256230,7860,248370,69391,52134,17257,929,16328,38748,36270,15211,29
3,0,3,2,13.4,31.1,29.6,26,8969435,5991825,1310295,86606,62196,1161493,1667315,261906,34247,22878,5003,331,237,4435,6366,6007249,4336077,1167306,816883,350423,503866,52339,451527,145811,113893,31918,1141,30777,41199,38071,14671,140
3,0,2,2,11.9,23.4,31.8,33,9067884,5781033,1719016,205872,73414,1439730,1567835,281315,32234,20550,6111,732,261,5118,5573,9033445,6682416,1879951,1361597,518354,471078,-208,471286,196619,164296,32323,805,31518,45944,40673,14953,57
3,0,2,2,8.5,17.1,26.3,48.1,15125024,10445226,1716287,135938,73556,1506793,2963511,341595,44278,30578,5024,398,215,4411,8676,12543620,9105145,2558417,1873111,685306,880058,-57,880115,242983,197598,45385,1081,44304,51623,46079,19865,368
3,0,2,2,15.4,28.3,30.5,25.8,24469806,14778207,3474589,410959,143877,2919753,6217010,599234,40835,24662,5798,686,240,4872,10375,19741822,14293133,3553283,2403958,1149325,1895406,23635,1871771,419303,350093,69210,999,68211,47082,40827,27441,114
3,0,2,2,16.9,33.4,33.5,16.2,13094262,7788414,3489435,460233,147820,2881382,1816413,433082,30235,17984,8057,1063,341,6653,4194,7746286,5776338,1523159,1057917,465242,446789,4247,442542,189381,147639,41742,826,40916,40903,39125,10816,64
3,0,1,1,17.1,32.8,32.6,17.6,30108615,20075176,5500605,400111,242810,4857684,4532834,837857,35935,23960,6565,478,290,5798,5410,19636408,14927985,3671746,2476876,1194870,1036677,7175,1029502,401534,321996,79538,386,79152,48903,46361,13007,223
3,0,1,1,10.7,22.1,29,38.2,63463823,43346890,7369735,473026,293821,6602888,12747198,1199545,52907,36136,6144,394,245,5504,10627,51053279,38132413,8221165,5280288,2940877,4699701,781,4698920,900065,721579,178486,451,178035,56722,52846,26393,935
3,0,1,1,23,30.6,29.1,17.2,60035528,36073297,15542171,2281922,613361,12646888,8420060,1865058,32190,19342,8333,1224,329,6781,4515,51757844,39253858,9328811,6289152,3039659,3175175,1676,3173499,938708,776651,162057,246,161811,55137,50542,19612,430
3,0,9,10,17.8,39.6,31.9,10.7,147183,84343,32966,2164,648,30154,29874,3637,40468,23190,9064,595,178,8291,8214,84111,34633,10791,8063,2728,38687,32362,6325,2158,1316,842,370,472,38976,26317,13400,0
3,0,9,12,15.4,37.4,30,17.2,145067,80356,37110,2093,884,34133,27601,4128,35142,19466,8990,507,214,8269,6686,66196,42850,12698,9215,3483,10648,2715,7933,2380,1575,805,187,618,27813,27206,12837,0
3,0,9,12,20.3,34.5,30.4,14.8,221751,151115,37510,2175,909,34426,33126,4614,48060,32751,8130,471,197,7461,7179,136218,46724,13461,9801,3660,76033,68353,7680,2653,1544,1109,520,589,51345,30262,13039,0
3,0,6,5,15.5,32.5,38,14,294162,195910,50622,3258,988,46376,47630,6622,44422,29585,7645,492,149,7003,7193,173175,72185,18618,12481,6137,82372,47894,34478,3440,2310,1130,334,796,50342,31249,43314,0
3,0,9,12,21,40.2,27.5,11.4,201342,111831,51127,3131,1035,46961,38384,5328,37789,20989,9596,588,194,8814,7204,107706,56941,17128,12525,4603,33637,25821,7816,3076,2100,976,353,623,35015,27115,12546,0
3,0,9,10,20.2,38.5,27.2,14.1,211718,123229,49782,2612,1060,46110,38707,5937,35661,20756,8385,440,179,7767,6520,97202,49345,14468,10518,3950,33389,24195,9194,3329,1879,1450,627,823,29199,26261,11171,0
3,0,8,7,25,34.1,28.6,12.4,153943,79687,49571,8168,1122,40281,24685,5386,28582,14795,9204,1517,208,7479,4583,94817,58673,17693,13170,4523,18451,11637,6814,2924,2134,790,308,482,32427,27494,14137,0
3,0,9,12,11.3,28.5,31.3,28.8,186159,98979,39566,2251,1202,36113,47614,5255,35425,18835,7529,428,229,6872,9061,127517,78990,22754,16431,6323,25773,0,25773,4246,2822,1424,0,1424,30032,27991,18099,0
3,0,8,7,21.2,38.2,29.8,10.7,145831,95872,28520,2231,1217,25072,21439,4097,35595,23401,6961,545,297,6120,5233,72196,35032,10935,7804,3131,26229,17681,8548,2040,1226,814,318,496,35390,28574,17234,0
3,0,6,6,18.5,35.7,30.5,15.4,388401,258261,67730,4372,1230,62128,62410,9597,40471,26911,7057,456,128,6474,6503,243267,107753,29948,21829,8119,105566,72508,33058,5676,3649,2027,574,1453,42859,29529,22752,0
3,0,9,12,19.2,37.7,30.2,13,281043,167451,62981,3403,1291,58287,50611,7342,38279,22807,8578,463,176,7939,6893,156613,71892,21204,15499,5705,63517,42015,21502,4346,2612,1734,787,947,36036,27524,22705,0
3,0,8,7,20,34.9,32,13.1,289750,182608,60520,4340,1328,54852,46622,6842,42349,26689,8845,634,194,8017,6814,170335,59050,16909,12188,4721,94376,81677,12699,3470,2076,1394,570,824,49088,28444,15411,0
3,0,9,10,16.5,35.4,32.5,15.7,236672,141839,54146,3344,1399,49403,40687,6113,38716,23203,8858,547,229,8082,6656,134930,63493,16597,11516,5081,54840,36992,17848,3667,2087,1580,534,1046,36796,30423,17063,0
3,0,6,6,22.4,36,27.6,13.9,369698,240393,67555,5371,1605,60579,61750,9631,38386,24960,7014,558,167,6290,6412,275576,140806,41909,30695,11214,92861,53017,39844,7030,5204,1826,573,1253,39200,27057,31799,0
3,0,7,11,15.6,34.1,29.7,20.6,402697,259407,65901,4535,1689,59677,77389,9711,41468,26713,6786,467,174,6145,7969,332103,182510,50138,35500,14638,99455,66416,33039,6986,5307,1679,489,1190,47538,34390,27764,1
3,0,9,10,20.9,37.8,29.4,11.9,382479,241281,66777,4172,1792,60813,74421,8755,43687,27559,7627,477,205,6946,8500,219081,81860,24444,17651,6793,112777,79516,33261,5127,3034,2093,831,1262,42731,26981,26356,1
3,0,7,9,15.9,38,31.9,14.2,406746,265437,74787,4556,1820,68411,66522,10364,39246,25611,7216,440,176,6601,6419,301931,157303,47159,34104,13055,97469,71308,26161,7504,5416,2088,794,1294,40236,29044,20217,1
3,0,9,9,18.1,35.4,32.2,14.4,415173,257555,87225,5114,1922,80189,70393,10473,39642,24592,8329,488,184,7657,6721,279850,153273,40943,28922,12021,85634,55755,29879,7028,4798,2230,818,1412,39819,31945,21161,0
3,0,8,6,18.2,33.5,33.6,14.7,390259,231014,84603,5325,2112,77166,74642,11084,35209,20842,7633,480,191,6962,6734,215779,133340,35086,24321,10765,47353,30334,17019,6588,4236,2352,853,1499,32753,31478,11354,1
3,0,7,9,19.6,37.2,28.9,14.2,425638,256547,96426,6812,2196,87418,72665,11701,36376,21925,8241,582,188,7471,6210,297646,155041,44237,32130,12107,98368,62438,35930,7724,5444,2280,718,1562,38535,28479,23003,1
3,0,6,6,13.6,37.5,29.4,19.5,371914,211347,97428,5042,2253,90133,63139,10872,34208,19440,8961,464,207,8290,5807,223586,161692,43258,30463,12795,18636,-1,18637,6172,4638,1534,30,1504,36226,34862,12392,1
3,0,7,9,19.6,35.1,31.2,14,354922,212888,81192,5269,2260,73663,60842,9966,35613,21361,8147,529,227,7391,6105,236983,127025,36031,25932,10099,73927,42814,31113,6078,4163,1915,723,1192,38990,30513,26102,3
3,0,7,9,24.1,39,23.3,13.7,375132,231074,83148,6193,2287,74668,60910,11120,33735,20780,7477,557,206,6715,5478,228823,129276,36869,26527,10342,62678,47478,15200,6209,4508,1701,495,1206,36853,28677,12604,0
3,0,7,9,18.4,37.6,30.3,13.7,472240,290367,92158,6455,2373,83330,89715,12376,38158,23462,7447,522,192,6733,7249,323085,203596,54829,38177,16652,64660,45078,19582,8283,6291,1992,587,1405,39006,32363,13937,0
3,0,8,7,20.9,37,30.2,12,409288,275436,73377,4902,2639,65836,60475,9551,42853,28838,7683,513,276,6893,6332,215832,81702,23090,16217,6873,111040,98570,12470,4796,2538,2258,1153,1105,45003,32191,11285,0
3,0,7,9,19.8,37,29.7,13.4,640376,404893,121695,7873,2817,111005,113788,16103,39767,25144,7557,489,175,6893,7066,404330,185676,53701,39269,14432,164953,102457,62496,9387,6351,3036,974,2062,43073,29236,30308,8
3,0,8,7,23.6,35.3,26.3,14.7,239759,128054,72426,7568,2975,61883,39279,8603,27869,14885,8419,880,346,7193,4566,114193,73769,23792,17455,6337,16632,3671,12961,4492,2687,1805,515,1290,25421,27454,10047,1
3,0,7,8,24.2,34.3,28,13.5,746295,480524,135858,13457,3020,119381,129913,21126,35326,22746,6431,637,143,5651,6149,579806,342890,89873,63434,26439,147043,101627,45416,14384,11146,3238,906,2332,40309,30764,19475,0
3,0,7,11,17.5,37.7,29.9,14.9,606995,396911,94890,6934,3086,84870,115194,15935,38092,24908,5955,435,194,5326,7229,493695,328854,102133,71715,30418,62708,45980,16728,12341,9394,2947,981,1966,40004,35007,8509,11
3,0,7,9,16.4,40.8,29,13.8,554822,328343,120995,8590,3110,109295,105484,14790,37513,22200,8181,581,210,7390,7132,332450,171818,49412,35166,14246,111220,63068,48152,8505,5672,2833,780,2053,39089,30292,23454,0
3,0,9,9,19.1,37.9,30.3,12.6,670967,428759,123686,9028,3230,111428,118522,15911,42170,26947,7774,567,203,7003,7449,440286,214195,58733,40926,17807,167358,135168,32190,9821,7119,2702,889,1813,44831,30088,17755,23
3,0,7,11,18.1,37.5,29.4,15.1,432389,243721,119531,9550,3417,106564,69137,13432,32191,18145,8899,711,254,7934,5147,276617,206700,56225,39343,16882,13692,795,12897,6923,5522,1401,182,1219,39956,37432,10580,0
3,0,8,4,20.8,40.1,27.5,11.6,556714,367060,103317,7108,3447,92762,86337,15283,36427,24018,6760,465,226,6070,5649,231799,113223,32840,23360,9480,85736,59748,25988,6416,3935,2481,851,1630,36128,28773,15944,2
3,0,7,9,20.5,36.9,29.2,13.4,377681,189078,125020,12201,3455,109364,63583,13844,27281,13658,9031,881,250,7900,4593,260961,176800,51054,36896,14158,33107,9632,23475,8661,6220,2441,567,1874,30131,28424,12527,1
3,0,7,9,15.2,38.5,30.1,16.2,679106,449092,121449,9755,3655,108039,108565,19311,35167,23256,6289,505,189,5595,5622,437545,265961,75283,53262,22021,96301,69480,26821,11396,8535,2861,712,2149,38395,31161,12481,9
3,0,7,8,16.3,37.9,29.7,16.1,816214,485298,167853,12119,3660,152074,163063,20914,39027,23204,8026,579,175,7271,7797,565471,338375,88112,61812,26300,138984,100180,38804,14081,10445,3636,782,2854,40158,32396,13596,0
3,0,3,2,13.3,35.9,33.7,17.1,729625,527150,101252,7040,3763,90449,101223,19876,36709,26522,5094,354,189,4551,5093,354742,209843,55045,38384,16661,89854,26225,63629,8837,5894,2943,613,2330,40143,35603,27309,22
3,0,3,2,14.4,37.5,31.2,16.9,783737,502356,138728,7883,3958,126887,142653,21787,35973,23058,6367,362,182,5824,6548,366613,228740,65375,46596,18779,72498,33518,38980,11129,7493,3636,823,2813,32942,30527,13857,2
3,0,6,6,18.7,31,35.4,14.9,522636,312445,101442,8310,4036,89096,108749,13842,37757,22572,7329,600,292,6437,7856,449737,318304,87757,61066,26691,43676,23932,19744,11719,9567,2152,530,1622,38377,33271,12173,8
3,0,3,2,14.5,34.7,30.3,20.5,707179,453191,126831,8019,4052,114760,127157,19159,36911,23654,6620,419,211,5990,6637,245280,146851,44531,32341,12190,53898,20460,33438,8950,5471,3479,875,2604,27406,26842,12841,6
3,0,8,7,19.6,39.6,29.5,11.3,455640,209404,148204,10346,4076,133782,98032,16422,27746,12751,9025,630,248,8147,5970,174216,121241,34880,24940,9940,18095,-591,18686,6543,4399,2144,462,1682,26626,27561,11109,1
3,0,7,8,17.4,32.5,28.7,21.4,964084,635636,168123,12835,4149,151139,160325,25646,37592,24785,6556,500,162,5893,6251,802609,538701,143189,101779,41410,120719,69069,51650,19740,15840,3900,819,3081,40659,34009,16764,2
3,0,8,6,18.3,36.9,29.7,15.1,767609,500302,146687,9302,4275,133110,120620,20991,36568,23834,6988,443,204,6341,5746,386262,182383,52157,37484,14673,151722,43535,108187,11334,6784,4550,1414,3136,34080,26884,34498,5
3,0,7,9,13.9,34.4,31.5,20.2,605251,327374,160397,13174,4690,142533,117480,20346,29748,16090,7883,647,231,7005,5774,284734,191741,53262,37446,15816,39731,-223,39954,9954,6467,3487,385,3102,28605,29649,12880,1
3,0,6,6,20.7,41.2,28.1,10,777850,476053,194373,16166,5222,172985,107424,24859,31290,19150,7819,650,210,6959,4321,406438,222967,60827,43055,17772,122644,30474,92170,11524,7171,4353,1671,2682,35269,31093,34366,0
3,0,6,4,19.4,42.2,28,10.5,460019,263862,123564,10247,5267,108050,72593,16535,27821,15958,7473,620,319,6535,4390,169305,116942,34173,24346,9827,18190,-3024,21214,6320,4111,2209,608,1601,26789,28446,13250,0
3,0,6,4,18.5,38.3,29.4,13.9,788593,508834,155572,10651,5337,139584,124187,23454,33623,21695,6633,454,228,5951,5295,376529,232456,62516,44068,18448,81557,36782,44775,11065,7275,3790,982,2808,34029,31953,15946,3
3,0,3,2,18,31.7,32.7,17.6,1174263,756437,240343,21167,5544,213632,177483,31175,37667,24264,7709,679,178,6853,5693,706764,398571,111877,78879,32998,196316,144681,51635,18241,13361,4880,1236,3644,38746,29831,14170,1
3,0,5,8,9.9,27.7,33.1,29.3,1198638,813782,176281,13492,5553,157236,208575,32261,37154,25225,5464,418,172,4874,6465,775475,511167,145333,105677,39656,118975,65814,53161,19962,15637,4325,669,3656,38848,32690,14541,7
3,0,7,8,18.3,38.5,26.7,16.5,1020175,627812,193043,10851,5807,176385,199320,25992,39250,24154,7427,417,223,6786,7669,733414,464712,128137,89614,38523,140565,66140,74425,19263,14867,4396,941,3455,38074,31258,21541,1
3,0,7,8,18.8,37.7,30.7,12.8,1049810,623686,240652,17708,6059,216885,185472,31270,33572,19945,7696,566,194,6936,5931,629245,414931,108444,74678,33766,105870,52081,53789,17288,13390,3898,1039,2859,36398,30988,18814,1
3,0,4,5,17.7,35.3,32.3,14.7,1354423,823353,299666,23186,6146,270334,231404,38695,35003,21278,7744,599,159,6986,5980,886266,626340,152644,105366,47278,107282,39721,67561,21979,17641,4338,940,3398,40323,35505,19883,3
3,0,7,8,14.4,33.1,35.2,17.3,1421000,895884,274916,16826,6571,251519,250200,36108,39354,24811,7614,466,182,6966,6929,1030041,651569,161829,113338,48491,216643,19892,196751,25543,18815,6728,1014,5714,40326,34630,34433,8
3,0,6,4,15.4,38.3,29.4,16.9,997915,660043,165872,10985,6793,148094,172000,27816,35876,23729,5963,395,244,5324,6183,420038,279341,78494,55461,23033,62203,27705,34498,12392,8812,3580,932,2648,33896,31700,13028,4
3,0,5,8,13.4,35.9,30.5,20.1,1339922,927998,215613,16972,6845,191796,196311,36558,36652,25384,5898,464,187,5246,5370,1156782,858569,214516,148675,65841,83697,28875,54822,27483,22826,4657,771,3886,42091,37614,14108,23
3,0,6,4,18.7,40.4,28.8,12.2,805414,479675,207338,17936,7177,182225,118401,26171,30775,18328,7922,685,274,6963,4524,405129,286055,78757,56555,22202,40317,3540,36777,14675,10362,4313,664,3649,27607,27606,10079,3
3,0,6,6,17.1,34.7,31.6,16.7,1058788,610444,255641,24963,7465,223213,192703,32244,32837,18932,7928,774,232,6923,5976,621410,411689,113214,79150,34064,96507,25967,70540,19614,13689,5925,1021,4904,31682,30074,14384,1
3,0,4,5,16.5,31.1,34,18.3,1653745,1051380,295036,25993,7570,261473,307329,41840,39525,25129,7052,621,181,6249,7345,1172846,767350,201471,139144,62327,204025,64130,139895,30278,23851,6427,1135,5292,38736,32173,26435,19
3,0,6,4,21,40.9,27.8,10.3,791156,447428,223211,20167,7784,195260,120517,29614,26716,15109,7537,681,263,6594,4070,350137,241235,70479,50978,19501,38423,4614,33809,13077,8908,4169,799,3370,26775,27081,10032,0
3,0,2,2,15.7,37.4,32,14.9,1113295,691799,266200,19858,7825,238517,155296,34986,31821,19774,7609,568,224,6817,4439,650738,469472,131935,93830,38105,49331,-1456,50787,17934,13999,3935,430,3505,36285,33536,14490,0
3,0,3,2,13.3,28.2,33.8,24.7,1901514,1261451,352342,33960,7832,310550,287721,57056,33327,22109,6175,595,137,5443,5043,983488,631066,167797,113886,53911,184625,65926,118699,27329,20539,6790,724,6066,35987,30725,19568,11
3,0,9,8,16.1,36.5,30.9,16.6,950411,427061,280122,27946,7933,244243,243228,28733,33077,14863,9749,973,276,8500,8465,376631,257479,73696,52459,21237,45456,3696,41760,14718,10246,4472,488,3984,25590,25130,10482,0
3,0,6,3,15.3,37.3,32,15.4,1319878,885858,230144,13841,7998,208305,203876,36917,35753,23996,6234,375,217,5643,5523,972450,681682,181662,127491,54171,109106,25457,83649,24248,19028,5220,872,4348,40104,35825,19239,11
3,0,6,6,20.3,38.7,28.3,12.6,1051858,650042,237914,18850,8731,210333,163902,33267,31619,19540,7152,567,262,6323,4927,602105,359685,104498,74903,29595,137922,91068,46854,18104,12259,5845,1653,4192,33258,29340,11177,2
3,0,4,5,16,30.2,30.6,23.2,1788432,1068993,293014,23708,8945,260361,426425,51457,34756,20774,5694,461,174,5060,8287,1236216,891760,254636,183768,70868,89820,28518,61302,32998,27359,5639,1015,4624,37463,32595,13257,5
3,0,3,2,15.1,34.8,32.9,17.2,1306428,908636,212312,19453,8945,183914,185480,38200,34200,23786,5558,509,234,4815,4855,841221,571746,145090,97516,47574,124385,37097,87288,21883,16942,4941,811,4130,38442,33747,21135,2
3,0,4,3,13.3,36.5,31.1,19.1,1808551,1200321,294115,17039,9274,267802,314115,45919,39386,26140,6405,371,202,5832,6841,1187097,817770,214611,150939,63672,154716,49524,105192,29949,22789,7160,1395,5765,39637,35884,18247,20
3,0,1,1,13.4,38.4,33.7,14.5,1237359,859579,222803,16623,9636,196544,154977,37851,32690,22710,5886,439,255,5193,4094,524668,376447,100414,70230,30184,47807,-84,47891,16369,11542,4827,792,4035,32053,32615,11869,4
3,0,7,8,16.6,28.6,31.3,23.5,1257288,689430,350038,53472,9649,286917,217820,43815,28695,15735,7989,1220,220,6548,4971,826071,593647,167346,119086,48260,65078,3917,61161,24788,19171,5617,567,5050,33325,30966,12111,3
3,0,5,8,12.3,28.1,32.9,26.6,2151238,1391337,350378,33039,10608,306731,409523,62860,34223,22134,5574,526,169,4880,6515,1873204,1321305,338120,233518,104602,213779,81265,132514,47339,39604,7735,1003,6732,39570,33363,19684,3
3,0,6,6,14.4,33.3,34.7,17.6,1375014,743124,386278,33131,11563,341584,245612,44852,30657,16568,8612,739,258,7616,5476,789840,575292,157276,109226,48050,57272,-1053,58325,22461,16758,5703,364,5339,35165,34329,10924,3
3,0,6,5,18.6,33.2,31.1,17.2,1937720,1103540,452133,31562,11728,408843,382047,57691,33588,19128,7837,547,203,7087,6622,1102533,705008,202784,145508,57276,194741,87829,106912,34004,23534,10470,2787,7683,32424,29957,13915,2
3,0,1,1,11.3,37.1,36.3,15.3,1906896,1368590,293156,19020,12001,262135,245150,53012,35971,25817,5530,359,226,4945,4624,771903,552404,139579,94857,44722,79920,7237,72683,23303,15951,7352,750,6602,33125,34631,11009,13
3,0,4,3,14.8,33,29.9,22.4,2115585,1421535,344611,25921,12367,306323,349439,63061,33548,22542,5465,411,196,4858,5541,1221308,874505,216150,145913,70237,130653,25091,105562,33170,25006,8164,1263,6901,36820,34972,15297,15
3,0,5,8,13.7,33.6,34.3,18.4,2027720,1135487,495673,37589,14759,443325,396560,62178,32612,18262,7972,605,237,7130,6378,1331044,953558,249385,170187,79198,128101,-2043,130144,40526,30478,10048,521,9527,32844,31287,13661,5
3,0,1,1,8.6,26.6,30.4,34.3,4733057,3664983,357072,19376,15823,321873,711002,88812,53293,41267,4021,218,178,3624,8006,2242579,1557121,379151,258906,120245,306307,21957,284350,48350,35987,12363,681,11682,46382,43269,24341,66
3,0,1,1,10.1,32.5,38,19.4,3050178,2301591,373820,27902,19627,326291,374767,87495,34861,26305,4272,319,224,3729,4283,1247921,892698,237667,165921,71746,117556,5363,112193,35414,24909,10505,446,10059,35238,35838,11153,31
3,0,3,2,8.9,24,32.4,34.7,6030795,4310535,774238,63787,22831,687620,946022,141527,42612,30457,5471,451,161,4859,6684,5711404,4475630,980607,649517,331090,255167,20208,234959,111189,94121,17068,1162,15906,51367,47552,14772,309
3,0,1,1,9,28.4,33.2,29.4,5666497,4380920,510376,33777,23585,453014,775201,126613,44754,34601,4031,267,186,3578,6123,2536507,1855768,424053,278369,145684,256686,25649,231037,63034,46099,16935,688,16247,40240,40256,14220,80
3,0,1,1,11.9,36.8,33.4,17.9,4545188,3399838,575449,38918,26435,510096,569901,121553,37393,27970,4734,320,217,4196,4688,1927881,1331601,353596,244474,109122,242684,27364,215320,55784,39920,15864,1302,14562,34560,33357,14786,18
3,0,3,2,13.8,33.4,30.9,22,5137540,3429592,868015,67852,30052,770111,839933,148307,34641,23125,5853,458,203,5193,5663,4245568,3079210,786057,540400,245657,380301,153176,227125,107691,87719,19972,2939,17033,39424,35103,13334,13
3,0,1,1,6,26,34.1,33.9,11279618,8100484,1103224,64288,41419,997517,2075910,233306,48347,34720,4729,276,178,4276,8898,4196630,3063315,744140,502748,241392,389175,12799,376376,107796,78625,29171,569,28602,38931,38961,13159,338
3,0,2,2,12.8,31.8,33.5,21.9,7143657,4317450,1604745,146171,47607,1410967,1221462,199745,35764,21615,8034,732,238,7064,6115,5280073,3839804,977432,673362,304070,462837,305,462532,123295,103966,19329,652,18677,42825,36933,24765,8
3,0,1,1,9,32.4,37.3,21.3,12665860,9392960,1735404,129684,67079,1538641,1537496,327427,38683,28687,5300,396,205,4699,4696,6773236,5099785,1206903,801944,404959,466548,4790,461758,154946,121687,33259,381,32878,43714,41909,14045,233
3,0,1,1,6.8,23.5,34.8,34.9,18185205,13481026,1968120,123254,72809,1772057,2736059,393900,46167,34224,4996,313,185,4499,6946,11035717,8301019,1910602,1267363,643239,824096,29066,795030,233667,187074,46593,852,45741,47228,44373,17381,200
3,0,1,1,12.4,25.3,28,34.3,21468293,13422619,3555362,426798,92850,3035714,4490312,502890,42690,26691,7070,849,185,6037,8929,22282169,17439055,3955216,2640853,1314363,887898,826,887072,409024,354211,54813,26,54787,54476,49234,16191,242
3,0,1,1,9.4,21.2,30.4,39.1,64692558,42477384,7220588,739138,211273,6270177,14994586,1135173,56989,37419,6361,651,186,5524,13209,67296302,52339493,10746158,7026390,3719768,4210651,7781,4202870,1060939,900879,160060,471,159589,63431,58098,26336,718
3,0,9,10,19.8,45.6,23.2,11.3,59573,31172,16602,931,238,15433,11799,2166,27504,14392,7665,430,110,7125,5447,19426,10281,3750,3028,722,5395,3396,1999,1169,494,675,381,294,16618,20812,6799,0
3,0,9,10,20,44.8,24.1,11.2,130421,59830,44391,3062,501,40828,26200,5028,25939,11899,8829,609,100,8120,5211,58230,36035,10550,7953,2597,11645,1834,9811,2534,1246,1288,602,686,22979,28921,14302,0
3,0,9,8,18.6,46.6,23.2,11.6,105838,54361,34101,2290,512,31299,17376,4383,24147,12403,7780,522,117,7141,3964,36621,19625,6853,5418,1435,10143,2885,7258,1716,830,886,490,396,21341,23645,18328,0
3,0,8,7,18.1,49.5,20.7,11.7,191133,124308,37236,2097,516,34623,29589,4926,38801,25235,7559,426,105,7029,6007,101524,37241,11266,8414,2852,53017,20601,32416,2461,1383,1078,369,709,41253,26928,45721,0
3,0,9,10,20,39.2,24.2,16.6,227338,142097,47076,2238,563,44275,38165,5798,39210,24508,8119,386,97,7636,6582,120929,53424,14950,11029,3921,52555,33887,18668,3188,2029,1159,386,773,37933,26330,24150,0
3,0,8,7,18.2,45.6,21.6,14.5,223897,126523,62001,2913,597,58491,35373,6806,32897,18590,9110,428,88,8594,5197,113662,61137,17249,12514,4735,35276,24806,10470,3948,2416,1532,710,822,28790,25305,12737,0
4,0,6,6,29.9,33.3,19.2,17.6,579601,236611,144799,16024,6136,122639,198191,15934,36375,14849,9087,1006,385,7697,12438,258817,187385,44801,31658,13143,26631,15046,11585,8125,5668,2457,186,2271,31854,33060,5101,0
4,0,6,6,33.7,39.2,19.2,7.9,608452,368066,153428,21487,6203,125738,86958,25068,24272,14683,6120,857,247,5016,3469,312885,173916,54092,42581,11511,84877,65332,19545,8490,6242,2248,479,1769,36853,27862,11049,0
4,0,6,6,35.4,36,20.4,8.1,440514,252681,126269,18243,6348,101678,61564,17114,25740,14765,7378,1066,371,5941,3597,205085,127945,36236,27349,8887,40904,23073,17831,5829,4466,1363,198,1165,35184,28649,15306,1
4,0,1,1,24.7,40.1,21.2,14,518262,333695,110679,11759,6354,92566,73888,17721,29246,18830,6246,664,359,5224,4170,126517,81272,23970,18339,5631,21275,-884,22159,5118,2858,2260,297,1963,24720,28437,11288,0
4,0,6,4,26,37.1,18.2,18.7,631226,359778,126212,14483,6624,105105,145236,17921,35223,20076,7043,808,370,5865,8104,287474,205446,50971,36814,14157,31057,12463,18594,9640,6533,3107,512,2595,29821,31447,7165,0
4,0,7,9,32.7,37.2,21.7,8.4,448515,252689,131871,17255,6823,107793,63955,18144,24720,13927,7268,951,376,5941,3525,353292,250370,79385,62438,16947,23537,10524,13013,8643,6855,1788,415,1373,40876,36524,9478,0
4,0,7,9,33.7,36.6,18.1,11.6,530820,295460,150790,21541,7045,122204,84570,21659,24508,13641,6962,995,325,5642,3905,248373,171628,53727,42310,11417,23018,7564,15454,8013,6189,1824,352,1472,30996,27731,10499,0
4,0,6,6,41.5,34,15.5,9.1,444484,224695,152613,24462,7398,120753,67176,17067,26043,13165,8942,1433,433,7075,3936,252728,173349,49408,37143,12265,29971,13568,16403,7238,5380,1858,280,1578,34917,32221,10395,0
4,0,9,12,25.8,35.1,26.5,12.5,598464,275718,191652,11927,7401,172324,131094,21338,28047,12921,8982,559,347,8076,6144,282650,196210,54602,41310,13292,31838,3098,28740,9916,6410,3506,220,3286,28504,30610,8746,1
4,0,6,6,33.1,38.6,18.1,10.2,358039,178958,118661,18147,7402,93112,60420,14905,24021,12007,7961,1218,497,6247,4054,165381,109009,31410,23628,7782,24962,13975,10987,5267,3824,1443,322,1121,31399,28507,9801,0
4,0,6,6,34,34.6,22,9.4,482738,262675,139854,18944,7663,113247,80209,19067,25318,13776,7335,994,402,5939,4207,195038,128152,35668,26663,9005,31218,20682,10536,5957,4292,1665,346,1319,32741,29858,7988,0
4,0,6,6,34.7,35.4,20.8,9.1,620788,361582,169003,30020,7678,131305,90203,23592,26313,15326,7164,1272,325,5566,3823,390476,244405,70989,54239,16750,75082,63076,12006,11056,9050,2006,340,1666,35318,27006,7206,1
4,0,3,2,31.7,38.1,21.6,8.6,594296,360338,144190,22319,7698,114173,89768,21799,27263,16530,6615,1024,353,5238,4118,187644,119276,32576,24470,8106,35792,26222,9570,6005,4033,1972,407,1565,31248,29575,6115,0
4,0,1,1,28.7,37,23,11.3,478881,268706,139840,14486,7873,117481,70335,18233,26265,14737,7670,794,432,6443,3858,182468,116387,33683,25430,8253,32398,12961,19437,5506,3838,1668,219,1449,33140,30325,13414,1
4,0,1,1,20.5,33.2,28.2,18.1,691053,443225,122364,11193,8032,103139,125464,22325,30954,19853,5481,501,360,4620,5620,315251,214700,54006,38606,15400,46545,10916,35629,11076,7761,3315,166,3149,28463,27664,11314,2
4,0,8,4,29.1,38.9,21.6,10.4,599142,268364,204090,16146,8172,179772,126688,23661,25322,11342,8626,682,345,7598,5354,238798,162197,43144,31719,11425,33457,1627,31830,9556,5570,3986,194,3792,24989,29120,8394,0
4,0,6,4,24.5,40.5,20.5,14.4,648250,337189,166139,19068,8219,138852,144922,21179,30608,15921,7845,900,388,6556,6843,303981,213382,63782,49000,14782,26817,629,26188,9932,7048,2884,160,2724,30606,30276,9614,1
4,0,7,9,31.7,38.8,18.9,10.5,532451,275431,157507,23051,8249,126207,99513,21240,25068,12968,7416,1085,388,5942,4685,331103,243569,69062,52159,16903,18472,7367,11105,9460,7448,2012,358,1654,35000,32703,6714,0
4,0,3,2,13.3,23.4,23.5,39.8,1462975,1008902,149931,11416,8308,130207,304142,32386,45173,31152,4630,352,257,4020,9391,505562,334162,83262,60556,22706,88138,20243,67895,14908,9341,5567,319,5248,33912,35774,12937,7
4,0,7,8,34.2,37.2,19.1,9.5,416150,191067,152938,22479,8422,122037,72145,17581,23670,10868,8699,1279,479,6941,4104,247892,178130,51951,38155,13796,17811,5959,11852,8070,6316,1754,184,1570,30718,28203,7549,0
4,0,2,2,35.1,37,18.3,9.5,615544,345410,192767,34486,8482,149799,77367,23117,26627,14942,8339,1492,367,6480,3347,372422,257892,82901,65534,17367,31629,14493,17136,8900,6375,2525,367,2158,41845,40454,7941,0
4,0,6,6,30.6,39.7,19.1,10.6,688714,412252,166418,27259,8486,130673,110044,24893,27667,16561,6685,1095,341,5249,4421,320667,181664,50393,37840,12553,88610,28673,59937,8604,6121,2483,373,2110,37270,29679,28406,0
4,0,6,5,34.1,34.5,18.6,12.8,545286,281332,174439,30671,8564,135204,89515,23378,23325,12034,7462,1312,366,5783,3829,348043,244598,65162,47883,17279,38283,10920,27363,10626,8237,2389,186,2203,32754,29695,12421,0
4,0,2,2,21,29.4,28.4,21.1,1135641,750767,181272,15225,8580,157467,203602,31494,36059,23838,5756,483,272,5000,6465,204309,130008,36801,27945,8856,37500,-1142,38642,8192,5045,3147,265,2882,24940,25770,13408,0
4,0,8,7,24,35.1,25.4,15.4,698117,379167,188793,16335,8617,163841,130157,26949,25905,14070,7006,606,320,6080,4830,276456,184440,50042,37011,13031,41974,7951,34023,10075,6482,3593,242,3351,27440,28454,10153,0
4,0,1,1,30.2,39.9,21.3,8.6,601638,357262,159756,18790,8716,132250,84620,23682,25405,15086,6746,793,368,5584,3573,263074,187939,52559,39699,12860,22576,1861,20715,8652,6012,2640,121,2519,30406,31261,8224,0
4,0,3,2,22.1,41,21.8,15,829681,529269,179694,21645,8810,149239,120718,28710,28899,18435,6259,754,307,5198,4205,185565,124740,34764,26204,8560,26061,-93,26154,6118,4184,1934,165,1769,30331,29814,14785,0
4,0,8,7,33,37.5,19.2,10.3,597549,323509,175811,18965,8902,147944,98229,22152,26975,14604,7937,856,402,6679,4434,342750,215271,57613,42249,15364,69866,38614,31252,10620,7317,3303,690,2613,32274,29421,11960,1
4,0,6,6,32.8,39.2,18.1,9.8,551804,279571,169884,21702,8905,139277,102349,20335,27136,13748,8354,1067,438,6849,5033,307332,207589,59889,45122,14767,39854,6867,32987,9407,6917,2490,403,2087,32671,30011,15806,0
4,0,3,2,22.3,38.7,21.9,17.1,865080,560628,167645,16953,8949,141743,136807,26233,32977,21371,6391,646,341,5403,5215,324155,225947,64973,49880,15093,33235,6542,26693,9030,6469,2561,158,2403,35898,34928,11108,0
4,0,2,2,33.3,35.2,19.8,11.7,607339,347842,168884,25259,9138,134487,90613,21836,27814,15930,7734,1157,418,6159,4150,317807,231426,62949,46436,16513,23432,10830,12602,9541,7420,2121,174,1947,33310,31189,6473,0
4,0,6,5,26.6,33.2,23.4,16.8,775339,447233,196530,27992,9213,159325,131576,27474,28221,16278,7153,1019,335,5799,4789,390511,283495,82924,62146,20778,24092,9334,14758,11951,8814,3137,168,2969,32676,32164,4971,0
4,0,1,1,34.2,35.7,19.3,10.8,591348,324799,183651,27323,9417,146911,82898,22446,26345,14470,8182,1217,420,6545,3693,242086,165873,49614,37370,12244,26599,3364,23235,7783,5422,2361,315,2046,31104,30593,11356,1
4,0,2,2,21,32.8,26.8,19.3,1227419,880683,165969,17103,9547,139319,180767,29987,40932,29369,5535,570,318,4646,6028,284522,201658,53166,39070,14096,29698,3279,26419,10215,6459,3756,60,3696,27853,31221,7148,3
4,0,7,11,32.7,35,19.7,12.7,770136,435615,221660,33566,9839,178255,112861,27079,28440,16087,8186,1240,363,6583,4168,528867,373751,98661,72049,26612,56455,23325,33130,15192,11877,3315,259,3056,34812,31468,10841,2
4,0,3,2,29.2,40.8,19.1,10.9,767313,465946,193821,21849,9930,162042,107546,28008,27396,16636,6920,780,355,5786,3840,200547,109693,32750,25243,7507,58104,22327,35777,7073,3808,3265,652,2613,28354,28806,13692,2
4,0,6,4,34,33.3,19.8,12.9,724630,381153,210565,18920,10098,181547,132912,28174,25720,13529,7474,672,358,6444,4718,374983,252069,69436,51854,17582,53478,32573,20905,12027,8575,3452,294,3158,31178,29396,6620,2
4,0,6,5,39.6,34.6,18.1,7.7,620741,337010,195616,23847,10232,161537,88115,25894,23972,13015,7554,921,395,6238,3403,278831,188412,55579,41863,13716,34840,5569,29271,8353,6147,2206,254,1952,33381,30651,14995,2
4,0,3,2,18.7,35.9,28.5,17,992102,716382,143340,17409,10275,115656,132380,28326,35024,25291,5060,615,363,4083,4673,257837,181125,46504,33976,12528,30208,14082,16126,8387,5736,2651,152,2499,30742,31577,6453,3
4,0,6,5,29.9,37.1,21.5,11.6,805984,467653,223922,29119,10349,184454,114409,30016,26852,15580,7460,970,345,6145,3812,442790,311142,86913,65617,21296,44735,6557,38178,11611,8760,2851,258,2593,38135,35518,14723,1
4,0,6,6,28.9,36.9,20.7,13.5,670681,356043,194894,20626,10474,163794,119744,25108,26712,14180,7762,821,417,6524,4769,310523,196492,53759,39547,14212,60272,29139,31133,9138,6523,2615,532,2083,33982,30123,14946,1
4,0,7,8,28.9,35.9,21.2,14.1,719219,382549,218613,24645,10646,183322,118057,26069,27589,14674,8386,945,408,7032,4529,449165,333372,89117,65836,23281,26676,-241,26917,13006,10139,2867,176,2691,34535,32880,10003,0
4,0,1,1,37,36.1,17.9,9,769844,450565,214750,26110,10809,177831,104529,28774,26755,15659,7463,907,376,6180,3633,355613,247337,67235,49356,17879,41041,6337,34704,10222,7214,3008,290,2718,34789,34286,12768,0
4,0,6,4,28,30.4,23.9,17.6,801166,469403,178629,16661,11182,150786,153134,29723,26954,15793,6010,561,376,5073,5152,352125,235554,67708,51031,16677,48863,3535,45328,10627,7174,3453,215,3238,33135,32834,13999,5
4,0,6,3,33.3,37.2,18,11.5,733686,391701,229013,29193,11354,188466,112972,27360,26816,14317,8370,1067,415,6888,4129,351511,248761,65562,47918,17644,37188,6570,30618,10165,7840,2325,277,2048,34581,31730,14950,0
4,0,1,1,29.8,33.1,21.4,15.6,1002245,571614,230666,17185,11394,202087,199965,29542,33926,19349,7808,582,386,6841,6769,363028,246785,64255,46748,17507,51988,4770,47218,12042,7455,4587,260,4327,30147,33103,10912,4
4,0,6,5,30.3,33.5,24,12.1,813465,461866,223568,36949,11750,174869,128031,28058,28992,16461,7968,1317,419,6232,4563,462244,285731,82290,62965,19325,94223,58147,36076,13272,9735,3537,284,3253,34829,29351,11090,0
4,0,4,8,29.7,38.8,20.2,11.4,954900,475336,335294,38753,12128,284413,144270,35985,26536,13209,9318,1077,337,7904,4009,735237,547943,148813,104047,44766,38481,5887,32594,19184,16199,2985,239,2746,38326,33826,11870,0
4,0,4,3,16.7,33.2,34.1,16,1423958,878202,266979,31501,13313,222165,278777,50024,28465,17556,5337,630,266,4441,5573,1068050,784837,260223,196548,63675,22990,379,22611,23125,19439,3686,51,3635,46186,40374,6220,2
4,0,6,5,30.1,30.2,20.4,19.3,891730,472002,254689,44591,13387,196711,165039,32724,27250,14424,7783,1363,409,6011,5043,520528,361085,108312,82237,26075,51131,22057,29074,14817,12048,2769,321,2448,35130,29971,11877,0
4,0,6,5,35.1,35.8,17.7,11.4,1205462,687626,327763,50032,13482,264249,190073,45152,26698,15229,7259,1108,299,5852,4210,680760,451789,126647,95925,30722,102324,66506,35818,19132,15670,3462,463,2999,35582,28831,11943,1
4,0,4,5,26.5,33.6,23.2,16.8,1434661,789455,366049,47215,14208,304626,279157,44689,32103,17666,8191,1057,318,6817,6247,1014833,762730,189846,137281,52565,62257,10179,52078,26569,21530,5039,365,4674,38196,35426,11142,3
4,0,6,5,29.1,33.7,21.3,15.8,1132683,620006,285232,25029,14474,245729,227445,42947,26374,14437,6641,583,337,5722,5296,683976,475262,141959,108883,33076,66755,14219,52536,19549,15045,4504,314,4190,34988,31589,12538,3
4,0,4,5,32.1,30.3,22,15.6,1132133,652589,291838,42857,14811,234170,187706,39748,28483,16418,7342,1078,373,5891,4722,878825,629949,170620,128098,42522,78256,20376,57880,24814,19730,5084,284,4800,35416,31928,12058,10
4,0,6,3,36.7,35.1,20.2,8,1055139,601309,319918,39169,16359,264390,133912,41386,25495,14529,7730,946,395,6388,3236,538262,388889,108957,81976,26981,40416,6576,33840,15756,12028,3728,305,3423,34162,32332,9886,1
4,0,2,2,21.1,40.4,24.8,13.6,1672620,1228183,261619,28987,16768,215864,182818,51908,32223,23661,5040,558,323,4159,3522,514436,372575,101123,76224,24899,40738,-553,41291,14626,10301,4325,166,4159,35173,36169,9928,0
4,0,6,5,29.7,37.1,18.8,14.4,1418852,814190,378801,57133,17839,303829,225861,48601,29194,16753,7794,1176,367,6251,4647,934955,687709,186036,137268,48768,61210,-434,61644,24469,19718,4751,573,4178,38210,34877,14754,1
4,0,7,8,35.2,33,21.8,10,1026763,576019,289942,45292,18078,226572,160802,42089,24395,13686,6889,1076,430,5383,3821,688137,481693,134939,101050,33889,71505,36796,34709,19800,15602,4198,501,3697,34754,30874,9388,0
4,0,3,2,38.9,35.4,18.5,7.2,893521,544885,246708,35178,18135,193395,101928,39888,22401,13660,6185,882,455,4848,2555,491637,360903,91415,65075,26340,39319,10768,28551,13584,11111,2473,268,2205,36192,32482,12948,0
4,0,3,2,13.2,34.2,38,14.5,1803822,1080678,310627,57101,18436,235090,412517,67061,26898,16115,4632,851,275,3506,6151,2319755,1680363,613839,465647,148192,25553,667,24886,39491,35981,3510,46,3464,58741,46701,7184,1
4,0,4,5,27.4,35.4,21,16.2,1211372,652374,354410,41212,18902,294296,204588,47087,25726,13855,7527,875,401,6250,4345,792349,578711,175340,136695,38645,38298,742,37556,23187,18914,4273,131,4142,34172,30597,9067,1
4,0,2,2,24,34.8,27.4,13.8,1745252,1148183,396285,38508,20914,336863,200784,63874,27323,17976,6204,603,327,5274,3143,703253,476954,121993,88301,33692,104306,9992,94314,20023,14629,5394,230,5164,35122,32603,18264,3
4,0,6,6,31.9,35.5,20.8,11.7,1713358,1109903,358413,39109,21571,297733,245042,60052,28531,18482,5968,651,359,4958,4080,853961,651418,168444,123882,44562,34099,20402,13697,24650,19385,5265,705,4560,34643,33604,3004,10
4,0,4,5,22.1,29.7,22.8,25.4,1763990,1080881,382591,50621,22089,309881,300518,68598,25715,15757,5577,738,322,4517,4381,1042861,762283,212164,160664,51500,68414,10151,58263,31522,24952,6570,515,6055,33084,30550,9622,1
4,0,6,5,34.1,34.1,21.2,10.6,1454326,923041,342637,45919,23517,273201,188648,54945,26469,16799,6236,836,428,4972,3433,973426,695067,171059,120981,50078,107300,23611,83689,25059,19894,5165,660,4505,38845,34939,18577,0
4,0,3,2,17.8,29.3,29.2,23.8,2749706,1521444,546604,59046,24531,463027,681658,78946,34830,19272,6924,748,311,5865,8634,1947454,1439271,368067,267173,100894,140116,-649,140765,48220,38925,9295,34,9261,40387,36975,15200,5
4,0,2,2,33.2,35,21.7,10.2,1701390,972917,499465,51720,25140,422605,229008,68612,24797,14180,7280,754,366,6159,3338,641942,423695,126679,96107,30572,91568,13903,77665,20899,14125,6774,444,6330,30716,29996,12269,3
4,0,1,1,26.7,36,26.4,10.9,1848405,1255447,357281,45600,26563,285118,235677,68548,26965,18315,5212,665,388,4159,3438,725962,537917,134481,97063,37418,53564,10376,43188,23743,16079,7664,338,7326,30576,33455,5895,2
4,0,4,3,27,33.7,21.3,18,1926835,1149558,475810,69983,28640,377187,301467,66422,29009,17307,7163,1054,431,5679,4539,1578405,1190204,301384,215009,86375,86817,-675,87492,38729,31408,7321,197,7124,40755,37895,12281,4
4,0,1,1,32.2,34.7,20.6,12.5,1714697,960600,492058,74680,29238,388140,262039,64135,26736,14978,7672,1164,456,6052,4086,1013278,740954,200455,149103,51352,71869,-1932,73801,29109,22612,6497,270,6227,34810,32768,11852,3
4,0,1,1,26.5,35.6,24.8,13,2450850,1612781,481509,57254,30701,393554,356560,83353,29403,19349,5777,687,368,4722,4278,993406,707890,179585,129832,49753,105931,12156,93775,27949,20356,7593,397,7196,35544,34775,13032,14
4,0,2,2,12.1,25.8,30.2,32,4773663,3353156,625559,47102,30828,547629,794948,121050,39435,27701,5168,389,255,4524,6567,1509504,1061239,261549,186985,74564,186716,1004,185712,45395,31594,13801,141,13660,33253,33590,13595,15
4,0,1,1,7.6,24,32.2,36.2,4714508,3306739,559824,35820,31545,492459,847945,105493,44690,31346,5307,340,299,4668,8038,2055180,1551369,360286,252987,107299,143525,888,142637,55402,39437,15965,117,15848,37096,39338,9000,26
4,0,1,1,17.6,29.4,29.7,23.4,2496101,1644538,492142,67365,31903,392874,359421,84625,29496,19433,5816,796,377,4643,4247,1620078,1247463,282498,195234,87264,90117,342,89775,41547,31183,10364,89,10275,38994,40005,8737,23
4,0,3,2,22.3,30.6,27.4,19.7,3157195,1866414,671174,94371,32987,543816,619607,107583,29347,17349,6239,877,307,5055,5759,2422150,1833436,521190,385578,135612,67524,5696,61828,65134,54617,10517,374,10143,37187,33569,6096,0
4,0,3,2,19,21.6,19.6,39.8,2938375,1688352,579244,83537,34940,460767,670779,116843,25148,14450,4957,715,299,3943,5741,3500858,2657564,740241,564016,176225,103053,-387,103440,83629,71586,12043,80,11963,41862,37124,8647,21
4,0,3,2,26.3,28.3,27.6,17.8,2710765,1473087,770672,142195,35794,592683,467006,94688,28628,15557,8139,1502,378,6259,4932,2595586,1969868,521821,383658,138163,103897,8035,95862,60580,52304,8276,100,8176,42846,37662,11725,0
4,0,3,2,15.7,32.4,32.2,19.8,4816982,3051241,839262,100874,37066,701322,926479,137416,35054,22204,6107,734,270,5104,6742,3729057,2775579,850256,639680,210576,103222,10,103212,75964,63626,12338,227,12111,49090,43623,8522,3
4,0,3,2,28.5,33.2,22.4,15.8,2833878,1635906,743303,83579,37323,622401,454669,96383,29402,16973,7712,867,387,6458,4717,2056988,1489954,379852,274887,104965,187182,8019,179163,49708,40382,9326,468,8858,41381,36896,20226,6
4,0,3,2,37,29,21.1,12.8,2663779,1607419,606534,84472,39900,482162,449826,101009,26372,15914,6005,836,395,4773,4453,2699864,2077473,491393,341281,150112,130998,1953,129045,64074,55845,8229,364,7865,42137,37201,16408,5
4,0,1,1,28.2,34.2,23.5,14.1,2815872,1803122,608883,77323,40801,490759,403867,99807,28213,18066,6101,775,409,4917,4046,1683423,1245177,324151,235562,88589,114095,22923,91172,43528,33336,10192,405,9787,38674,37352,9316,8
4,0,1,1,28.9,34.2,20.3,16.5,3197012,1986654,700367,92928,41061,566378,509991,110433,28950,17990,6342,841,372,5129,4618,1921860,1418936,366927,268116,98811,135997,25092,110905,52333,39282,13051,848,12203,36724,36122,9088,8
4,0,1,1,25.3,34.7,25.4,14.5,2643633,1733265,564929,86929,41197,436803,345439,99494,26571,17421,5678,874,414,4390,3472,1079955,803550,219294,163061,56233,57111,-287,57398,32511,21458,11053,246,10807,33218,37448,5311,7
4,0,1,1,18.4,32.8,28.2,20.6,4377726,3133191,652603,79665,43248,529690,591932,125501,34882,24965,5200,635,345,4221,4717,1542120,1157199,299407,218484,80923,85514,2940,82574,47803,33380,14423,336,14087,32260,34667,5862,14
4,0,1,1,19.2,39.1,26.5,15.2,4024840,3015054,594924,68529,48876,477519,414862,140761,28593,21420,4226,487,347,3392,2947,932265,668475,173713,127368,46345,90077,3093,86984,32733,21250,11483,141,11342,28481,31458,7669,1
4,0,1,1,18.9,34.6,27.3,19.2,3811741,2688164,675954,94811,50174,530969,447623,131292,29033,20475,5148,722,382,4044,3409,1726888,1338462,329074,234674,94400,59352,-154,59506,56376,40740,15636,105,15531,30632,32854,3831,9
4,0,1,1,14.3,23.5,27.6,34.6,7724892,6125342,630107,40370,51777,537960,969443,171993,44914,35614,3664,235,301,3128,5637,3810063,2577590,546979,368348,178631,685494,8545,676949,78447,58075,20372,247,20125,48569,44384,33637,68
4,0,3,2,22.8,31.7,24.2,21.3,5103424,2924891,1262819,187802,52492,1022525,915714,155154,32893,18852,8139,1210,338,6590,5902,4399208,3272085,797264,564841,232423,329859,-26,329885,107379,86554,20825,96,20729,40969,37804,15914,11
4,0,2,2,21.1,28.2,30.4,20.3,6320665,3452767,1411674,219040,60050,1132584,1456224,188796,33479,18288,7477,1160,318,5999,7713,5276819,4043654,1061901,772402,289499,171264,62,171202,123588,103522,20066,29,20037,42697,39061,8544,7
4,0,3,2,29.5,29.6,22.2,18.7,5411867,3388686,1019047,118492,60152,840403,1004134,178503,30318,18984,5709,664,337,4708,5625,3738374,2883278,678045,487508,190537,177051,7246,169805,91963,73485,18478,605,17873,40651,39236,9501,17
4,0,1,1,15.8,34.3,30.4,19.5,6132128,4359761,960371,122241,67548,770582,811996,199622,30719,21840,4811,612,338,3860,4068,2355530,1815818,462133,334749,127384,77579,973,76606,76669,50956,25713,230,25483,30723,35635,3006,8
4,0,2,2,22,29.6,29.7,18.7,5913855,3286152,1537936,239793,69010,1229133,1089767,198489,29794,16556,7748,1208,348,6192,5490,6537490,4832168,1392304,1035651,356653,313018,-115,313133,132787,116879,15908,115,15793,49233,41343,19827,6
4,0,1,1,15.6,27.3,30.2,27,7621819,5694991,939954,70594,69504,799856,986874,212232,35913,26834,4429,333,327,3769,4650,2459735,1720093,409399,290003,119396,330243,4194,326049,79993,48858,31135,351,30784,30749,35206,10592,41
4,0,2,2,19.8,26.9,28.3,25,9650513,5994206,1750081,200763,82288,1467030,1906226,262122,36817,22868,6677,766,314,5597,7272,7911591,5982208,1513105,1078360,434745,416278,2765,413513,173708,145502,28206,23,28183,45545,41114,14672,9
4,0,1,1,19.9,31.9,31.5,16.6,6285498,4128690,1426214,301525,112381,1012308,730594,260067,24169,15875,5484,1159,432,3892,2809,6744303,5238021,1345114,992726,352388,161168,-564,161732,148066,120834,27232,32,27200,45549,43349,5946,2
4,0,1,1,11.2,20.8,28.3,39.8,27964197,20257116,3136324,339560,243815,2552949,4570757,684776,40837,29582,4580,496,356,3728,6675,20677739,16211775,3387599,2272719,1114880,1078365,1616,1076749,428014,323706,104308,94,104214,48311,50082,10332,137
4,0,1,1,12.7,22,31.2,34.1,25351130,18994030,3076164,442094,267755,2366315,3280936,796276,31837,23854,3863,555,336,2972,4120,19145943,14900658,3148347,2120553,1027794,1096938,3558,1093380,437958,322813,115145,140,115005,43716,46159,9507,256
4,0,1,1,14.9,20.3,28.4,36.3,25359047,17225060,3652166,584101,275430,2792635,4481821,690658,36717,24940,5288,846,399,4043,6489,19802741,15071332,3417021,2345475,1071546,1314388,4,1314384,410437,307707,102730,24,102706,48248,48979,12798,215
4,0,1,1,16,19.4,23.3,41.4,52875079,37454269,4840315,770320,353101,3716894,10580495,905511,58393,41363,5345,851,390,4105,11685,64976942,46041331,9265776,6157296,3108480,9669835,357,9669478,906539,748540,157999,150,157849,71676,61508,61258,374
4,0,5,8,16.7,29.7,34.1,19.4,2335793,1394930,448319,44428,38067,365824,492544,66518,35115,20971,6740,668,572,5500,7405,1575609,1121364,260044,178810,81234,194201,-6714,200915,40461,29469,10992,562,10430,38941,38052,19263,1
4,0,5,8,15.4,31.4,31.1,22.1,5710062,3144204,1325144,222373,104297,998474,1240714,183629,31096,17123,7216,1211,568,5437,6757,3533925,2457579,607792,429326,178466,468554,25252,443302,96014,67017,28997,3680,25317,36806,36671,17510,12
4,0,2,2,15.2,27.8,29.2,27.9,42616645,27768364,5653875,684910,331356,4637609,9194406,943177,45184,29441,5995,726,351,4917,9748,31258917,22237573,6039986,4332563,1707423,2981358,64345,2917013,598479,498557,99922,736,99186,52231,44604,29410,43
4,0,9,12,17.2,44.4,25,13.4,162272,81841,42578,3208,1004,38366,37853,5119,31700,15988,8318,627,196,7495,7395,73606,43418,12907,9541,3366,17281,9196,8085,2769,1521,1248,567,681,26582,28546,11872,0
4,0,9,12,15.5,41.4,31.1,12,148274,82240,37741,2523,1157,34061,28293,4047,36638,20321,9326,623,286,8416,6991,74262,38412,11705,8860,2845,24145,18267,5878,2337,1461,876,446,430,31777,26292,13670,0
4,0,8,7,17.5,44.8,25.5,12.3,229114,135132,49091,2731,1697,44663,44891,6136,37339,22023,8000,445,277,7279,7316,111221,53493,15650,11380,4270,42078,27909,14169,3270,1906,1364,533,831,34013,28066,17051,0
4,0,8,6,15,42.4,28.7,14,330107,220145,64445,4503,1842,58100,45517,7453,44292,29538,8647,604,247,7796,6107,220205,101506,26945,18933,8012,91754,48598,43156,4348,3056,1292,373,919,50645,33215,46960,0
4,0,8,7,15,43.2,28.1,13.6,280735,166155,56664,3263,1947,51454,57916,7090,39596,23435,7992,460,275,7257,8169,202514,119787,32723,23536,9187,50004,32995,17009,5062,3611,1451,463,988,40007,33173,17216,0
4,0,9,12,16.1,45.9,25.9,12.1,198304,104342,54040,4400,1962,47678,39922,6393,31019,16321,8453,688,307,7458,6245,97020,54300,18084,13808,4276,24636,11358,13278,3485,2038,1447,640,807,27839,26644,16454,4
4,0,9,10,16.7,46.6,24.7,12,209648,125849,49939,3858,2054,44027,33860,6355,32989,19803,7858,607,323,6928,5328,109056,54633,15994,11794,4200,38429,27532,10897,3383,1945,1438,600,838,32236,28089,13004,0
4,0,7,9,18.9,37.6,30,13.4,230140,147011,42756,2621,2221,37914,40373,6509,35357,22586,6569,403,341,5825,6203,138777,70495,20002,14453,5549,48280,21266,27014,3515,2410,1105,454,651,39481,29251,41496,0
4,0,9,10,14.6,38.1,31.9,15.4,371912,218362,85523,4703,2248,78572,68027,9684,38405,22549,8831,486,232,8114,7025,178594,92858,27245,20228,7017,58491,34419,24072,5487,3408,2079,660,1419,32549,27247,16964,0
4,0,9,10,13.4,39.9,31.8,15,292814,184251,61013,3770,2258,54985,47550,7395,39596,24916,8251,510,305,7435,6430,187258,85214,25006,18208,6798,77038,53666,23372,4396,2904,1492,577,915,42597,29344,25543,0
4,0,6,6,13.4,45.9,25.3,15.3,471694,284946,95508,5763,2315,87430,91240,12165,38775,23423,7851,474,190,7187,7500,303814,182362,53397,38921,14476,68055,37085,30970,8284,6226,2058,712,1346,36675,29290,23009,0
4,0,2,2,16.8,36.6,30.3,16.3,681180,401890,191872,7377,2351,182144,87418,15056,45243,26693,12744,490,156,12098,5806,247046,140493,42222,31552,10670,64331,39251,25080,6330,4344,1986,390,1596,39028,32342,15714,1
4,0,9,12,18.3,41.5,25.1,15.1,214783,116388,63250,6802,2427,54021,35145,8506,25251,13683,7436,800,285,6351,4132,97124,62433,18983,13967,5016,15708,4876,10832,4266,2582,1684,590,1094,22767,24180,9901,0
4,0,8,6,21.3,38.3,26.1,14.2,400937,260346,66345,4183,2515,59647,74246,11557,34692,22527,5741,362,218,5161,6424,223027,115173,33658,25025,8633,74196,36812,37384,6503,4021,2482,826,1656,34296,28643,22575,0
4,0,2,2,15,44.1,28.2,12.7,555846,362027,117395,8199,2628,106568,76424,14972,37126,24180,7841,548,176,7118,5104,238483,128375,35831,25903,9928,74277,40996,33281,6774,4236,2538,661,1877,35206,30306,17731,1
4,0,8,7,12.2,48.4,28.2,11.2,272949,169099,55105,3592,2711,48802,48745,7676,35559,22030,7179,468,353,6358,6350,147568,82951,23268,16452,6816,41349,19848,21501,4449,2935,1514,604,910,33169,28263,23627,0
5,0,7,9,4.6,33.4,35.2,26.8,316884,177500,57024,2460,3119,51445,82360,8587,36903,20671,6641,286,363,5991,9591,172663,114184,32328,21048,11280,26151,-5036,31187,5916,3539,2377,293,2084,29186,32264,14965,2
5,0,9,12,9.5,28.9,42.4,19.2,375917,227533,82999,4799,3443,74757,65385,11667,32221,19502,7114,411,295,6408,5604,241812,163028,47849,31040,16809,30935,970,29965,6750,4572,2178,584,1594,35824,35658,18799,1
5,0,9,10,3.8,37.3,33.6,25.4,465612,339631,40873,1553,3459,35861,85108,10254,45408,33122,3986,151,337,3497,8300,484235,336276,70807,41025,29782,77152,-3831,80983,8157,5974,2183,304,1879,59364,56290,43099,1
5,0,6,6,9.7,36.5,35.7,18.2,562136,386835,88882,6227,3996,78659,86419,13821,40673,27989,6431,451,289,5691,6253,391752,264497,69753,43874,25879,57502,-6501,64003,8203,5993,2210,362,1848,47757,44134,34634,1
5,0,7,9,9.1,33.9,36.2,20.9,619471,404502,100568,7529,5453,87586,114401,15849,39086,25522,6345,475,344,5526,7218,429077,292322,90397,60936,29461,46358,-4139,50497,9599,7217,2382,241,2141,44700,40505,23586,2
5,0,4,5,3.8,16.1,30.3,49.8,1249041,770918,197070,10814,7070,179186,281053,36433,34283,21160,5409,297,194,4918,7714,858586,606682,180970,122382,58588,70934,-3122,74056,22700,17995,4705,394,4311,37823,33714,17178,15
5,0,7,8,8.2,37.4,37,17.4,814340,591077,119055,9839,8216,101000,104208,21093,38607,28022,5644,466,390,4788,4940,614725,434981,109864,68071,41793,69880,-392,70272,12791,9978,2813,305,2508,48059,43594,28019,2
5,0,7,9,7.1,31.3,41.1,20.5,601078,359108,107923,6317,8426,93180,134047,18094,33220,19847,5965,349,466,5150,7408,360237,256122,72404,48529,23875,31711,73,31638,9833,6496,3337,525,2812,36636,39428,11251,0
5,0,7,11,4.9,27.5,35.3,32.2,1139392,660893,214142,12222,8789,193131,264357,28248,40335,23396,7581,433,311,6837,9358,778658,519570,137278,87732,49546,121810,-84,121894,20280,14086,6194,737,5457,38395,36886,22337,3
5,0,7,8,4.9,13,28,54.1,3088147,1054908,99542,3965,13991,81586,1933697,21295,145017,49538,4674,186,657,3831,90805,1268470,696557,149466,77984,71482,422447,264,422183,26308,17600,8708,129,8579,48216,39577,49211,25
5,0,7,8,4.7,23.7,40.3,31.3,1481624,721246,209632,11701,14188,183743,550746,29123,50875,24766,7198,402,487,6309,18911,763742,526508,140960,87787,53173,96274,-6482,102756,19595,13791,5804,603,5201,38976,38178,19757,3
5,0,7,8,8.9,31.7,36.1,23.3,1445174,856519,320928,27018,16218,277692,267727,40195,35954,21309,7984,672,403,6909,6661,944098,654513,175759,112347,63412,113826,5790,108036,24428,17735,6693,1251,5442,38648,36905,19852,4
5,0,5,8,8.7,33.5,35.5,22.2,1883526,1419528,223528,14063,17445,192020,240470,43569,43231,32581,5130,323,400,4407,5519,1772040,1305789,303073,184049,119024,163178,-2913,166091,29291,25071,4220,225,3995,60498,52084,41575,7
5,0,5,8,8.7,35.7,37.1,18.5,2334683,1830271,194164,12539,18802,162823,310248,46233,50498,39588,4200,271,407,3522,6711,2394508,1655876,357929,208439,149490,380703,-10312,391015,36344,29759,6585,661,5924,65885,55643,66005,3
5,0,3,2,6.8,25.3,39.3,28.7,3955192,2419749,679150,49154,32339,597657,856293,92219,42889,26239,7365,533,351,6481,9285,2871712,2001070,593693,390620,203073,276949,21391,255558,61441,48730,12711,898,11813,46739,41064,21634,9
5,0,3,2,7.8,29.4,40,22.8,3745140,2526172,509322,39286,33705,436331,709646,75456,49633,33479,6750,521,447,5783,9405,2867423,1799481,406264,235377,170887,661678,-2802,664480,51833,40075,11758,358,11400,55320,44903,58288,2
6,0,9,12,7.6,23.4,36.8,32.2,72790,53135,7579,614,1020,5945,12076,962,75665,55234,7878,638,1060,6180,12553,55994,28870,9073,6591,2482,18051,0,18051,962,673,289,0,289,58206,42897,62460,0
6,0,9,12,3.4,28.4,33.5,34.7,113376,62012,25316,2941,1073,21302,26048,2574,44047,24092,9835,1143,417,8276,10120,62276,37466,12390,9442,2948,12420,0,12420,1715,1056,659,0,659,36313,35479,18847,0
6,0,9,12,14.2,41.6,32.7,11.5,120811,98444,9603,1258,1262,7083,12764,3262,37036,30179,2944,386,387,2171,3913,109967,72088,23719,17791,5928,14160,0,14160,2321,1983,338,0,338,47379,36353,41893,0
6,0,8,7,1.3,28.6,25.7,44.5,126298,77998,30366,4482,1379,24505,17934,1870,67539,41710,16239,2397,737,13104,9590,122651,92167,25276,17440,7836,5208,0,5208,2165,1854,311,0,311,56652,49713,16746,0
6,0,9,10,9.7,37.3,31.1,21.9,96025,54567,23218,2230,1969,19019,18240,2118,45338,25763,10962,1053,930,8980,8612,48387,25307,10736,8921,1815,12344,0,12344,1218,732,486,0,486,39727,34572,25399,0
6,0,9,12,13.6,38.7,30.4,17.4,233390,158493,42238,10094,2106,30038,32659,4948,47169,32032,8536,2040,426,6071,6600,173970,110217,37631,28985,8646,26122,0,26122,3564,2647,917,0,917,48813,41638,28486,0
6,0,7,11,11.6,40,33.1,15.3,592558,471936,51841,8832,2705,40304,68781,9549,62054,49423,5429,925,283,4221,7203,1653258,1383705,259796,166584,93212,9757,0,9757,14270,13953,317,0,317,115856,99169,30779,0
6,0,7,11,6.5,26.5,34.1,32.9,515545,339843,66082,7266,2951,55865,109620,8888,58005,38236,7435,818,332,6285,12333,360961,200914,68044,52718,15326,92003,0,92003,6426,4561,1865,0,1865,56172,44050,49331,0
6,0,9,10,10,37.8,35.4,16.8,199235,121065,47201,5524,3611,38066,30969,5763,34571,21007,8190,959,627,6605,5374,129732,79885,30549,25111,5438,19298,0,19298,2804,1973,831,0,831,46267,40489,23223,1
6,0,9,12,8.5,33.1,38.9,19.5,306545,197198,63658,9707,3869,50082,45689,7149,42879,27584,8904,1358,541,7005,6391,262122,184760,51166,37909,13257,26196,0,26196,3902,2857,1045,0,1045,67176,64669,25068,0
6,0,9,11,4.1,28,35.2,32.7,498088,341951,69225,7828,4514,56883,86912,9742,51128,35101,7106,804,463,5839,8921,403299,257678,84979,66547,18432,60642,0,60642,6956,4990,1966,0,1966,57979,51639,30845,0
6,0,7,11,11.5,28.9,35.5,24.1,717027,498261,92086,12542,4593,74951,126680,13820,51883,36054,6663,908,332,5423,9166,557942,343470,117738,89161,28577,96734,0,96734,9832,7528,2304,0,2304,56748,45626,41985,0
6,0,9,12,15.3,41.7,30.6,12.4,260042,129720,88281,20108,4829,63344,42041,5631,46180,23037,15678,3571,858,11249,7466,144677,96676,41173,35492,5681,6828,0,6828,2719,2265,454,0,454,53210,42683,15040,2
6,0,7,11,15.1,43.5,27.4,14,411671,252362,110871,23186,4887,82798,48438,9775,42115,25817,11342,2372,500,8470,4955,276330,180938,66687,54807,11880,28705,0,28705,4743,3914,829,0,829,58261,46228,34626,0
6,0,7,8,8.1,30.4,37.4,24.1,772646,505451,125240,17937,5779,101524,141955,13644,56629,37046,9179,1315,424,7441,10404,568342,344771,115757,90185,25572,107814,0,107814,10095,7637,2458,0,2458,56299,45145,43862,1
6,0,5,8,4,20.5,35.2,40.3,1857772,1294699,208180,27983,9414,170783,354893,32162,57763,40256,6473,870,293,5310,11035,1437077,929444,332954,270331,62623,174679,-9936,184615,23417,18839,4578,28,4550,61369,49336,40575,0
6,0,7,11,19.8,44.7,22.9,12.6,642089,389973,183563,42256,10118,131189,68553,17416,36868,22392,10540,2426,581,7533,3936,430837,294045,113659,93685,19974,23133,0,23133,8623,7215,1408,0,1408,49964,40755,16430,0
6,0,7,11,7.4,31.2,37.2,24.1,2561929,1622070,472254,54422,24324,393508,467605,56304,45502,28809,8388,967,432,6989,8305,1499618,916434,292617,225836,66781,290567,-516,291083,30798,20192,10606,140,10466,48692,45386,27812,6
6,0,3,2,5.4,21.7,39.8,33.1,4970113,3380209,702862,91561,30732,580569,887042,98136,50645,34444,7162,933,313,5916,9039,3638634,2491534,860812,655820,204992,286288,1516,284772,58909,48969,9940,190,9750,61767,50880,29207,3
6,0,2,2,7.9,32.1,39.4,20.6,3915625,2813410,570643,69808,36406,464429,531572,91721,42691,30674,6222,761,397,5063,5796,1509928,860675,276091,208919,67172,373162,-4677,377839,33158,21921,11237,247,10990,45537,39263,34380,2
6,0,2,2,6.6,23.8,35,34.6,17334300,12068597,2258429,332818,92605,1833006,3007274,296291,58504,40732,7622,1123,313,6187,10150,14059387,9213504,2647551,1917540,730011,2198332,0,2198332,203575,168307,35268,0,35268,69062,54742,62332,13
6,0,8,3,23.2,38.5,27.3,11,289352,152010,95945,11968,2197,81780,41397,11484,25196,13237,8355,1042,191,7121,3605,74697,49542,14585,10525,4060,10570,343,10227,2356,1522,834,150,684,31705,32551,14952,0
6,0,8,4,24.2,37.4,26,12.4,428701,254958,123406,13488,2483,107435,50337,14928,28718,17079,8267,904,166,7197,3372,141109,90831,25278,18250,7028,25000,2090,22910,4255,2690,1565,320,1245,33163,33766,18402,0
6,0,6,6,28.6,36.6,21.4,13.4,257394,128974,88330,16786,2571,68973,40090,10675,24112,12082,8274,1572,241,6461,3756,132122,87265,26992,19914,7078,17865,8123,9742,3970,3122,848,238,610,33280,27952,15970,0
6,0,8,6,20.7,37.8,25.2,16.3,405390,221473,127557,16356,2788,108413,56360,13898,29169,15936,9178,1177,201,7801,4055,192022,124652,35307,24859,10448,32063,4035,28028,5901,4054,1847,534,1313,32541,30748,21347,0
6,0,9,10,26.7,33.7,29.3,10.3,365655,184631,126982,14171,2867,109944,54042,13688,26714,13489,9277,1035,209,8032,3948,160710,111357,33243,23832,9411,16110,-970,17080,5550,3937,1613,378,1235,28957,28285,13830,0
6,0,3,2,19.4,33.9,29.7,17.1,565847,319871,155835,17253,2882,135700,90141,17376,32565,18409,8968,993,166,7810,5188,190780,125282,33678,23719,9959,31820,8580,23240,5781,3745,2036,416,1620,33001,33453,14346,0
6,0,7,11,21,48,22.3,8.8,354084,161379,139341,21188,3171,114982,53364,13187,26851,12238,10567,1607,240,8719,4047,170959,111143,32976,23945,9031,26840,10310,16530,4973,3555,1418,328,1090,34377,31264,15165,0
6,0,2,2,24,36.1,26.1,13.7,349706,194222,114552,25270,3359,85923,40932,11130,31420,17450,10292,2270,302,7720,3678,174594,113025,33818,24657,9161,27751,14392,13359,4633,3003,1630,392,1238,37685,37637,10791,0
6,0,6,6,20.4,37.9,27.1,14.6,467538,229370,171354,19333,3414,148607,66814,17050,27422,13453,10050,1134,200,8716,3919,176714,121108,38671,28965,9706,16935,1411,15524,5778,4333,1445,372,1073,30584,27950,14468,1
6,0,3,2,21,35.7,32.2,11.1,785353,420585,250519,28813,4386,217320,114249,26760,29348,15717,9362,1077,164,8121,4269,256727,159696,47470,34663,12807,49561,12810,36751,8951,5686,3265,906,2359,28681,28086,15579,1
6,0,6,4,21.4,36.7,27.3,14.6,605019,302115,209557,27913,4604,177040,93347,22740,26606,13286,9215,1227,202,7785,4105,211230,143855,41383,29928,11455,25992,-5817,31809,7573,4959,2614,558,2056,27893,29009,15471,2
6,0,6,6,20.5,38.2,28.9,12.5,750484,402161,236995,26144,4854,205997,111328,25993,28873,15472,9118,1006,187,7925,4283,248814,158957,46448,33576,12872,43409,11887,31522,7741,5311,2430,524,1906,32142,29930,16538,1
6,0,6,6,26.9,35.5,25.5,12,768718,396977,239448,37531,5098,196819,132293,27351,28106,14514,8755,1372,186,7196,4837,435242,304263,88941,63676,25265,42038,10103,31935,12359,9773,2586,519,2067,35217,31133,15450,1
6,0,6,6,18.4,32.3,29.2,20.1,559860,274536,194620,39251,5241,150128,90704,21284,26304,12899,9144,1844,246,7054,4262,295486,203982,70286,54395,15891,21218,1486,19732,7759,5615,2144,323,1821,38083,36328,10836,2
6,0,6,6,18.9,40.4,24.5,16.1,601853,312010,203575,30436,5676,167463,86268,20880,28824,14943,9750,1458,272,8020,4132,300075,210960,58615,41196,17419,30500,-1075,31575,9382,7077,2305,386,1919,31984,29809,16454,0
6,0,6,5,18.9,33,23.3,24.7,1067090,561219,310759,40743,5859,264157,195112,32967,32368,17024,9426,1236,178,8013,5918,704137,512133,142779,103316,39463,49225,4603,44622,18571,14911,3660,557,3103,37916,34346,14380,1
6,0,6,6,23.6,37.5,25.5,13.4,894424,501836,269012,35029,6054,227929,123576,31767,28156,15797,8468,1103,191,7175,3890,478397,333424,96991,69190,27801,47982,-4825,52807,14533,11051,3482,774,2708,32918,30171,19500,4
6,0,6,6,19,43.8,25,12.1,1068309,545172,340822,44432,7309,289081,182315,38202,27965,14271,8922,1163,191,7567,4772,624321,454875,127886,93103,34783,41560,563,40997,17174,13392,3782,419,3363,36353,33966,12191,2
6,0,6,6,18,35.6,31,15.5,1119512,581526,363616,40879,7428,315309,174370,38017,29448,15296,9565,1075,195,8294,4587,596391,425407,121259,87043,34216,49725,6879,42846,18053,13598,4455,961,3494,33036,31285,12263,0
6,0,4,5,14.6,29.3,33.4,22.7,1816080,1065110,404751,38163,7599,358989,346219,50434,36009,21119,8025,757,151,7118,6865,712225,474922,128197,90082,38115,109106,14398,94708,20996,15852,5144,809,4335,33922,29960,21847,2
6,0,6,5,19.1,38.4,29.1,13.3,975673,514928,330751,45386,7784,277581,129994,34031,28670,15131,9719,1334,229,8157,3820,371389,269486,73642,52561,21081,28261,7056,21205,12315,8809,3506,275,3231,30157,30592,6563,0
6,0,3,2,22,40.8,27,10.2,963955,570223,282222,32192,7785,242245,111510,34047,28312,16748,8289,946,229,7115,3275,370044,264978,67113,47784,19329,37953,-5076,43029,10979,6701,4278,1421,2857,33705,39543,15061,0
6,0,1,1,18.2,43.4,23.3,15.1,1254140,744988,347012,46138,7931,292943,162140,43688,28707,17052,7943,1056,182,6705,3711,433803,287087,79566,56756,22810,67150,925,66225,13256,9292,3964,509,3455,32725,30896,19168,0
6,0,4,5,14,32.6,36.6,16.8,1692463,1007628,403888,50705,8418,344765,280947,50107,33777,20110,8061,1012,168,6881,5607,1865034,1255897,423505,316101,107404,185632,5438,180194,27361,23770,3591,447,3144,68164,52835,57314,2
6,0,6,6,19.2,34,28.6,18.2,1360222,709761,412604,47780,9263,355561,237857,41394,32860,17146,9968,1154,224,8590,5746,587627,416581,108534,74583,33951,62512,118,62394,17111,13306,3805,325,3480,34342,31308,17929,0
6,0,2,2,12.3,33.6,29.1,25,1894696,1224272,391827,44832,9636,337359,278597,55199,34325,22179,7098,812,175,6112,5047,562924,387206,99942,70454,29488,75776,7475,68301,17298,11945,5353,356,4997,32543,32416,13668,0
6,0,1,1,20.2,32.3,34.4,13.1,1632900,998208,422350,45504,10199,366647,212342,57562,28368,17341,7337,791,177,6370,3689,435330,277819,77961,55959,22002,79550,-9557,89107,14657,9471,5186,1162,4024,29701,29334,22144,4
6,0,2,2,17.1,32.4,33.6,16.9,1625282,909015,469163,77325,10861,380977,247104,54833,29641,16578,8556,1410,198,6948,4506,652213,461849,122382,86137,36245,67982,4507,63475,20157,14151,6006,254,5752,32357,32637,11035,1
6,0,6,5,18.6,40.7,27.3,13.4,1609668,883914,455520,45727,11246,398547,270234,53212,30250,16611,8560,859,211,7490,5078,822199,563123,156726,109972,46754,102350,7216,95134,23951,17280,6671,1296,5375,34328,32588,17699,4
6,0,4,5,18.7,36.6,30.5,14.2,1274519,614239,475108,98464,11534,365110,185172,43256,29465,14200,10984,2276,267,8441,4281,696038,478786,131017,92054,38963,86235,14244,71991,18591,14758,3833,460,3373,37440,32442,21343,0
6,0,1,1,20,37.3,31.6,11.1,2277999,1167976,697511,69135,12248,616128,412512,66577,34216,17543,10477,1038,184,9254,6196,943011,656545,175944,125333,50611,110522,-990,111512,25468,19843,5625,458,5167,37027,33087,21582,2
6,0,2,2,13.6,34.1,29.5,22.8,2814416,1775939,597909,68617,13762,515530,440568,80006,35178,22198,7473,858,172,6444,5507,915104,625007,169029,120277,48752,121068,2116,118952,28608,19744,8864,509,8355,31988,31656,14237,2
6,0,1,1,15.8,36.2,32,16,2593349,1675718,601316,63226,14517,523573,316315,84211,30796,19899,7141,751,172,6217,3756,851769,592925,153923,107114,46809,104921,-1546,106467,25734,18150,7584,503,7081,33099,32668,15036,0
6,0,2,2,16.3,30.7,28.5,24.6,3013144,1988282,606132,61007,14693,530432,418730,85530,35229,23247,7087,713,172,6202,4896,1321155,913431,248344,177273,71071,159380,15606,143774,32696,22907,9789,1134,8655,40407,39876,16612,27
6,0,4,5,20,31.3,31,17.7,2782870,1579233,755549,88709,16712,650128,448088,93890,29640,16820,8047,945,178,6924,4772,1565588,1111414,300787,211107,89680,153387,-15432,168819,48572,35921,12651,1426,11225,32232,30941,15040,6
6,0,3,2,14.7,31.9,32.5,20.9,3751729,2211069,852813,106316,17671,728826,687847,102468,36614,21578,8323,1038,172,7113,6713,2470584,1789938,457197,318918,138279,223449,-168,223617,62193,50270,11923,730,11193,39724,35606,19978,3
6,0,6,6,26.4,34,26.6,13,1834522,986962,578484,72983,17672,487829,269076,71353,25711,13832,8107,1023,248,6837,3771,939001,666869,183733,128779,54954,88399,-15578,103977,30835,21928,8907,1942,6965,30452,30412,14928,2
6,0,4,3,19.5,35.1,31.8,13.6,2353593,1299135,734390,97589,17790,619011,320068,81792,28775,15883,8979,1193,218,7568,3913,1458297,1092909,283626,198528,85098,81762,543,81219,34499,28505,5994,495,5499,42271,38341,14770,0
6,0,3,2,16.9,32.5,33.7,16.9,3223417,1755420,986208,104176,20228,861804,481789,104354,30889,16822,9451,998,194,8258,4617,1744713,1230934,315240,216934,98306,198539,-9060,207599,48421,37034,11387,809,10578,36032,33238,19626,2
6,0,3,2,16.8,32.2,33.1,17.9,3754285,2055561,1044401,124359,23119,896923,654323,117785,31874,17452,8867,1056,196,7615,5555,2565286,1859529,536798,390018,146780,168959,1247,167712,60613,49989,10624,568,10056,42322,37199,16678,1
6,0,3,2,10.1,24.5,30.6,34.9,4430367,2781154,805059,108078,24084,672897,844154,144117,30741,19298,5586,750,167,4669,5857,2439006,1762701,501579,365312,136267,174726,2180,172546,69655,53923,15732,290,15442,35016,32689,11174,24
6,0,3,2,17.5,29.9,31.8,20.9,3964314,2393292,926430,96967,25216,804247,644592,120007,33034,19943,7720,808,210,6702,5371,2555407,1890994,486801,339024,147777,177612,-5605,183217,62450,49147,13303,1174,12129,40919,38476,15106,7
6,0,1,1,7.9,20.9,28.9,42.2,8678731,6114695,1107187,83943,30568,992676,1456849,197885,43857,30900,5595,424,154,5016,7362,4714788,3532332,786709,528300,258409,395747,1634,394113,105616,80028,25588,363,25225,44641,44139,15624,29
6,0,2,2,14.3,25.6,27.8,32.3,8582457,4920077,1865836,321246,45979,1498611,1796544,229162,37451,21470,8142,1402,201,6540,7840,7988022,5983709,1605138,1140861,464277,399175,19726,379449,171253,140910,30343,539,29804,46645,42465,12731,1
6,0,2,2,9.2,21.1,29.2,40.6,14750214,9696314,2205470,211383,61862,1932225,2848430,339519,43444,28559,6496,623,182,5691,8390,13374934,10250829,2460348,1677026,783322,663757,9515,654242,233995,193761,40234,946,39288,57159,52905,16652,122
6,0,9,8,15.8,47.7,24.2,12.3,142955,85100,42775,3671,1481,37623,15080,5243,27266,16231,8158,700,282,7176,2876,164106,131608,28853,18668,10185,3645,-818,4463,3305,2887,418,84,334,49654,45586,13362,0
6,0,9,8,18.9,40.7,24.7,15.7,192302,87731,73984,7691,1732,64561,30587,8262,23275,10619,8955,931,210,7814,3702,51046,30598,9435,6985,2450,11013,-5343,16356,2857,1281,1576,602,974,17867,23886,16793,0
6,0,8,7,19.3,41.8,23.9,15,203993,96575,74164,9832,1790,62542,33254,7533,27080,12820,9845,1305,238,8302,4414,64187,44265,11157,7536,3621,8765,-1616,10381,2301,1536,765,242,523,27895,28818,19849,0
6,0,9,10,16.5,43.7,26.8,13.1,201745,85476,85812,7604,1858,76350,30457,8070,24999,10592,10633,942,230,9461,3774,74918,44205,12275,8455,3820,18438,-4426,22864,3607,1854,1753,562,1191,20770,23843,19197,0
6,0,8,7,17.2,42.4,26.6,13.8,245696,135922,79835,6878,2117,70840,29939,8600,28569,15805,9283,800,246,8237,3481,93259,49375,11996,7670,4326,31888,16798,15090,2861,1782,1079,390,689,32597,27708,21901,0
6,0,6,6,22,40.7,27.1,10.2,247189,116503,95737,11241,2120,82376,34949,11235,22002,10370,8521,1001,189,7332,3111,116708,86616,22480,15244,7236,7612,-9540,17152,4753,3237,1516,562,954,24555,26758,17979,0
6,0,8,7,21.2,36.9,29.6,12.3,222969,102188,85679,7215,2210,76254,35102,9397,23728,10875,9118,768,235,8115,3735,77684,47865,12717,8743,3974,17102,1987,15115,3197,1874,1323,417,906,24299,25542,16683,0
6,0,7,9,30,39.3,22.3,8.4,286029,158461,92616,16438,2419,73759,34952,10291,27794,15398,9000,1597,235,7167,3396,161892,72150,18820,12949,5871,70922,50014,20908,3523,2426,1097,205,892,45953,29740,23439,0
6,0,9,9,15.5,39.4,32.9,12.1,295797,128598,123314,9581,2425,111308,43885,12238,24170,10508,10076,783,198,9095,3586,102230,61443,17320,12243,5077,23467,5560,17907,3935,2351,1584,693,891,25980,26135,20098,0
6,0,7,9,14.2,44.7,24,17,252279,125797,95541,10378,2485,82678,30941,9005,28015,13970,10610,1152,276,9181,3436,107968,77750,19036,12266,6770,11182,-1200,12382,3505,2450,1055,334,721,30804,31735,17173,1
6,0,2,2,16.6,40.3,30.1,12.9,315085,179286,96439,8783,2575,85081,39360,10377,30364,17277,9294,846,248,8199,3793,78963,46991,11747,7922,3825,20225,-404,20629,3150,1581,1569,396,1173,25068,29722,17587,1
6,0,6,6,16.9,42.4,26.7,14.1,222544,104034,92101,9045,2619,80437,26409,8047,27656,12928,11445,1124,325,9996,3282,116955,89745,21967,13960,8007,5243,-6,5249,3784,3115,669,83,586,30908,28811,8957,0
6,0,2,2,20.4,45.9,22.2,11.6,384378,214784,116401,11462,2913,102026,53193,15656,24551,13719,7435,732,186,6517,3398,142523,100775,25868,17207,8661,15880,-7534,23414,6365,3509,2856,1172,1684,22392,28719,13904,1
6,0,9,9,23.2,33.6,29.8,13.4,312864,117053,137732,10741,2947,124044,58079,12497,25035,9366,11021,859,236,9926,4647,120640,75751,19784,13557,6227,25105,-1355,26460,4955,2983,1972,504,1468,24347,25394,18025,0
6,0,9,10,16.7,36.3,32,14.9,296654,152338,97561,8599,3142,85820,46755,11232,26412,13563,8686,766,280,7641,4163,118868,72875,18580,12590,5990,27413,4996,22417,4097,2688,1409,329,1080,29013,27111,20756,1
6,0,9,10,17.1,37.9,32.1,12.9,343211,150413,143072,9520,3148,130404,49726,13567,25297,11087,10546,702,232,9612,3665,142138,91096,24977,17483,7494,26065,87,25978,5471,3344,2127,593,1534,25980,27242,16935,0
6,0,6,6,18.7,35,31.1,15.3,368534,204708,119500,13265,3262,102973,44326,13821,26665,14811,8646,960,236,7450,3207,299141,221679,57100,37875,19225,20362,-2119,22481,9390,7774,1616,513,1103,31857,28515,20382,0
6,0,7,9,18.6,42.2,24.8,14.4,331418,165533,126910,13200,3457,110253,38975,11425,29008,14489,11108,1155,303,9650,3411,170491,113122,28632,19004,9628,28737,3226,25511,4762,3684,1078,180,898,35802,30706,28409,0
6,0,7,9,19.8,40.8,26.2,13.2,358711,188161,126794,19137,3482,104175,43756,11693,30677,16092,10844,1637,298,8909,3742,193089,107814,26660,17345,9315,58615,37421,21194,4943,3814,1129,286,843,39063,28268,25141,0
6,0,6,6,19.1,40,29.6,11.3,478122,257537,150532,14296,3787,132449,70053,17993,26573,14313,8366,795,210,7361,3893,225726,169642,45823,32710,13113,10261,-10901,21162,7007,4911,2096,748,1348,32214,34543,15699,0
6,0,9,10,13.8,37.6,32.6,16,407246,168243,168607,13367,3816,151424,70396,16673,24425,10091,10113,802,229,9082,4222,151959,107232,30812,21535,9277,13915,-8152,22067,6046,3901,2145,445,1700,25134,27488,12981,1
6,0,6,6,28.2,34.8,26.3,10.6,405619,233102,127233,15088,3892,108253,45284,17175,23617,13572,7408,878,227,6303,2637,210835,153296,41203,26479,14724,16336,-1570,17906,7028,5517,1511,516,995,29999,27786,17996,0
6,0,2,2,9.9,42.5,28.6,19,570013,365349,135431,10947,3928,120556,69233,17932,31787,20374,7552,610,219,6723,3861,185769,128245,31411,20658,10753,26113,-838,26951,6114,4110,2004,246,1758,30384,31203,15330,0
6,0,7,9,17.2,42.1,30.2,10.5,456299,177503,212795,16120,4064,192611,66001,17269,26423,10279,12322,933,235,11154,3822,153434,104436,26466,17837,8629,22532,-9120,31652,6690,4007,2683,616,2067,22935,26063,15313,0
6,0,6,5,21.1,42.8,22.4,13.7,564181,302954,183447,17666,4275,161506,77780,21924,25733,13818,8367,806,195,7367,3548,260633,185396,48518,32965,15553,26719,-4124,30843,9443,6915,2528,754,1774,27601,26811,17386,0
6,0,7,11,14.8,39.7,33,12.5,495047,227259,191568,17963,4420,169185,76220,20554,24085,11057,9320,874,215,8231,3708,255439,174330,46360,31864,14496,34749,-3869,38618,9823,6471,3352,854,2498,26004,26940,15460,0
6,0,8,6,15.2,45.5,26.4,12.9,465725,208722,177476,13169,4473,159834,79527,17198,27080,12136,10320,766,260,9294,4624,213970,153426,35715,24259,11456,24829,-5199,30028,6356,4232,2124,545,1579,33664,36254,19017,0
6,0,6,6,16,39.7,28.8,15.5,451839,219331,170696,16070,4536,150090,61812,17276,26154,12696,9881,930,263,8688,3578,206704,128021,33866,22915,10951,44817,2516,42301,6815,4570,2245,509,1736,30331,28013,24367,1
6,0,6,4,19.6,43.6,23,13.8,546244,309797,162405,19198,4548,138659,74042,17796,30695,17408,9126,1079,256,7792,4161,264038,172553,42385,27876,14509,49100,3212,45888,8117,5616,2501,292,2209,32529,30725,20773,0
6,0,3,2,14.9,40.4,34.4,10.3,386113,221047,117379,10939,4672,101768,47687,12944,29829,17077,9068,845,361,7862,3684,249663,185448,39895,26168,13727,24320,5475,18845,5538,4157,1381,416,965,45082,44611,19528,0
6,0,7,9,17.5,36.3,31.7,14.5,480048,227102,192576,16863,4921,170792,60370,17970,26714,12638,10717,938,274,9504,3359,215432,138031,37353,25421,11932,40048,-3313,43361,7577,5205,2372,646,1726,28432,26519,25122,1
6,0,6,6,22.6,43.2,25,9.2,507404,276311,169440,17849,4953,146638,61653,17884,28372,15450,9474,998,277,8199,3447,324475,188921,46120,30858,15262,89434,6245,83189,7546,5814,1732,376,1356,43000,32494,61349,0
6,0,6,6,16.2,44.4,27.3,12,614359,316736,219420,20571,5257,193592,78203,22229,27638,14249,9871,925,236,8709,3518,257546,180144,46213,31264,14949,31189,-2085,33274,8535,5973,2562,889,1673,30175,30160,19889,0
6,0,7,9,20.5,43.3,20.5,15.7,616810,345726,198399,22203,5284,170912,72685,25641,24056,13483,7738,866,206,6666,2835,366339,272760,67120,44076,23044,26459,-9600,36059,11597,9292,2305,581,1724,31589,29354,20916,0
6,0,6,6,14.8,43.8,25.6,15.8,675907,384727,201475,19620,5464,176391,89705,21115,32011,18221,9542,929,259,8354,4248,366960,251869,59369,39059,20310,55722,8621,47101,10495,7659,2836,787,2049,34965,32885,22987,1
6,0,6,6,14.3,35.9,30.5,19.3,677966,329805,216582,18573,5602,192407,131579,27448,24700,12016,7891,677,204,7010,4794,372801,288825,71475,46689,24786,12501,-27620,40121,15490,10745,4745,1017,3728,24067,26880,10762,0
6,0,6,6,15.6,39.2,29.3,15.9,804406,402805,251030,16389,5872,228769,150571,25890,31070,15558,9696,633,227,8836,5816,350400,233177,57826,38156,19670,59397,-6857,66254,11879,7591,4288,751,3537,29497,30718,18732,0
6,0,6,6,19.9,39,28,13.1,584916,317237,195597,25965,5902,163730,72082,22490,26008,14106,8697,1155,262,7280,3205,428029,333178,76772,49699,27073,18079,-13287,31366,11357,9214,2143,714,1429,37689,36160,21950,0
6,0,6,6,16.8,38.1,26.6,18.5,586960,334503,175247,18791,6054,150402,77210,18725,31346,17864,9359,1004,323,8032,4123,333785,207545,55214,38190,17024,71026,24991,46035,9268,7210,2058,289,1769,36015,28786,26023,0
6,0,3,2,20.5,43.1,26.7,9.8,692720,367606,247045,31054,6125,209866,78069,24440,28344,15041,10108,1271,251,8587,3194,310202,175679,42268,27759,14509,92255,31309,60946,8388,5784,2604,341,2263,36982,30373,26932,0
6,0,7,8,15.2,40.4,22.9,21.5,778639,423302,233253,27340,6174,199739,122084,24682,31547,17150,9450,1108,250,8092,4946,461329,331424,79668,53920,25748,50237,-549,50786,12022,9506,2516,257,2259,38374,34865,22482,1
6,0,6,3,24.2,31.1,33.4,11.3,611537,313546,227386,45084,6238,176064,70605,21405,28570,14648,10623,2106,291,8225,3299,336541,202045,51258,34603,16655,83238,38128,45110,8951,7093,1858,254,1604,37598,28485,28123,0
6,0,7,8,14.8,42.1,27.8,15.3,803730,452343,253085,30612,7142,215331,98302,25728,31240,17582,9837,1190,278,8370,3821,377227,255322,67256,46716,20540,54649,-279,54928,10442,8303,2139,171,1968,36126,30751,27911,1
6,0,6,3,21.3,39.4,29.8,9.5,690194,363918,235777,44108,7149,184520,90499,27980,24667,13006,8427,1576,256,6595,3234,440532,286481,76718,52536,24182,77333,34753,42580,11864,8957,2907,275,2632,37132,31984,16178,1
6,0,7,11,17,41.5,28.1,13.4,683722,390192,219232,23813,7258,188161,74298,21673,31547,18004,10115,1099,335,8682,3428,459846,333372,75723,48670,27053,50751,13292,37459,10792,8613,2179,355,1824,42610,38706,20537,0
6,0,7,8,11.8,31.7,30.1,26.4,660360,362154,206201,17965,7381,180855,92005,22918,28814,15802,8997,784,322,7891,4015,415544,305649,79642,54257,25385,30253,844,29409,12594,10240,2354,356,1998,32995,29849,14719,2
6,0,6,6,17.4,39,29.5,14.1,687680,425678,170342,18585,7846,143911,91660,18869,36445,22560,9028,985,416,7627,4858,552432,371250,86239,54200,32039,94943,20964,73979,13212,10722,2490,397,2093,41813,34625,35346,0
6,0,7,8,14.8,32.4,36.6,16.2,1080434,579267,332356,27647,7979,296730,168811,37063,29151,15629,8967,746,215,8006,4555,688337,507081,124537,83955,40582,56719,-13381,70100,20685,15196,5489,1186,4303,33277,33369,16291,0
6,0,6,5,14.4,41.4,30.4,13.8,863266,464645,285352,26690,8110,250552,113269,33129,26058,14025,8613,806,245,7563,3419,411814,292857,72585,47583,25002,46372,-3977,50349,12127,9153,2974,519,2455,33958,31996,20509,0
6,0,7,8,12.7,35.2,33.7,18.4,1236675,526667,472835,26000,9232,437603,237173,41341,29914,12740,11437,629,223,10585,5737,652853,477880,116828,76957,39871,58145,-4234,62379,20737,15130,5607,523,5084,31483,31585,12270,1
6,0,7,8,14.9,37.6,29.5,18,1103566,620455,335127,29323,9460,296344,147984,36846,29951,16839,9095,796,257,8043,4016,771179,535285,131924,87311,44613,103970,5020,98950,20599,16180,4419,941,3478,37438,33083,28450,0
6,0,3,2,14.9,36.8,32.5,15.8,1293889,781371,340035,45879,9600,284556,172483,43751,29574,17860,7772,1049,219,6504,3942,724137,506119,114234,72935,41299,103784,3078,100706,18603,14536,4067,491,3576,38926,34818,28162,0
6,0,7,8,16.1,36.3,27.5,20.1,1675911,980114,397619,45100,10885,341634,298178,41387,40494,23682,9607,1090,263,8255,7205,1226585,787687,180073,120575,59498,258825,-929,259754,23943,18457,5486,271,5215,51229,42677,49809,2
6,0,4,5,13.4,42.5,28,16.1,1220516,694969,362518,37604,12471,312443,163029,42751,28549,16256,8480,880,292,7308,3813,734083,511891,129203,82905,46298,92989,10233,82756,19250,15474,3776,661,3115,38134,33081,26567,0
6,0,2,2,11.5,34.3,34.1,20.1,2297088,1490950,494749,46341,14211,434197,311389,69458,33072,21465,7123,667,205,6251,4483,633041,424317,97210,62603,34607,111514,5742,105772,21294,14215,7079,671,6408,29729,29850,16506,1
6,0,5,8,16,34.1,27.7,22.2,1836607,1120769,481012,44712,14595,421705,234826,62654,29313,17888,7677,714,233,6731,3748,1338769,993862,238722,157791,80931,106185,905,105280,35755,29013,6742,913,5829,37443,34256,18061,1
6,0,4,3,17.7,39.2,31,12.2,1430818,864972,415693,68035,15518,332140,150153,46011,31097,18799,9035,1479,337,7219,3263,1193221,805746,184249,118571,65678,203226,62724,140502,24091,20771,3320,281,3039,49530,38792,46233,1
6,0,2,2,14.1,39.2,32.1,14.5,1733144,1047023,486464,49191,15524,421749,199657,61799,28045,16942,7872,796,251,6825,3231,931804,680822,157738,98452,59286,93244,4169,89075,26874,20756,6118,839,5279,34673,32801,16873,1
6,0,1,1,18.6,35.7,28.8,16.9,1551867,957439,432594,82244,17123,333227,161834,50504,30728,18958,8566,1628,339,6598,3204,853942,556737,134006,86680,47326,163199,27610,135589,22727,17212,5515,217,5298,37574,32346,25592,1
6,0,4,5,15.4,38.4,25.4,20.8,2370404,1424306,617333,54528,19302,543503,328765,78005,30388,18259,7914,699,247,6968,4215,1347343,971163,212270,133682,78588,163910,-2121,166031,37650,27921,9729,1758,7971,35786,34783,20829,1
6,0,2,2,9.9,32.1,32.5,25.5,3830450,2514655,851827,57951,21887,771989,463968,109509,34978,22963,7779,529,200,7050,4237,1128613,731441,165848,106034,59814,231324,-1679,233003,33897,22868,11029,343,10686,33295,31985,21805,5
6,0,3,2,11.8,30.9,37.2,20.1,3193104,1605298,975935,79246,22389,874300,611871,96834,32975,16578,10078,818,231,9029,6319,1746805,1219282,275623,174344,101279,251900,-249,252149,51177,38472,12705,332,12373,34133,31693,20379,9
6,0,3,2,11.7,33.2,28.5,26.5,3172702,2001606,768346,85233,23090,660023,402750,98310,32272,20360,7816,867,235,6714,4097,2396289,1637943,378852,243221,135631,379494,76613,302881,59522,47687,11835,533,11302,40259,34348,26799,8
6,0,3,2,14.7,38.2,30.3,16.8,2299114,1310055,690411,103369,23667,563375,298648,76008,30248,17236,9083,1360,311,7412,3929,1777012,1307037,335354,227220,108134,134621,36370,98251,40701,34442,6259,370,5889,43660,37949,16684,2
6,0,2,2,8.8,30.5,31,29.7,3726596,2491533,777039,67095,25738,684206,458024,116223,32064,21438,6686,577,221,5887,3941,2227420,1662214,355255,224834,130421,209951,-5903,215854,57234,44574,12660,1208,11452,38918,37291,18849,15
6,0,2,2,17.4,31.8,31.7,19,4497422,2775793,987302,101663,34520,851119,734327,126926,35433,21869,7779,801,272,6706,5785,3845318,2699345,611993,392837,219156,533980,-5031,539011,83834,69818,14016,739,13277,45868,38663,40597,7
6,0,2,2,15.8,26.6,25.7,31.9,6227011,4024878,1179996,131875,39548,1008573,1022137,207734,29976,19375,5680,635,190,4855,4920,5017940,3906079,865940,562388,303552,245921,-20019,265940,124522,98097,26425,2350,24075,40298,39819,11046,26
6,0,2,2,12.5,29.7,26.1,31.7,12840046,5592997,1345081,115098,43646,1186337,5901968,228827,56112,24442,5878,503,191,5184,25792,6126091,4893582,942483,564928,377555,290026,-32275,322301,125953,101162,24791,1924,22867,48638,48374,14095,14
6,0,2,2,9.6,26.5,30.2,33.7,16354455,10100424,3121921,360936,88490,2672495,3132110,386679,42295,26121,8074,933,229,6911,8100,15716438,12053072,2745106,1787295,957811,918260,687,917573,313321,267571,45750,380,45370,50161,45046,20224,26
6,0,7,9,10.3,37,40.5,12.1,267108,166978,76503,5063,1613,69827,23627,8569,31171,19486,8928,591,188,8149,2757,287652,226832,46616,31009,15607,14204,3172,11032,4209,3713,496,132,364,68342,61091,30308,2
6,0,6,4,22.8,37,29,11.2,569046,265056,202134,18054,3529,180551,101856,20582,27648,12878,9821,877,171,8772,4949,303223,174459,50723,37114,13609,78041,43377,34664,7170,5639,1531,110,1421,42291,30938,24394,0
6,0,7,8,14.2,31.3,40.4,14.1,944343,488724,336790,31435,6986,298369,118829,37124,25438,13165,9072,847,188,8037,3201,462202,325673,92743,67674,25069,43786,14171,29615,11442,8997,2445,363,2082,40395,36198,14224,2
6,0,4,3,15,27.5,38.5,19,1681639,680982,669492,53861,11125,604506,331165,53422,31478,12747,12532,1008,208,11316,6199,784685,568968,150748,108563,42185,64969,-1665,66634,20513,14553,5960,189,5771,38253,39096,11546,5
6,0,4,5,24.6,26.4,26.8,22.1,1458758,868635,337713,57307,14401,266005,252410,47615,30637,18243,7093,1204,302,5587,5301,948516,546805,156165,112986,43179,245546,-1014,246560,19501,13477,6024,196,5828,48639,40573,42306,1
6,0,6,6,21.4,33,34.2,11.5,1985382,915507,801462,114276,19752,667434,268413,72179,27506,12684,11104,1583,274,9247,3719,1063928,778540,253723,193282,60441,31665,-12418,44083,28943,19631,9312,5405,3907,36759,39659,11283,0
6,0,3,2,12.9,23,40.5,23.6,4681207,2526291,1283918,109930,25803,1148185,870998,132952,35210,19002,9657,827,194,8636,6551,2903451,2022610,636428,469004,167424,244413,11046,233367,56143,44526,11617,958,10659,51715,45425,21894,8
6,0,4,5,17.4,30,37.1,15.5,2762660,1234241,1101642,153806,29854,917982,426777,107518,25695,11479,10246,1431,278,8538,3969,1436518,1024391,298462,212449,86013,113665,1865,111800,39758,27409,12349,3704,8645,36132,37374,12932,3
6,0,3,2,10.3,21.3,32.9,35.4,4971530,3086057,941884,105845,31476,804563,943589,134181,37051,22999,7020,789,235,5996,7032,3324184,2266382,646118,475716,170402,411684,5181,406503,76961,60653,16308,2114,14194,43193,37366,28639,58
6,0,3,2,9.8,25.9,39.3,25,6312934,2675069,2007867,129678,41636,1836553,1629998,210883,29936,12685,9521,615,197,8709,7729,2783218,1946374,496022,347877,148145,340822,-685,341507,87057,56126,30931,798,30133,31970,34679,11333,13
6,0,3,2,15.3,35.6,36.8,12.3,5162489,2501897,1811230,165226,43669,1602335,849362,202733,25464,12341,8934,815,215,7904,4190,2289407,1604069,411864,287367,124497,273474,9395,264079,64077,46718,17359,292,17067,35729,34335,15473,8
6,0,1,1,14.8,29.9,36.8,18.6,9301945,5570363,2551784,238996,66519,2246269,1179798,378226,24594,14728,6747,632,176,5939,3119,3339212,2231408,617106,449116,167990,490698,127897,362801,83256,56484,26772,751,26021,40108,39505,13943,31
6,0,3,2,28.4,26,31.3,14.3,5665534,3478684,1377793,206441,110877,1060475,809057,202581,27967,17172,6801,1019,547,5235,3994,3822507,2410492,709074,505954,203120,702941,344632,358309,80988,67269,13719,434,13285,47198,35834,26971,6
6,0,2,2,11.8,22.5,34.1,31.6,34767954,19558964,8052184,775798,181955,7094431,7156806,987297,35215,19811,8156,786,184,7186,7249,21848666,15579226,4000256,2820800,1179456,2269184,34695,2234489,477616,370998,106618,696,105922,45745,41993,21096,601
6,0,1,1,12.9,22.8,32.9,31.4,145320626,93543930,26270516,2727414,735861,22807241,25506180,3869626,37554,24174,6789,705,190,5894,6591,106694363,81790683,17593790,11638505,5955285,7309890,139020,7170870,2181411,1703052,478359,2042,476317,48911,48026,15055,1334
6,0,8,4,10.2,34.2,30,25.6,62358,35891,11426,1202,474,9750,15041,1093,57052,32837,10454,1100,434,8920,13761,56101,40025,9927,7453,2474,6149,0,6149,1046,880,166,0,166,53634,45483,37042,1
6,0,8,7,7.1,25.4,46.1,21.4,105412,52814,27370,2390,1736,23244,25228,3100,34004,17037,8829,771,560,7498,8138,40230,21787,10187,8783,1404,8256,915,7341,1137,653,484,37,447,35383,33364,16423,8
6,0,6,6,14.5,30.5,38.5,16.6,355815,182962,104955,10894,3795,90266,67898,9515,37395,19229,11030,1145,399,9487,7136,197087,89003,37080,30689,6391,71004,42911,28093,3982,2638,1344,363,981,49494,33739,28637,0
6,0,8,6,10.2,31.9,38.4,19.5,392355,153143,146841,13940,6331,126570,92371,13677,28687,11197,10736,1019,463,9254,6754,172053,92036,39263,33003,6260,40754,-1023,41777,4521,2669,1852,203,1649,38056,34483,25335,0
6,0,7,11,15.3,18.9,34.3,31.5,600220,387133,59733,5535,6850,47348,153354,14329,41888,27017,4169,386,478,3304,10702,466821,275845,83580,62591,20989,107396,17176,90220,9838,7578,2260,64,2196,47451,36401,41084,1
6,0,7,11,11.4,30.3,33,25.3,813683,487760,169195,12582,7676,148937,156728,18401,44219,26507,9195,684,417,8094,8517,562479,300191,112747,92977,19770,149541,11183,138358,10338,7772,2566,85,2481,54409,38625,55767,0
6,0,8,7,9.9,28.2,37.5,24.4,676485,369238,172481,12248,8446,151787,134766,18174,37223,20317,9491,674,465,8352,7415,310905,183447,66511,53003,13508,60947,875,60072,7810,5476,2334,311,2023,39809,33500,29695,7
6,0,7,8,18.4,32.1,35.1,14.4,815844,409076,269471,41949,10320,217202,137297,28447,28679,14380,9473,1475,363,7635,4826,492620,297914,121551,102557,18994,73155,10945,62210,10474,8257,2217,96,2121,47033,36080,29331,2
6,0,7,12,6.4,25.5,45.5,22.6,782535,377736,213483,14782,11625,187076,191316,19716,39690,19159,10828,750,590,9489,9704,424338,241620,91560,73283,18277,91158,1024,90134,9501,6181,3320,108,3212,44662,39091,28062,3
6,0,7,8,17.7,32.4,37.5,12.4,996349,592587,227015,25995,12064,188956,176747,34244,29096,17305,6629,759,352,5518,5161,725475,450466,196145,166335,29810,78864,23867,54997,13027,10622,2405,385,2020,55690,42409,27226,0
6,0,6,6,27.5,27.3,32.2,13,985905,590768,229022,29576,14167,185279,166115,28160,35011,20979,8133,1050,503,6580,5899,607930,287454,97626,75376,22250,222850,141069,81781,11550,8034,3516,1108,2408,52635,35780,33962,1
6,0,6,4,30.6,23.2,30.5,15.7,882325,604551,146935,17690,16777,112468,130839,21366,41296,28295,6877,828,785,5264,6124,689471,310969,97775,73738,24037,280727,191950,88777,11096,8661,2435,661,1774,62137,35905,50043,0
6,0,6,4,10.3,27.1,40.6,22.1,1333900,727607,322749,18957,19158,284634,283544,37539,35534,19383,8598,505,510,7582,7553,786937,476733,172023,141460,30563,138181,5503,132678,17471,12107,5364,392,4972,45042,39377,26685,5
6,0,6,6,10.7,25.1,41.5,22.7,1530440,716770,484335,51661,24459,408215,329335,44614,34304,16066,10856,1158,548,9150,7382,821826,465121,167973,132122,35851,188732,50822,137910,19896,13302,6594,766,5828,41306,34966,23663,2
6,0,6,6,10,27.6,43.1,19.3,1724819,879752,426222,31804,25207,369211,418845,45163,38191,19479,9437,704,558,8175,9274,571937,285360,100884,80845,20039,185693,2098,183595,14752,7996,6756,573,6183,38770,35688,29694,5
6,0,4,5,16,32.4,37.3,14.4,1931208,998511,576425,73940,27064,475421,356272,63347,30486,15763,9099,1167,427,7505,5624,937407,570428,184401,141139,43262,182578,38130,144448,22020,15880,6140,1536,4604,42571,35921,31374,2
6,0,4,5,9.3,29.2,41,20.6,2001138,1019698,537333,39045,27259,471029,444107,54832,36496,18597,9800,712,497,8590,8099,1105106,677810,228316,181988,46328,198980,-1737,200717,24553,17233,7320,345,6975,45009,39332,28777,5
6,0,1,1,20.9,24.7,35.2,19.2,2099954,1427584,337102,39523,34738,262841,335268,56034,37476,25477,6016,705,620,4691,5983,963863,570631,178509,135603,42906,214723,34380,180343,20458,14301,6157,535,5622,47114,39901,32078,35
6,0,4,5,13.1,26.2,35.9,24.8,3402522,1830017,837893,97342,35297,705254,734612,87367,38945,20946,9590,1114,404,8072,8408,2032096,1071713,344495,266551,77944,615888,1703,614185,44771,29860,14911,1014,13897,45389,35891,44196,8
6,0,4,5,15.3,30.3,39.1,15.3,2059705,1012849,687794,80610,36110,571074,359062,64273,32046,15759,10701,1254,562,8885,5587,893520,524501,177386,140079,37307,191633,9147,182486,22504,14826,7678,736,6942,39705,35377,26287,7
6,0,3,2,17.9,24.6,41.2,16.4,2369092,1332006,708068,104553,41179,562336,329018,72511,32672,18370,9765,1442,568,7755,4537,1472846,925324,362405,290550,71855,185117,55399,129718,25851,20046,5805,690,5115,56974,46160,25360,1
6,0,4,3,6.5,18.5,39.2,35.8,4724836,2810607,848176,50628,45372,752176,1066053,98714,47864,28472,8592,513,460,7620,10799,2319585,1213932,352652,262893,89759,753001,-384,753385,50003,29708,20295,651,19644,46389,40862,38352,35
6,0,5,8,9.5,24,37.1,29.4,5032852,2934068,1149540,136618,48672,964250,949244,135239,37215,21695,8500,1010,360,7130,7019,3191843,1714190,580728,457741,122987,896925,81330,815595,67088,47874,19214,788,18426,47577,35806,44263,3
6,0,3,2,21.3,24.9,36.2,17.5,3414129,2172729,721336,90903,59287,571146,520064,94560,36105,22977,7628,961,627,6040,5500,1773673,996695,291781,215958,75823,485197,158642,326555,36712,26857,9855,1102,8753,48313,37111,37308,2
6,0,3,2,15.3,18.1,32.1,34.6,6732921,4061149,1006158,67414,61554,877190,1665614,137905,48823,29449,7296,489,446,6361,12078,4757876,3195530,897895,663910,233985,664451,-25006,689457,89319,67418,21901,1235,20666,53268,47399,33362,32
6,0,3,2,27.1,25.5,34.3,13,4516225,2922311,910975,152928,63646,694401,682939,152030,29706,19222,5992,1006,419,4568,4492,3441315,2023808,752287,596485,155802,665220,450879,214341,56158,48328,7830,891,6939,61279,41877,30889,2
6,0,3,2,28.4,24.8,33,13.8,4550509,2859617,1030092,167397,69803,792892,660800,151876,29962,18829,6782,1102,460,5221,4351,2995895,1665474,541163,420372,120791,789258,369071,420187,57253,44096,13157,1270,11887,52327,37769,35348,5
6,0,1,1,13.9,18.9,26.7,40.6,8773060,5885748,1255447,143130,87030,1025287,1631865,202082,43413,29126,6213,708,431,5074,8075,7337343,4731669,1596113,1283468,312645,1009561,140367,869194,118162,97364,20798,792,20006,62096,48598,43447,100
6,0,1,1,6.8,11.2,24.5,57.5,23241383,14014756,1770129,87897,90457,1591775,7456498,255505,90963,54851,6928,344,354,6230,29183,11247891,6460323,1464921,1018322,446599,3322647,15560,3307087,178735,110231,68504,242,68262,62931,58607,48447,204
6,0,1,1,7.1,21.5,38.1,33.3,9130100,6176631,1317483,84265,91405,1141813,1635986,180975,50450,34130,7280,466,505,6309,9040,3445371,2091063,592832,441569,151263,761476,-6172,767648,78508,50146,28362,1160,27202,43886,41699,28220,103
6,0,2,2,9.5,19.8,36.7,34,11577475,6994261,1809976,140279,98885,1570812,2773238,271150,42698,25795,6675,517,365,5793,10228,7130784,4374091,1351432,1038214,313218,1405261,106022,1299239,151009,106645,44364,2147,42217,47221,41015,30775,64
6,0,3,2,11.2,22.6,39.5,26.6,7574070,4196578,2010585,240711,99005,1670869,1366907,220003,34427,19075,9139,1094,450,7595,6213,4488773,2705380,845737,648059,197678,937656,156243,781413,97756,72900,24856,1735,23121,45918,37111,33797,12
6,0,3,2,9.3,25.7,43.6,21.4,6317057,3276262,1908795,196698,105771,1606326,1132000,177595,35570,18448,10748,1108,596,9045,6374,3716571,2392573,738393,559477,178916,585605,19278,566327,84116,61641,22475,1355,21120,44184,38815,26815,8
6,0,2,2,31.1,25.1,30,13.8,7924519,4896525,1994621,343358,140047,1511216,1033373,259607,30525,18861,7683,1323,539,5821,3981,4746922,2524495,858761,672011,186750,1363666,751378,612288,88469,69507,18962,2099,16863,53656,36320,36310,4
6,0,2,2,19.6,17.4,29.8,33.3,20811129,12101609,2666522,268934,142708,2254880,6042998,426058,48846,28404,6259,631,335,5292,14184,14073185,8892171,2431855,1784282,647573,2749159,240285,2508874,250715,191208,59507,1156,58351,56132,46505,42996,274
6,0,2,2,13.6,15.5,31.1,39.8,13302889,8885558,1705052,164346,143651,1397055,2712279,265103,50180,33517,6432,620,542,5270,10231,7754728,4234339,1174449,871366,303083,2345940,164756,2181184,138208,95796,42412,516,41896,56109,44202,52062,530
6,0,3,2,31.6,23.5,30.6,14.3,5584740,3544034,1376640,262923,167005,946712,664066,176157,31703,20119,7815,1493,948,5374,3770,4006344,2157062,790899,635071,155828,1058383,585594,472789,73804,60126,13678,289,13389,54284,35876,35312,0
6,0,1,1,5.5,19.1,37.9,37.5,17691589,11989234,2483462,149444,176384,2157634,3218893,356445,49633,33636,6967,419,495,6053,9031,9317676,6488829,1615092,1129330,485762,1213755,6743,1207012,189950,134182,55768,1224,54544,49053,48358,22129,125
6,0,2,2,28.8,20.7,26.6,23.9,17837598,11171296,2701227,343745,212622,2144860,3965075,421162,42353,26525,6414,816,505,5093,9415,12305350,7602239,2262637,1671326,591311,2440474,610038,1830436,221085,176924,44161,895,43266,55659,42969,42307,73
6,0,2,2,31.4,25.8,29,13.8,14432008,9070000,3413120,658520,227972,2526628,1948888,447358,32261,20275,7630,1472,510,5648,4356,9150604,5097139,1695745,1310769,384976,2357720,980458,1377262,184762,148617,36145,4074,32071,49526,34297,42944,7
6,0,2,2,12.3,19.1,34.7,33.8,21972758,13641998,3424943,251809,230209,2942925,4905817,487822,45043,27965,7021,516,472,6033,10057,13764793,8657705,2303817,1665396,638421,2803271,11778,2791493,263452,185360,78092,2880,75212,52248,46708,37115,198
6,0,2,2,12.4,23.3,38.7,25.6,16252685,10692008,2940658,316955,237662,2386041,2620019,416652,39008,25662,7058,761,570,5727,6288,9590702,6551884,1917218,1431868,485350,1121600,69607,1051993,169810,131801,38009,713,37296,56479,49710,28207,50
6,0,1,1,11.1,15.5,24.9,48.5,58228290,38560310,4196287,272366,279547,3644374,15471693,729022,79872,52893,5756,374,383,4999,21223,38253976,26752650,5259576,3558625,1700951,6241750,19002,6222748,459071,345074,113997,243,113754,83329,77527,54704,2695
6,0,2,2,22.2,28.2,32.8,16.7,17297182,10955522,3885367,572407,309255,3003705,2456293,518034,33390,21148,7500,1105,597,5798,4742,10802747,6843941,1972298,1460710,511588,1986508,487359,1499149,212134,165523,46611,3494,43117,50924,41347,34769,43
6,0,1,1,12.1,12.3,19.8,55.8,66662295,45496389,6180020,695719,375887,5108414,14985886,816294,81665,55735,7571,852,460,6258,18358,69608570,48147337,9885933,6979689,2906244,11575300,0,11575300,731875,579964,151911,0,151911,95110,83018,76198,581
6,0,2,2,26.2,27.7,30.3,15.8,27746031,18515166,5519047,1015568,375940,4127539,3711818,848767,32690,21814,6502,1197,443,4863,4373,20581507,12903225,3846272,2890457,955815,3832010,814275,3017735,361933,292053,69880,1540,68340,56866,44181,44158,70
6,0,2,2,16,18.9,32.5,32.6,39908241,27233397,5269832,516769,383815,4369248,7405012,830990,48025,32772,6342,622,462,5258,8911,24804074,16196364,4201037,3021454,1179583,4406673,384724,4021949,430069,316760,113309,1694,111615,57675,51131,36034,535
6,0,2,2,21.6,27.4,33,18.1,23243047,14350062,5569152,789091,429037,4351024,3323833,695071,33440,20645,8012,1135,617,6260,4782,13904673,8853317,2592602,1923036,669566,2458754,343769,2114985,269966,209380,60586,2953,57633,51505,42283,36697,62
6,0,1,1,10.9,17.9,30.5,40.7,61498902,41497224,7395182,634562,513141,6247479,12606496,1066182,57681,38921,6936,595,481,5860,11824,30529572,20478421,5145479,3733087,1412392,4905672,34118,4871554,479634,333627,146007,517,145490,63652,61381,33484,745
6,0,2,2,25.3,22.8,31.7,20.1,31409742,19303498,7444520,1350530,514395,5579595,4661724,940360,33402,20528,7917,1436,547,5933,4957,21494292,13383819,4090318,3092095,998223,4020155,1321076,2699079,426268,341121,85147,4739,80408,50424,39235,33567,56
6,0,1,1,13,22.5,34.6,29.9,57945529,36773286,11475418,1570772,757178,9147468,9696825,1434506,40394,25635,8000,1095,528,6377,6760,46667589,32807248,10065079,7931682,2133397,3795262,63254,3732008,752768,597063,155705,1153,154552,61995,54948,24147,143
6,0,1,1,12.5,17.9,24.9,44.7,78521460,54267123,10992190,1224965,772283,8994942,13262147,1532215,51247,35417,7174,799,504,5871,8656,59933242,42548714,10181045,7217745,2963300,7203483,25512,7177971,865987,666928,199059,371,198688,69208,63798,36127,2243
6,0,1,1,12.4,14.8,22.7,50,120375606,86381137,10907335,1032574,818307,9056454,23087134,1813812,66366,47624,6013,569,451,4993,12729,111744786,87283134,14727090,9791131,4935959,9734562,69231,9665331,1139445,910649,228796,837,227959,98069,95847,42399,10221
6,0,1,1,20.8,26.2,33.2,19.8,64038851,41169591,13770701,2343509,969301,10457891,9098559,2062381,31051,19962,6677,1136,470,5071,4412,40636001,27679658,8275957,6171693,2104264,4680386,197657,4482729,850962,645503,205459,1087,204372,47753,42881,21934,157
6,0,1,1,18.9,26.4,33.2,21.5,71949357,46335582,14311576,1877909,1102332,11331335,11302199,2235890,32179,20724,6401,840,493,5068,5055,37663485,23801162,7134114,5396623,1737491,6728209,282672,6445537,827299,588187,239112,2498,236614,45526,40465,27241,219
6,0,1,1,15.3,17.3,28.3,39.1,157160243,105681049,18534686,1873452,1282986,15378248,32944508,3053465,51469,34610,6070,614,420,5036,10789,116707232,80838367,18692869,12856174,5836695,17175996,49023,17126973,1919034,1453982,465052,227,464825,60816,55598,36846,2310
6,0,1,1,13.3,18.6,30.7,37.4,146013646,93688276,21300917,2152281,1470875,17677761,31024453,3139767,46505,29839,6784,685,468,5630,9881,106297632,76617957,20562748,14837984,5724764,9116927,293841,8823086,1828222,1415138,413084,4947,408137,58143,54142,21618,3293
6,0,1,1,21.8,20.7,26.2,31.2,459098093,294132085,76610829,11201059,4239743,61170027,88355179,9885998,46439,29752,7749,1133,429,6188,8937,344312307,228444609,55609370,39709806,15899564,60258328,39648,60218680,5479684,4059098,1420586,1093,1419493,62834,56280,42423,2844
6,0,0,0,17.5,20.6,29.3,32.6,1738413111,1132825129,268503844,34168653,17563901,216771290,337084138,37672654,46145,30070,7127,907,466,5754,8948,1248829957,847508892,210178538,151640003,58538535,191142527,9947965,181194562,19986021,15091751,4894270,64615,4829655,62485,56157,37517,0
6,0,9,12,3.6,18.5,38.7,39.3,33286,14667,6140,239,175,5726,12479,711,46816,20629,8636,336,246,8053,17551,19997,14676,2903,1745,1158,2418,677,1741,815,505,310,13,297,24536,29061,5862,0
6,0,9,12,4.6,40.9,33.5,21,72314,45114,12665,824,330,11511,14535,1431,50534,31526,8850,576,231,8044,10157,47530,25536,5927,4269,1658,16067,8108,7959,1231,651,580,346,234,38611,39226,34013,0
6,0,9,12,9.7,32.8,35.7,21.9,108280,76669,12538,923,365,11250,19073,1853,58435,41376,6766,498,197,6071,10293,84920,31429,7736,5597,2139,45755,34444,11311,1579,872,707,332,375,53781,36042,30163,0
6,0,9,10,14.9,34.5,34,16.5,53861,30335,9783,914,433,8436,13743,1358,39662,22338,7204,673,319,6212,10120,30487,18017,5235,3820,1415,7235,4767,2468,1005,608,397,77,320,30335,29633,7712,0
6,0,9,10,3.5,37.4,29.3,29.8,27421,17108,3494,344,457,2693,6819,690,39741,24794,5064,499,662,3903,9883,16846,7150,1776,1204,572,7920,0,7920,525,293,232,0,232,32088,24403,34138,0
6,0,9,10,9.2,30,40,20.8,111612,70959,21767,1352,681,19734,18886,2366,47173,29991,9200,571,288,8341,7982,68221,24963,6606,4918,1688,36652,29854,6798,1423,861,562,193,369,47942,28993,18423,0
6,0,9,12,14.5,26.6,37.4,21.4,165056,96748,38336,2884,824,34628,29972,3778,43689,25608,10147,763,218,9166,7933,99527,38112,11067,8623,2444,50348,37021,13327,2676,1406,1270,672,598,37192,27107,22286,0
6,0,9,10,10.7,31.5,36.2,21.6,191919,120425,37349,2260,957,34132,34145,4374,43877,27532,8539,517,219,7803,7806,131924,55373,14315,10430,3885,62236,42629,19607,2708,1677,1031,273,758,48716,33019,25867,0
6,0,8,7,6.3,20,40.4,33.3,144419,60423,34103,2114,1013,30976,49893,4228,34158,14291,8066,500,240,7326,11801,51595,28551,7043,4857,2186,16001,-311,16312,2180,920,1260,182,1078,23667,31034,15132,1
6,0,8,7,15.1,43.7,33,8.1,95253,44586,33810,5150,1345,27315,16857,5859,16258,7610,5771,879,230,4662,2877,58406,44178,10515,7671,2844,3713,-702,4415,1743,1235,508,220,288,33509,35772,15330,0
6,0,9,12,22.2,25.2,31.8,20.9,99934,47009,35232,5448,1444,28340,17693,3636,27485,12929,9690,1498,397,7794,4866,40853,21686,5837,4326,1511,13330,6501,6829,1406,773,633,242,391,29056,28054,17465,0
6,0,9,10,2,17.4,31.2,49.4,181577,91056,28074,1646,1554,24874,62447,4413,41146,20634,6362,373,352,5637,14151,79205,45147,10245,6922,3323,23813,-1276,25089,3011,1452,1559,92,1467,26305,31093,17102,0
6,0,7,12,15.1,46.2,28.5,10.3,145942,73981,42050,5998,1736,34316,29911,6328,23063,11691,6645,948,274,5423,4727,78816,46033,12108,9031,3077,20675,13507,7168,2054,1449,605,257,348,38372,31769,20598,0
6,0,1,1,2,22.6,38.8,36.6,193425,130329,24753,2081,1867,20805,38343,5418,35700,24055,4569,384,345,3840,7077,264902,225636,33886,16475,17411,5380,0,5380,6372,5526,846,0,846,41573,40832,6359,0
6,0,9,10,7.8,32.6,38.6,20.9,278581,193111,40959,2301,1928,36730,44511,6771,41143,28520,6049,340,285,5425,6574,233593,175165,38067,25748,12319,20361,4365,15996,4733,3400,1333,277,1056,49354,51519,15148,1
6,0,7,11,14.6,32.3,32,21,453956,301011,72053,6168,2100,63785,80892,10098,44955,29809,7135,611,208,6317,8011,331855,150422,34371,22959,11412,147062,92412,54650,6844,4371,2473,754,1719,48488,34414,31792,0
6,0,6,6,9.5,26.6,40.3,23.6,209088,81973,76538,8980,2893,64665,50577,6519,32074,12574,11741,1378,444,9919,7758,76919,54696,14976,10919,4057,7247,-1499,8746,3305,1935,1370,352,1018,23274,28267,8591,0
6,0,9,12,15,30.4,35.4,19.2,220842,122112,66043,10838,2960,52245,32687,8279,26675,14750,7977,1309,358,6311,3948,86824,42621,11564,8456,3108,32639,13135,19504,3039,1479,1560,552,1008,28570,28817,19349,0
6,0,9,12,6.4,13.9,25.5,54.1,379029,200134,23794,1917,3053,18824,155101,7469,50747,26795,3186,257,409,2520,20766,249268,171056,34118,20507,13611,44094,772,43322,7737,4740,2997,125,2872,32218,36088,15084,2
6,0,7,11,18.7,25.8,39.5,16,423688,241552,100709,14512,3323,82874,81427,12516,33852,19299,8046,1159,266,6621,6506,262813,157915,39475,27815,11660,65423,32756,32667,7193,5033,2160,517,1643,36537,31376,19883,0
6,0,1,1,2.1,20.5,30.9,46.4,418391,276901,50087,3225,3325,43537,91403,9002,46478,30760,5564,358,369,4836,10154,218839,158693,30808,19469,11339,29338,0,29338,4326,3318,1008,0,1008,50587,47828,29105,1
6,0,6,4,13.2,33.4,22.2,31.2,201945,121880,38370,4636,3371,30363,41695,7335,27532,16616,5231,632,460,4139,5684,97058,64781,16773,12231,4542,15504,0,15504,3025,2090,935,0,935,32085,30996,16582,0
6,0,7,10,9.5,23.3,30.2,37,385337,189266,89595,6567,4510,78518,106476,12014,32074,15754,7458,547,375,6536,8863,198346,112107,25529,17082,8447,60710,-210,60920,7240,3559,3681,320,3361,27396,31500,18126,0
6,0,7,11,4.3,17.3,24.6,53.7,541770,297455,66182,4489,4722,56971,178133,15444,35080,19260,4285,291,306,3689,11534,403724,293685,65300,44124,21176,44739,-1697,46436,12091,8284,3807,196,3611,33390,35452,12860,0
6,0,7,11,16.7,28.2,31.4,23.7,410392,220693,111432,15996,4915,90521,78267,11905,34472,18538,9360,1344,413,7604,6574,226998,136113,35260,23842,11418,55625,24626,30999,6680,4374,2306,332,1974,33982,31119,15704,2
6,0,7,11,8.4,26.9,32.3,32.4,584992,271828,138947,8362,4941,125644,174217,18019,32465,15086,7711,464,274,6973,9669,308041,214652,51241,35756,15485,42148,-121,42269,10664,6895,3769,198,3571,28886,31132,11837,1
6,0,1,1,3.6,29.2,38.7,28.5,555850,342537,90604,5967,5533,79104,122709,16043,34648,21351,5648,372,345,4931,7649,132065,75583,18718,13525,5193,37764,-2019,39783,5344,2376,2968,186,2782,24713,31811,14300,0
6,0,7,10,4.6,27.5,29.6,38.4,476263,271778,67258,4352,5568,57338,137227,14544,32746,18687,4624,299,383,3942,9435,288834,212110,46321,29927,16394,30403,5441,24962,10250,6799,3451,164,3287,28179,31197,7594,1
6,0,7,8,9.9,40.1,32.9,17.2,477258,324338,83129,7893,5675,69561,69791,13412,35584,24183,6198,589,423,5186,5204,330833,236728,57354,40112,17242,36751,9073,27678,7453,5351,2102,439,1663,44389,44240,16643,0
6,0,7,11,16.9,25.2,31.7,26.2,482209,275921,120914,19615,5772,95527,85374,16117,29919,17120,7502,1217,358,5927,5297,382630,273645,69081,48813,20268,39904,17025,22879,10469,8307,2162,279,1883,36549,32941,12150,0
6,0,7,11,12.7,28.8,38.3,20.2,461028,226593,148323,14598,6111,127614,86112,15033,30668,15073,9866,971,407,8489,5728,266120,205407,50602,34502,16100,10111,-484,10595,8105,5846,2259,532,1727,32834,35136,6135,1
6,0,7,8,12,31.8,37.2,19,889189,590941,151191,13627,6270,131294,147057,22084,40264,26759,6846,617,284,5945,6659,610289,306162,75669,52413,23256,228458,41982,186476,12382,8852,3530,846,2684,49288,34587,69477,1
6,0,7,8,4.7,14.3,19.7,61.2,1619643,511788,75833,2255,6747,66831,1032022,17146,94462,29849,4423,132,394,3898,60190,822390,711446,122290,68380,53910,-11346,-596,-10750,22515,16017,6498,61,6437,36526,44418,-1670,4
6,0,6,6,14.7,28.2,39.4,17.7,579951,293973,189172,23111,6971,159090,96806,18860,30750,15587,10030,1225,370,8435,5133,327049,218257,58054,39085,18969,50738,18242,32496,9311,6819,2492,510,1982,35125,32007,16396,0
6,0,1,1,3.7,25.2,36.1,35,1117653,831290,113943,6348,7459,100136,172420,23168,48241,35881,4918,274,322,4322,7442,198784,115291,26500,18049,8451,56993,1529,55464,7920,3424,4496,1246,3250,25099,33671,17066,3
6,0,6,3,19.5,31.2,32.2,17.2,972664,643052,193692,20588,7982,165122,135920,28396,34254,22646,6821,725,281,5815,4787,692112,467387,110739,73925,36814,113986,46554,67432,16422,12619,3803,719,3084,42145,37038,21865,0
6,0,2,2,4.9,25.4,35.5,34.1,960539,608336,160969,10195,8656,142118,191234,23363,41114,26038,6890,436,371,6083,8185,355886,250132,52386,33681,18705,53368,-2042,55410,11583,7203,4380,118,4262,30725,34726,13001,9
6,0,6,6,10,29.4,32.6,28,824653,456342,191584,18233,8846,164505,176727,25463,32386,17922,7524,716,347,6461,6941,435981,304147,76845,54312,22533,54989,-1888,56877,14165,9390,4775,1066,3709,30779,32391,15335,0
6,0,7,8,3.9,20.7,23.8,51.6,1395485,842476,98744,5731,9160,83853,454265,23246,60031,36242,4248,247,394,3607,19542,959878,564047,112777,68954,43823,283054,-1043,284097,20965,13812,7153,678,6475,45785,40837,43876,10
6,0,5,8,6.6,20,25.6,47.8,1288357,736107,98200,6923,9845,81432,454050,27988,46032,26301,3509,247,352,2910,16223,865837,638371,121619,71611,50008,105847,-161,106008,25164,18385,6779,27,6752,34408,34722,15700,2
6,0,6,6,11.1,37.6,31.9,19.4,951884,517829,239907,20240,11691,207976,194148,30372,31341,17050,7899,666,385,6848,6392,477532,300586,72117,49982,22135,104829,5045,99784,14827,8829,5998,1165,4833,32207,34045,20646,2
6,0,4,5,10.2,39,33.7,17.1,1264621,658965,369825,30855,16136,322834,235831,47315,26728,13927,7816,652,341,6823,4984,737783,508071,137300,101704,35596,92412,-2040,94452,19343,13891,5452,793,4659,38142,36576,20273,5
6,0,4,5,4.8,19.6,32.4,43.1,2236283,1328003,270929,19667,16303,234959,637351,51770,43197,25652,5233,380,315,4539,12311,1499607,1026794,213482,139862,73620,259331,-3327,262658,37081,24785,12296,1011,11285,40441,41428,23275,7
6,0,4,5,10.7,33.5,32.4,23.4,1246222,673458,300642,29354,17306,253982,272122,40925,30451,16456,7346,717,423,6206,6649,728813,501202,119834,82366,37468,107777,-1012,108789,22037,14263,7774,1060,6714,33072,35140,16203,5
6,0,1,1,4.2,14.5,27.8,53.4,3230126,2404263,271536,13399,18408,239729,554327,57445,56230,41853,4727,233,320,4173,9650,2765292,2145234,375067,225024,150043,244991,346,244645,41130,31815,9315,24,9291,67233,67428,26331,60
6,0,5,8,10.1,17.2,27.6,45.1,2401837,1412690,164773,14312,19928,130533,824374,51892,46285,27224,3175,276,384,2515,15886,1504125,1197942,215977,120901,95076,90206,323,89883,41171,29220,11951,135,11816,36534,40997,7607,10
6,0,5,8,12.5,28.5,28.8,30.2,2246314,1283642,267201,23792,22914,220495,695471,55964,40139,22937,4775,425,409,3940,12427,1521732,1140648,236784,150627,86157,144300,-2932,147232,37385,25505,11880,559,11321,40704,44723,13005,6
6,0,3,2,9.8,28.3,34.7,27.2,5209240,3221577,1018313,92358,60466,865489,969350,147276,35371,21874,6914,627,411,5877,6582,3355904,2468911,533014,341038,191976,353979,-61,354040,83893,61421,22472,2028,20444,40002,40197,17318,11
6,0,3,2,11.2,29,38,21.7,4924867,2716409,1410268,167059,62759,1180450,798190,160171,30748,16959,8805,1043,392,7370,4983,3033046,2272396,530006,355146,174860,230644,7578,223066,75213,60592,14621,813,13808,40326,37503,16155,15
6,0,1,1,2.1,12.2,27.7,58,16554785,12872434,1117613,45371,82193,990049,2564738,292370,56623,44028,3823,155,281,3386,8772,7185945,5346019,955000,588828,366172,884926,-2585,887511,153069,98414,54655,983,53672,46946,54322,16536,130
6,0,2,2,5.4,12.4,21.8,60.4,15632452,10124121,1464425,97644,88063,1278718,4043906,300518,52018,33689,4873,325,293,4255,13456,12241753,9327411,1821270,1162122,659148,1093072,7802,1085270,234434,169858,64576,725,63851,52218,54913,16997,595
6,0,2,2,12.3,27.3,33.4,27,9060387,6374829,1407369,136987,91547,1178835,1278189,258528,35046,24658,5444,530,354,4560,4944,5350109,3627210,779801,506654,273147,943098,180949,762149,126413,88137,38276,3227,35049,42322,41154,21745,191
6,0,2,2,4.2,19.5,30.4,45.9,11907560,7659145,1729795,121592,96059,1512144,2518620,305027,39038,25110,5671,399,315,4957,8257,7872937,5913194,1276116,842901,433215,683627,11998,671629,193349,139920,53429,1461,51968,40719,42261,12924,289
6,0,1,1,17.4,28.3,31.2,23.1,14634652,10232051,2536101,302325,181108,2052668,1866500,451443,32417,22665,5618,670,401,4547,4135,10624970,8000888,1722090,1137651,584439,901992,32565,869427,215652,173503,42149,763,41386,49269,46114,21008,83
6,0,1,1,5.7,20.7,30.4,43.1,25545647,17449998,3335702,209808,194512,2931382,4759947,540429,47269,32289,6172,388,360,5424,8808,14697347,10802646,2295713,1491619,804094,1598988,3949,1595039,309269,221035,88234,479,87755,47523,48873,18176,264
6,0,1,1,7.7,20.7,30,41.6,27321656,17255809,3323338,316157,209783,2797398,6742509,584955,46707,29499,5681,540,359,4782,11527,20847211,16916155,3164639,1935655,1228984,766417,5839,760578,384956,295109,89847,679,89168,54155,57322,8530,155
6,0,2,2,6.3,20.1,36.3,37.3,25526254,16367037,4192427,377937,224744,3589746,4966790,636596,40098,25710,6586,594,353,5639,7802,18056280,13395718,3474653,2382496,1092157,1185909,-430,1186339,366584,286712,79872,1178,78694,49256,46722,15075,188
6,0,1,1,13.3,17.6,22.6,46.5,33539485,21968498,3956587,496446,240523,3219618,7614400,619356,54152,35470,6388,802,388,5198,12294,36919650,26291618,5074906,3215899,1859007,5553126,-86,5553212,544944,438424,106520,4,106516,67749,59968,52135,50
6,0,2,2,11.6,32.7,31.2,24.4,4622071,2989406,964677,89871,73513,801293,667988,118396,39039,25249,8148,759,621,6768,5642,2384831,1563067,464721,342765,121956,357043,9522,347521,52029,39854,12175,620,11555,45837,39220,30075,25
6,0,1,1,5.9,27.2,27.3,39.7,7229841,5275930,930221,48998,75150,806073,1023690,153063,47234,34469,6077,320,491,5266,6688,3073743,1866450,578048,446413,131635,629245,3512,625733,62221,44144,18077,493,17584,49400,42281,35585,98
6,0,1,1,6,27.2,26,40.8,9127806,6488507,1185225,63168,83350,1038707,1454074,166265,54899,39025,7129,380,501,6247,8746,5043423,3345328,863308,612054,251254,834787,9242,825545,94003,68751,25252,445,24807,53652,48659,33279,118
6,0,4,3,8,29.1,28,35,9892217,6646055,1388908,78452,100960,1209496,1857254,189076,52319,35150,7346,415,534,6397,9823,4765220,2620380,703531,494369,209162,1441309,10672,1430637,95598,63285,32313,1031,31282,49846,41406,45734,92
6,0,2,2,8.1,30.1,28.8,32.9,13229656,8583022,2213595,170074,154003,1889518,2433039,273226,48420,31414,8102,622,564,6916,8905,9639044,6736907,1919955,1428165,491790,982182,14443,967739,168024,137501,30523,830,29693,57367,48995,32591,84
6,0,2,2,10.6,22,21,46.5,96668717,68011852,6916325,518152,446295,5951878,21740540,929398,104012,73178,7442,558,480,6404,23392,63682157,35507708,6729409,4640918,2088491,21445040,6916,21438124,621735,436104,185631,339,185292,102427,81420,115699,682
6,0,1,1,10.6,27.1,24.9,37.4,47858375,33005724,7813687,733521,502956,6577210,7038964,897778,53308,36764,8703,817,560,7326,7840,43190422,30990121,7186598,4968828,2217770,5013703,6994,5006709,629927,519588,110339,743,109596,68564,59644,45683,419
6,0,2,2,10.1,30.7,24.7,34.6,40426436,26202876,7740230,718467,516667,6505096,6483330,864725,46751,30302,8951,831,597,7523,7498,27041036,18868700,4677276,3221539,1455737,3495060,8430,3486630,482732,376656,106076,568,105508,56017,50095,33046,421
6,0,1,1,9.7,17.6,16.1,56.6,41968518,28656782,5764535,844194,301747,4618594,7547201,620336,67654,46196,9293,1361,486,7445,12166,81592589,59787184,16125088,11791099,4333989,5680317,0,5680317,826761,742832,83929,0,83929,98689,80485,67680,97
6,0,3,2,12.6,33.1,30.8,23.5,34942,3540108,194,6870,5995,109802602,78941778,165149,35334,21436,8089,821,288,6981,5809,3882041,2607294,863820,659110,204710,410927,70250,340677,83855,68706,15149,722,14427,46295,37949,23614,20
6,0,2,2,13.2,33.4,28.3,25.1,7720373,4150035,2046623,139105,54931,1852587,1523715,200453,38515,20703,10210,694,274,9242,7601,3821470,2461614,697361,504152,193209,662495,111774,550721,97969,72514,25455,955,24500,39007,33947,22478,12
6,0,1,1,9,29.7,25.6,35.7,21030,17837308,4090142,346186,160681,3583275,4313477,542282,48390,32893,7542,638,296,6608,7954,22824640,16261357,3832287,2688920,1143367,2730996,19104,2711892,348576,288099,60477,280,60197,65480,56444,45050,387
6,0,9,12,26.1,38.4,21.4,14,181931,106464,42734,5212,823,36699,32733,8800,20674,12098,4856,592,94,4170,3720,83835,52429,17347,13485,3862,14059,8577,5482,2337,1786,551,187,364,35873,29356,15060,0
6,0,8,7,20.2,48.8,19.8,11.1,186500,105111,52597,7436,1090,44071,28792,8261,22576,12724,6367,900,132,5335,3485,103075,73529,23335,17670,5665,6211,-1301,7512,2817,2204,613,68,545,36590,33362,13783,0
6,0,6,6,24.6,41.1,24.1,10.2,322493,159795,108157,17047,1954,89156,54541,14591,22102,10952,7413,1168,134,6110,3738,191766,141919,45536,35541,9995,4311,-5825,10136,4487,3459,1028,261,767,42738,41029,13215,1
6,0,6,4,24.1,37.7,30,8.3,274480,143681,85711,13046,1958,70707,45088,15296,17945,9393,5603,853,128,4623,2948,203989,140489,50792,40648,10144,12708,488,12220,5106,4034,1072,256,816,39951,34826,14975,1
6,0,6,4,26.3,39.5,23.2,10.9,255934,133058,73976,7994,2099,63883,48900,12833,19943,10368,5765,623,164,4978,3810,107890,63544,19144,14300,4844,25202,16091,9111,2603,1937,666,256,410,41448,32805,22222,0
6,0,6,6,22.6,40.4,27.5,9.6,345245,182672,111805,13988,2308,95509,50768,14714,23464,12415,7599,951,157,6491,3450,149227,94048,29545,22418,7127,25634,1727,23907,4355,3131,1224,195,1029,34266,30038,23233,0
6,0,6,6,23.9,39.1,25.6,11.5,510947,246993,186630,23298,2378,160954,77324,19839,25755,12450,9407,1174,120,8113,3898,181641,107027,35096,27224,7872,39518,2192,37326,6311,3793,2518,784,1734,28782,28217,21526,0
6,0,2,2,19.1,32.9,26.8,21.2,492857,252613,119030,15339,2598,101093,121214,14519,33946,17399,8198,1056,179,6963,8349,135171,81187,24725,18700,6025,29259,5287,23972,4794,2709,2085,567,1518,28196,29969,15792,2
6,0,6,7,20.9,43.9,26.1,9.1,355353,140300,147190,19701,2835,124654,67863,16403,21664,8553,8973,1201,173,7599,4137,114585,77460,24694,18981,5713,12431,1358,11073,3775,2565,1210,184,1026,30354,30199,10792,0
6,0,6,6,17.8,38.5,31.2,12.5,484354,220303,165479,23963,2984,138532,98572,19126,25324,11519,8652,1253,156,7243,5154,194158,137725,43013,32901,10112,13420,-3932,17352,6687,4519,2168,601,1567,29035,30477,11073,1
6,0,2,2,15.5,39.9,32.2,12.4,457421,258027,135535,15879,3189,116467,63859,16993,26918,15184,7976,934,188,6854,3758,170091,98811,30288,23018,7270,40992,12482,28510,4832,3179,1653,526,1127,35201,31082,25297,0
6,0,6,6,20.5,42.6,28.3,8.6,599017,309002,179615,23929,3846,151840,110400,22652,26444,13641,7929,1056,170,6703,4874,373563,272242,70815,51106,19709,30506,614,29892,8589,7085,1504,154,1350,43493,38425,22142,0
6,0,6,6,19.5,41.1,28.1,11.3,641140,325222,218309,24503,4255,189551,97609,24507,26162,13271,8908,1000,174,7735,3983,300494,205080,61205,46276,14929,34209,436,33773,8596,6352,2244,417,1827,34957,32286,18485,0
6,0,6,3,28,43.9,17.5,10.5,665283,373709,185880,31805,4437,149638,105694,27657,24055,13512,6721,1150,160,5410,3822,409633,256512,71459,51731,19728,81662,56813,24849,10912,8406,2506,810,1696,37540,30515,14652,0
6,0,6,4,21.8,38.1,29.7,10.4,744482,405561,224828,28158,5004,191666,114093,28432,26185,14264,7908,990,176,6741,4013,334073,240832,70785,53175,17610,22456,-145,22601,9201,7324,1877,433,1444,36308,32883,15652,1
6,0,2,2,12.5,36.2,33.6,17.8,919938,586518,188344,22289,5592,160463,145076,30971,29703,18938,6081,720,181,5181,4684,294569,178760,56487,43469,13018,59322,-441,59763,8908,5467,3441,143,3298,33068,32698,18121,3
6,0,1,1,15.8,41.6,29.5,13.1,713911,425040,196284,24509,5613,166162,92587,27042,26400,15718,7258,906,208,6145,3424,325504,227845,70093,53372,16721,27566,3194,24372,8997,7020,1977,345,1632,36179,32457,14934,1
6,0,6,5,29.5,40.4,18.6,11.5,784642,358335,255538,34616,5963,214959,170769,34794,22551,10299,7344,995,171,6178,4908,488105,312432,84967,60918,24049,90706,48190,42516,12687,9803,2884,735,2149,38473,31871,19784,1
6,0,6,6,19.8,39.7,26.8,13.7,1248632,651189,400772,44198,6685,349889,196671,43354,28801,15020,9244,1019,154,8071,4536,625430,349220,99682,73613,26069,176528,33351,143177,15969,11641,4328,1070,3258,39165,29999,43946,0
6,0,6,6,20.3,35.6,30,14,1371940,671660,463009,48141,7199,407669,237271,49184,27894,13656,9414,979,146,8289,4824,731015,498749,152783,116208,36575,79483,20989,58494,19956,15063,4893,1087,3806,36631,33111,15369,1
6,0,6,6,16.5,41.4,30.2,11.9,1147941,555437,384739,41145,7888,335706,207765,40154,28588,13833,9582,1025,196,8360,5174,388229,263473,74564,54636,19928,50192,130,50062,13249,8990,4259,888,3371,29303,29307,14851,1
6,0,3,2,8.4,30.1,30.6,30.9,3285313,1048843,1465004,47647,9587,1407770,771466,97976,33532,10705,14953,486,98,14369,7874,1250593,865741,222214,156147,66067,162638,170,162468,32744,23409,9335,1116,8219,38193,36983,19767,2
6,0,4,3,26.1,38.4,24.6,11,1013777,501572,342810,39551,9935,293324,169395,39854,25437,12585,8602,992,249,7360,4250,518333,359263,92277,64580,27697,66793,10991,55802,14661,11025,3636,530,3106,35355,32586,17966,1
6,0,2,2,20.3,36.2,27.2,16.3,1385922,731030,379958,71365,10619,297974,274934,47355,29267,15437,8024,1507,224,6292,5806,655948,447831,134057,101264,32793,74060,8611,65449,17768,13223,4545,355,4190,36917,33868,15620,1
6,0,4,3,34.9,33,23.7,8.4,1004640,588316,261531,49902,12216,199413,154793,38941,25799,15108,6716,1281,314,5121,3975,649717,414628,108251,74915,33336,126838,78333,48505,17208,13642,3566,284,3282,37757,30393,14779,2
6,0,4,3,13,36.1,34.5,16.4,1991272,1035032,585178,72572,13852,498754,371062,67309,29584,15377,8694,1078,206,7410,5513,1086236,783746,223508,164444,59064,78982,-646,79628,28749,22627,6122,873,5249,37783,34638,15170,1
6,0,1,1,8.6,33,31.2,27.2,3337723,1900656,584168,46024,16061,522083,852899,74146,45016,25634,7879,621,217,7041,11503,1054626,758057,174518,119504,55014,122051,-283,122334,27411,18814,8597,386,8211,38475,40292,14899,6
6,0,3,2,16,36.7,30.1,17.1,2918216,1195037,1072098,84982,16831,970285,651081,98451,29641,12138,10890,863,171,9856,6613,1288424,906058,226893,158060,68833,155473,53001,102472,37769,29638,8131,712,7419,34113,30571,13812,3
6,0,4,3,20.4,40.1,26.9,12.5,1986293,913955,740151,93867,17386,628898,332187,73635,26975,12412,10052,1275,236,8541,4511,932801,665392,181891,133277,48614,85518,7805,77713,23629,18446,5183,372,4811,39477,36072,16153,3
6,0,2,2,8.1,33.5,34.9,23.6,3372483,1559993,938736,64510,20969,853257,873754,97485,34595,16002,9630,662,215,8753,8963,963132,643773,166561,119116,47445,152798,2304,150494,30718,19753,10965,91,10874,31354,32591,13840,18
6,0,3,2,12.6,37.8,31.7,17.8,4414575,1714848,1675423,101193,27114,1547116,1024304,139765,31586,12270,11987,724,194,11069,7329,1730787,1235619,309271,219068,90203,185897,-679,186576,46578,33687,12891,450,12441,37159,36679,14997,5
6,0,2,2,9.7,26,32,32.3,8562148,3354596,1347828,70374,27933,1249521,3859724,147876,57901,22685,9115,476,189,8450,26101,3238664,2338785,504452,335330,169122,395427,29830,365597,81639,59360,22279,424,21855,39671,39400,16728,114
6,0,3,2,10,34.3,33.3,22.4,5358323,2020550,1805072,89837,29717,1685518,1532701,159881,33514,12638,11290,562,186,10542,9587,2128854,1503032,351580,238637,112943,274242,33952,240290,60926,43616,17310,215,17095,34942,34461,14056,16
6,0,2,2,7.9,22.1,28.6,41.4,9196382,5510971,1654480,180869,33142,1440469,2030931,249832,36810,22059,6622,724,133,5766,8129,6900836,5153904,1406525,1038508,368017,340407,3331,337076,153699,126866,26833,1405,25428,44898,40625,13256,108
6,0,1,1,5.6,21.3,30.2,43,10832062,6578937,1369963,80461,33217,1256285,2883162,196079,55243,33552,6987,410,169,6407,14704,3284143,2290220,502345,336420,165925,491578,6943,484635,86260,58751,27509,143,27366,38073,38982,17709,63
6,0,3,2,11.6,30.9,29.8,27.8,8033703,2821907,1386876,92423,34217,1260236,3824920,139086,57761,20289,9971,665,246,9061,27500,2620248,1818188,404225,268207,136018,397835,34554,363281,69292,49070,20222,339,19883,37815,37053,18271,15
6,0,1,1,12.2,36.7,34,17.1,5364928,2393975,1895665,137449,36597,1721619,1075288,172836,31041,13851,10968,795,212,9961,6221,1806295,1280424,320466,223920,96546,205405,-1559,206964,53825,38897,14928,667,14261,33559,32918,14513,5
6,0,1,1,8.9,31.3,36.2,23.7,6774859,4201953,1388938,117102,39775,1232061,1183968,192290,35233,21852,7223,609,207,6407,6157,2094158,1556681,378865,263630,115235,158612,-1297,159909,61669,44850,16819,348,16471,33958,34709,9709,29
6,0,2,2,6.8,18.6,29.1,45.5,10721178,6640519,1605270,197407,41648,1366215,2475389,278349,38517,23857,5767,709,150,4908,8893,8269139,6049650,1633835,1207978,425857,585654,-1611,587265,179661,147631,32030,250,31780,46026,40978,18479,49
6,0,2,2,11.1,30.6,29.2,29.1,13035630,6166432,2875101,237970,61425,2575706,3994097,327543,39798,18826,8778,727,188,7864,12194,6011921,4232204,943421,629752,313669,836296,50658,785638,148660,109194,39466,529,38937,40441,38759,20177,80
6,0,1,1,11.4,33.3,33,22.4,9971759,5092581,2932084,224474,62689,2644921,1947094,300511,33183,16946,9757,747,209,8801,6479,3968128,2864689,703824,489475,214349,399615,23402,376213,116374,84348,32026,1470,30556,34098,33963,12312,17
6,0,2,2,13.2,36.9,30.5,19.4,10392454,4266771,3502202,302724,70389,3129089,2623481,332307,31274,12840,10539,911,212,9416,7895,4550525,3354956,835331,586392,248939,360238,-84922,445160,129797,95707,34090,3104,30986,35059,35054,14366,20
6,0,2,2,7.5,29.6,29.1,33.9,18249803,6847319,3838233,204310,70635,3563288,7564251,382263,47741,17913,10041,534,185,9322,19788,7988528,5891572,1245675,818790,426885,851281,2471,848810,203828,144017,59811,203,59608,39192,40909,14240,53
6,0,1,1,14,32.2,34.8,19,7778841,4847047,1941133,327169,74602,1539362,990661,278733,27908,17390,6964,1174,268,5523,3554,3835309,2702029,603702,405517,198185,529578,19566,510012,107325,77025,30300,290,30010,35735,35080,16995,14
6,0,2,2,13.8,34,32.6,19.6,8944862,4434959,2517815,246964,76940,2193911,1992088,280487,31890,15812,8977,880,274,7822,7102,3683447,2602470,647590,456220,191370,433387,26323,407064,97624,69681,27943,270,27673,37731,37348,14710,24
6,0,1,1,11.3,33.1,32.9,22.7,15624832,8689990,4214463,338275,101694,3774494,2720379,466502,33494,18628,9034,725,218,8091,5831,5240879,3660301,877758,605891,271867,702820,1583,701237,147156,104481,42675,897,41778,35614,35033,16785,55
6,0,1,1,5.9,21.9,34.6,37.6,16132822,10667982,2724134,248313,107999,2367822,2740706,426415,37834,25018,6388,582,253,5553,6427,8878603,6904142,1470948,962011,508937,503513,3411,500102,218395,165912,52483,244,52239,40654,41613,9573,162
6,0,2,2,10.4,33.1,33.9,22.7,17005103,8456718,4647875,393819,126097,4127959,3900510,494479,34390,17102,9400,796,255,8348,7888,7854718,5689921,1338397,915222,423175,826400,30201,796199,214956,160029,54927,1120,53807,36541,35556,14797,46
6,0,2,2,15.7,35.5,29.3,19.5,19457677,10025783,5129891,612658,136062,4381171,4302003,609924,31902,16438,8411,1004,223,7183,7053,10753855,7740719,1822423,1254886,567537,1190713,80229,1110484,258249,203392,54857,1952,52905,41641,38058,20990,38
6,0,2,2,12.7,30.9,29.2,27.2,26197166,11742178,5459403,451160,138322,4869921,8995585,631077,41512,18607,8651,715,219,7717,14254,13094955,8469451,1923083,1302954,620129,2702421,21723,2680698,292596,210939,81657,683,80974,44754,40151,33106,37
6,0,2,2,8.3,28.5,34.8,28.4,20799080,11583686,4973067,352536,146182,4474349,4242327,544439,38203,21276,9134,648,269,8218,7792,12542382,9332079,2069133,1386239,682894,1141170,11542,1129628,257435,202203,55232,406,54826,48721,46152,20604,287
6,0,1,1,9.3,28.5,32.1,30.1,39987807,21032444,8804596,651109,215924,7937563,10150767,918565,43533,22897,9585,709,235,8641,11051,23598547,18002711,3920393,2622014,1298379,1675443,-1221,1676664,514908,404243,110665,81,110584,45831,44534,15162,237
6,0,1,1,10.6,27.9,32.8,28.7,33209325,20163676,6602564,843545,237761,5521258,6443085,872405,38066,23113,7568,967,273,6329,7385,30303233,23642373,5336172,3556380,1779792,1324688,3777,1320911,577700,486657,91043,300,90743,52455,48581,14557,44
6,0,1,1,11.8,25.1,30.4,32.7,41505820,26503513,7688611,1082588,297490,6308533,7313696,1170765,35452,22638,6567,925,254,5388,6247,39231721,31227699,6264235,4040321,2223914,1739787,37498,1702289,853344,698747,154597,480,154117,45974,44691,11045,131
6,0,1,1,11.8,27.2,29,32,53786197,32454084,9276898,1202972,299504,7774422,12055215,1271239,42310,25529,7298,946,236,6116,9483,40793746,29968607,6454777,4290697,2164080,4370362,42259,4328103,769145,618087,151058,2053,149005,53038,48486,29047,194
6,0,1,1,11.9,24.9,28.3,34.8,77585354,32154677,11370665,879717,302345,10188603,34060012,1337065,58027,24049,8504,658,226,7620,25474,34324610,25746611,5153100,3351914,1801186,3424899,40440,3384459,757897,538585,219312,832,218480,45289,47804,15491,449
6,0,0,0,12.4,29,30.2,28.5,766185838,406751619,157757781,16403048,4433975,136920758,201676438,19097369,40120,21299,8261,859,232,7170,10560,450502115,332057251,73664759,49546483,24118276,44780105,955905,43824200,10036634,7601048,2435586,38943,2396643,44886,43686,18286,0
6,0,8,7,30.9,47.5,14.8,6.8,42320,17951,16845,2694,510,13641,7524,1706,24807,10522,9874,1579,299,7996,4410,10964,5679,2248,1884,364,3037,2280,757,453,242,211,46,165,24203,23467,4588,1
6,0,8,6,19.1,49.1,20.6,11.3,74801,41676,19639,3398,713,15528,13486,2765,27053,15073,7103,1229,258,5616,4877,32977,17345,5401,4157,1244,10231,7222,3009,830,572,258,88,170,39731,30323,17700,0
6,0,9,12,22.4,42.4,25.8,9.4,82909,46946,24524,2815,727,20982,11439,3099,26753,15149,7914,908,235,6771,3691,19250,10939,4155,3411,744,4156,905,3251,813,438,375,82,293,23678,24975,11096,0
6,0,8,7,25.7,40.1,24.8,9.4,151092,77290,47884,8138,1396,38350,25918,6625,22806,11666,7228,1228,211,5789,3912,75357,39174,14925,12375,2550,21258,18391,2867,2071,1495,576,123,453,36387,26203,6329,0
6,0,8,4,20.8,43,23.7,12.5,182412,89491,62248,9564,1606,51078,30673,6823,26735,13116,9123,1402,235,7486,4496,39692,27612,8782,6824,1958,3298,-670,3968,1453,954,499,85,414,27317,28943,9585,1
6,0,6,6,26.3,35.1,26.5,12.1,208719,108506,68419,12497,1992,53930,31794,7564,27594,14345,9045,1652,263,7130,4203,110836,61521,19727,15367,4360,29588,12841,16747,2865,2065,800,161,639,38686,29792,26208,0
6,0,7,9,23.7,35.7,25.1,15.5,175815,92811,57461,9443,2166,45852,25543,6823,25768,13603,8422,1384,317,6720,3744,61040,33998,10575,8172,2403,16467,5789,10678,2022,1313,709,130,579,30188,25893,18442,0
6,0,3,2,20.1,33.3,30.9,15.8,238154,132159,69838,11442,2176,56220,36157,10477,22731,12614,6666,1092,208,5366,3451,69740,43815,13702,10726,2976,12223,4275,7948,2276,1542,734,79,655,30641,28414,12134,0
6,0,2,2,17,43.9,27,12.1,230389,119582,69715,7589,2206,59920,41092,7871,29271,15193,8857,964,280,7613,5221,63379,41604,13129,10101,3028,8646,-516,9162,2273,1462,811,140,671,27883,28457,13654,0
6,0,6,6,16,40.9,28.1,15.1,314577,182033,88804,13155,2211,73438,43740,8765,35890,20768,10132,1501,252,8379,4990,181180,76304,21698,16250,5448,83178,31978,51200,3562,2409,1153,128,1025,50865,31675,49951,1
6,0,9,10,30.1,40.1,21.6,8.2,197893,111672,59772,11284,2279,46209,26449,8373,23635,13337,7139,1348,272,5519,3159,93902,56512,16198,12286,3912,21192,12102,9090,2646,1785,861,158,703,35488,31659,12930,0
6,0,8,7,24.9,43.9,17.5,13.7,154258,75226,55630,9378,2287,43965,23402,5677,27172,13251,9799,1652,403,7744,4122,61836,43397,12114,8927,3187,6325,1563,4762,1960,1351,609,121,488,31549,32122,9758,0
6,0,3,2,19.9,40.1,27.4,12.6,304811,159585,82133,11352,2418,68363,63093,11842,25740,13476,6936,959,204,5773,5328,149286,99363,28121,21227,6894,21802,11800,10002,4386,3145,1241,146,1095,34037,31594,9134,0
6,0,6,6,21.3,42.4,28,8.3,223732,109945,78744,13872,2433,62439,35043,8127,27529,13528,9689,1707,299,7683,4312,72960,41999,14867,11683,3184,16094,8838,7256,2244,1428,816,198,618,32513,29411,11741,0
6,0,7,8,24.4,43.2,22.8,9.6,212553,102096,79503,12070,2490,64943,30954,10009,21236,10200,7943,1206,249,6488,3093,78188,53376,18322,14544,3778,6490,-1516,8006,2683,1823,860,222,638,29142,29279,12549,0
6,0,3,2,24.2,31.4,33.6,10.8,325144,179533,90192,18216,2522,69454,55419,9391,34623,19118,9604,1940,269,7396,5901,134250,76171,21465,16305,5160,36614,22261,14353,3621,2471,1150,203,947,37075,30826,15156,0
6,0,7,9,17.5,41.3,29.3,11.8,295981,165525,93573,12394,2528,78651,36883,11162,26517,14829,8383,1110,226,7046,3304,171263,106104,31354,23862,7492,33805,20908,12897,4845,3623,1222,236,986,35348,29286,13080,0
6,0,7,9,24.3,35.2,26.1,14.4,289448,147781,98329,14479,2552,81298,43338,11208,25825,13185,8773,1292,228,7254,3867,135332,84931,25396,19546,5850,25005,8933,16072,4283,2931,1352,211,1141,31597,28977,14086,1
6,0,7,9,17.9,40.7,28.3,13.1,286871,146869,84204,11674,2599,69931,55798,9697,29583,15146,8684,1204,268,7212,5754,133968,70759,24401,19348,5053,38808,22436,16372,3417,2383,1034,328,706,39206,29693,23190,1
6,0,6,6,23.5,37.7,25.3,13.5,263907,126497,86835,15245,2705,68885,50575,8937,29530,14154,9716,1706,303,7708,5659,110261,68315,20161,15346,4815,21785,13688,8097,3555,2388,1167,226,941,31016,28608,8605,0
6,0,9,12,10.9,30.4,33.1,25.6,319683,106257,122480,6954,2721,112805,90946,10578,30221,10045,11579,657,257,10664,8598,145789,98309,29499,22446,7053,17981,-192,18173,5172,3354,1818,96,1722,28188,29311,10553,0
6,0,6,6,19.6,36.3,27.1,17,358505,203670,102374,18477,2736,81161,52461,10784,33244,18886,9493,1713,254,7526,4865,262063,173125,46265,33967,12298,42673,35163,7510,5612,4442,1170,273,897,46697,38975,8372,0
6,0,9,8,18.7,38.3,27.6,15.5,229713,129603,65609,9324,2796,53489,34501,9034,25428,14346,7262,1032,309,5921,3819,76480,50290,15022,11371,3651,11168,2355,8813,2631,1724,907,190,717,29069,29171,12291,0
6,0,1,1,19.7,44.9,24.7,10.8,295387,171717,90659,13315,2927,74417,33011,11725,25193,14645,7732,1136,250,6347,2815,164376,110137,33495,25167,8328,20744,-517,21261,3494,2458,1036,148,888,47045,44808,23943,1
6,0,6,6,21.4,41.6,22.7,14.3,305096,137252,102703,12840,2949,86914,65141,10230,29824,13417,10039,1255,288,8496,6368,144195,93500,29529,22965,6564,21166,7386,13780,4508,3222,1286,278,1008,31986,29019,13671,0
6,0,3,2,13.5,30.8,40.1,15.6,412806,265584,84645,14663,3080,66902,62577,15208,27144,17463,5566,964,203,4399,4115,50992,30965,12004,9870,2134,8023,1450,6573,1715,1072,643,63,580,29733,28885,11333,0
6,0,3,2,15.6,37,34.3,13.2,367725,218995,100879,13251,3241,84387,47851,12615,29150,17360,7997,1050,257,6689,3793,81101,42701,12827,9792,3035,25573,14609,10964,2184,1451,733,134,599,37134,29429,18304,0
6,0,3,2,17.2,36.1,32.8,14,334018,168092,101861,13236,3327,85298,64065,14223,23484,11818,7162,931,234,5997,4504,97837,59667,19523,15393,4130,18647,1903,16744,3448,2077,1371,46,1325,28375,28727,12637,0
6,0,3,2,22.1,36,26.3,15.5,420194,253408,102874,12861,3458,86555,63912,14702,28581,17236,6997,875,235,5887,4347,119232,54986,17641,13791,3850,46605,29194,17411,3529,2111,1418,353,1065,33786,26047,16348,0
6,0,2,2,20.9,34.2,31,13.9,441201,262696,118152,11524,3593,103035,60353,16589,26596,15836,7122,695,217,6211,3638,168058,106424,28535,20652,7883,33099,201,32898,4918,3303,1615,184,1431,34172,32220,22990,1
6,0,1,1,23.9,38.1,27.6,10.5,382804,225214,103010,14562,3720,84728,54580,13838,27663,16275,7444,1052,269,6123,3944,106683,63511,19927,15369,4558,23245,2022,21223,3686,2135,1551,227,1324,28943,29748,16029,3
6,0,3,2,19.5,37.7,29.2,13.6,495738,266690,138119,20467,3793,113859,90929,15994,30995,16674,8636,1280,237,7119,5685,164225,86566,25067,18961,6106,52592,40593,11999,4223,3053,1170,319,851,38888,28354,14100,0
6,0,8,6,23,41.8,23.2,11.9,472792,277636,126224,15276,3927,107021,68932,18267,25882,15199,6910,836,215,5859,3774,160058,104482,28314,20535,7779,27262,1771,25491,5516,3708,1808,441,1367,29017,28177,18647,1
6,0,7,11,29.6,47.4,14.9,8.1,298245,140102,113415,15730,3966,93719,44728,16266,18335,8613,6973,967,244,5762,2750,160547,104249,33369,25296,8073,22929,5103,17826,5167,3820,1347,267,1080,31072,27290,16506,0
6,0,6,4,17.6,32.7,24.1,25.6,651428,248836,165069,19324,4015,141730,237523,16080,40512,15475,10265,1202,250,8814,14771,262064,182971,43631,30639,12992,35462,9341,26121,7714,5255,2459,173,2286,33973,34818,11427,1
6,0,6,6,27.2,33.8,30.4,8.6,336794,176073,106083,17031,4076,84976,54638,14462,23288,12175,7335,1178,282,5876,3778,185097,108904,31227,23616,7611,44966,28919,16047,4699,3281,1418,236,1182,39391,33192,13576,0
6,0,1,1,11,41.1,31.4,16.5,545367,347039,122517,13579,4349,104589,75811,17780,30673,19519,6891,764,245,5882,4264,137059,80253,24664,18834,5830,32142,-1080,33222,4960,2654,2306,272,2034,27633,30239,16333,1
6,0,1,1,13.4,34.7,29.8,22.1,641390,355132,142355,17276,4418,120661,143903,17903,35826,19836,7951,965,247,6740,8038,289679,213154,54796,39651,15145,21729,7117,14612,9806,6610,3196,491,2705,29541,32247,5402,1
6,0,6,6,15.1,42.3,25.4,17.2,388177,208113,107129,12303,4572,90254,72935,13080,29677,15911,8190,941,350,6900,5576,151785,100841,36006,29057,6949,14938,3128,11810,5049,3686,1363,211,1152,30062,27358,10252,0
6,0,6,5,18.1,40.2,29,12.7,556695,305263,168281,19561,4606,144114,83151,18779,29645,16256,8961,1042,245,7674,4428,186931,121632,35016,26503,8513,30283,8928,21355,6182,4117,2065,319,1746,30238,29544,12231,0
6,0,7,10,16.2,33.4,25.1,25.3,508907,211599,151376,12326,4607,134443,145932,16270,31279,13005,9304,758,283,8263,8969,220010,145061,39552,29022,10530,35397,1128,34269,7501,5030,2471,89,2382,29331,28839,14387,5
6,0,6,6,21.3,37.3,26.7,14.8,461749,248272,140605,21470,4758,114377,72872,17045,27090,14566,8249,1260,279,6710,4275,181506,112488,33699,25557,8142,35319,17644,17675,5512,3964,1548,195,1353,32929,28377,13064,1
6,0,7,9,23,36.5,30.3,10.3,400360,221094,121035,18331,4767,97937,58231,15158,26412,14586,7985,1209,314,6461,3842,207297,136007,39634,29696,9938,31656,9118,22538,6158,4517,1641,175,1466,33663,30110,15374,0
6,0,3,2,18.3,48.3,25.6,7.8,411414,225585,137527,17736,4798,114993,48302,18540,22191,12167,7418,957,259,6202,2605,111583,66878,22366,17709,4657,22339,-1628,23967,3787,2291,1496,192,1304,29465,29192,18380,0
7,0,1,1,16.3,25.4,31,27.3,68745923,43853090,12041150,1625624,303888,10111638,12851683,1788244,38443,24523,6734,909,170,5655,7187,53293749,37237246,8617698,5909098,2708600,7438805,3098,7435707,1036986,828930,208056,2185,205871,51393,44922,36118,163
7,0,1,1,14.6,23.8,30.5,31.1,82699478,58311245,10410560,1361166,342573,8706821,13977673,1882399,43933,30977,5530,723,182,4625,7425,59126472,40640105,8550535,5639053,2911482,9935832,1589,9934243,1093735,832550,261185,1099,260086,54059,48814,38196,416
7,0,1,1,21.7,22.5,25.7,30.1,119354141,80527527,14054195,2319325,466504,11268366,24772419,2454781,48621,32804,5725,945,190,4590,10091,131132172,92584954,16962079,10644552,6317527,21585139,12123,21573016,1963201,1552693,410508,734,409774,66795,59629,52646,696
7,0,1,1,19.5,23.3,26.7,30.5,226341627,162951709,23627904,3568119,776852,19282933,39762014,4262689,53098,38227,5543,837,182,4524,9328,216379770,144059780,26211616,16927890,9283726,46108374,8789,46099585,2841362,2237580,603782,1938,601844,76154,64382,76597,990
7,0,0,0,17.2,25.1,29,28.7,1133801108,774212622,163711977,21467699,4737815,137506463,195876509,26078327,43477,29688,6278,823,182,5273,7511,848490032,568953207,117676948,78749390,38927558,161859877,1011096,160848781,15095912,11358574,3737338,222832,3514506,56207,50090,45767,0
7,0,0,0,12.7,27.3,29.1,30.9,13998383000,8956340000,2362988000,267614000,84439000,2010935000,2679055000,313993272,44582,28524,7526,852,269,6404,8532,9901882000,6918166000,1632251000,1119860000,512391000,1351465000,65035000,1286430000,178979700,139619000,39360700,1844000,37516700,55324,49550,34290,0
7,0,9,10,4.9,43.3,42.5,9.3,38502,21862,6918,340,138,6440,9722,1094,35194,19984,6324,311,126,5887,8887,20537,14476,4827,3669,1158,1234,-4,1238,557,417,140,45,95,36871,34715,13032,0
7,0,9,12,15.9,36.6,24.8,22.7,35931,15499,13121,1219,210,11692,7311,1497,24002,10353,8765,814,140,7810,4884,12325,7732,2655,2055,600,1938,-914,2852,563,285,278,114,164,21892,27130,17390,0
7,0,8,7,1.9,31.4,44,22.8,64309,34296,11180,1152,247,9781,18833,2256,28506,15202,4956,511,109,4336,8348,30561,19543,5663,4017,1646,5355,1787,3568,1310,701,609,115,494,23329,27879,7223,0
7,0,9,12,11.4,23.8,38.8,26,74520,37824,16985,2050,802,14133,19711,2709,27508,13962,6270,757,296,5217,7276,38054,27291,8351,5924,2427,2412,-426,2838,1655,953,702,160,542,22993,28637,5236,1
7,0,7,9,9.2,38.7,33.6,18.5,196416,121754,42081,4738,884,36459,32581,6505,30195,18717,6469,728,136,5605,5009,143446,98700,26124,16819,9305,18622,4319,14303,3748,2689,1059,224,835,38273,36705,17129,2
7,0,2,2,2.8,17.7,39.6,40,417692,302090,40480,2820,1065,36595,75122,9803,42609,30816,4129,288,109,3733,7663,126399,71081,17005,11502,5503,38313,5241,33072,3977,1914,2063,253,1810,31782,37137,18272,5
7,0,6,6,6.2,26,40.9,27,233052,127191,52658,4519,1128,47011,53203,7173,32490,17732,7341,630,157,6554,7417,142646,99005,25781,17653,8128,17860,-229,18089,4461,3170,1291,156,1135,31976,31232,15937,0
7,0,2,2,7.6,37.1,38.6,16.8,281078,188261,58246,7119,1299,49828,34571,10295,27302,18287,5658,692,126,4840,3358,151727,111337,29840,20374,9466,10550,-1108,11658,4842,3310,1532,290,1242,31336,33637,9386,0
7,0,7,11,10.4,31.9,36.2,21.4,374357,233382,77315,9194,1383,66738,63660,12454,30059,18740,6208,738,111,5359,5112,254312,173982,49352,35690,13662,30978,15755,15223,6576,4514,2062,624,1438,38673,38543,10586,0
7,0,9,12,8.8,33.4,36.7,21.1,150527,83807,33185,3252,1511,28422,33535,5063,29731,16553,6554,642,298,5614,6624,93633,67268,20350,13868,6482,6015,-845,6860,3366,2390,976,232,744,27817,28146,9220,0
7,0,7,10,6.7,32.5,45.8,15,299481,189230,67510,7532,1698,58280,42741,10938,27380,17300,6172,689,155,5328,3908,223720,172245,46377,32854,13523,5098,-1374,6472,5380,3743,1637,549,1088,41584,46018,5949,0
7,0,7,11,8.9,27.1,36.2,27.8,379035,213893,61925,8094,2298,51533,103217,9355,40517,22864,6619,865,246,5509,11033,252339,154417,40346,26579,13767,57576,-702,58278,6881,5010,1871,57,1814,36672,30822,32127,2
7,0,7,9,16.3,31.1,35.2,17.3,331998,184191,87788,19721,2514,65553,60019,15034,22083,12252,5839,1312,167,4360,3992,221249,160904,47558,34480,13078,12787,-2872,15659,6346,4504,1842,688,1154,34864,35725,13569,0
7,0,7,11,10,32,41.2,16.8,559670,317499,139864,17062,2855,119947,102307,20659,27091,15369,6770,826,138,5806,4952,374996,273451,75987,53187,22800,25558,-27,25585,11591,8475,3116,601,2515,32352,32266,10173,1
7,0,6,3,7,18.8,35.5,38.7,955256,620318,100071,12212,3213,84646,234867,25428,37567,24395,3935,480,126,3329,9237,346385,231833,56615,37895,18720,57937,-2375,60312,11850,6791,5059,394,4665,29231,34138,12929,5
7,0,7,8,10.3,27.7,46.3,15.7,690797,428882,161034,18463,3267,139304,100881,21230,32539,20202,7585,870,154,6562,4752,501608,374909,95213,64740,30473,31486,-1060,32546,11669,9335,2334,284,2050,42986,40162,15876,3
7,0,7,8,14.1,35.1,36.5,14.3,1172573,832956,140564,18725,3698,118141,199053,34644,33846,24043,4057,540,107,3410,5746,967124,744520,164497,105999,58498,58107,-2165,60272,20039,15713,4326,1081,3245,48262,47382,18574,1
7,0,6,6,10.9,27.3,42.6,19.2,694007,414723,162499,21044,3709,137746,116785,27950,24830,14838,5814,753,133,4928,4178,367307,220276,70503,52743,17760,76528,20284,56244,11422,7472,3950,800,3150,32158,29480,17855,4
7,0,7,9,12.6,36,37,14.5,725156,502585,103906,12373,3716,87817,118665,19013,38140,26434,5465,651,195,4619,6241,597465,430520,106214,72265,33949,60731,4076,56655,12947,9406,3541,925,2616,46147,45771,21657,2
7,0,4,3,6.3,14.5,25.7,53.5,3490090,1999254,149427,14427,5460,129540,1341409,37899,92089,52752,3943,381,144,3418,35394,1326404,909235,186965,110638,76327,230204,1677,228527,35903,23884,12019,537,11482,36944,38069,19903,29
7,0,4,5,7.5,24.8,39,28.7,1166881,663806,271981,41317,6645,224019,231094,46642,25018,14232,5831,886,142,4803,4955,695726,496731,146839,106457,40382,52156,5008,47148,22245,16084,6161,427,5734,31276,30884,8223,4
7,0,2,2,6.5,31.4,39.3,22.7,1522962,1015925,260371,31776,6772,221823,246666,50201,30337,20237,5187,633,135,4419,4914,913038,658718,165246,110151,55095,89074,20149,68925,24091,17460,6631,1054,5577,37900,37727,12359,15
7,0,1,1,8.1,30.2,39.1,22.6,1862555,1359496,252947,37153,8545,207249,250112,59788,31153,22739,4231,621,143,3466,4183,1005173,746202,189299,129510,59789,69672,1369,68303,21543,16847,4696,421,4275,46659,44293,15977,5
7,0,3,2,6.7,21.3,35.1,36.9,3619585,2357645,515782,80091,12451,423240,746158,115858,31242,20349,4452,691,107,3653,6440,2548758,1676566,484259,350319,133940,387933,18814,369119,68355,51889,16466,1054,15412,37287,32311,23950,66
7,0,3,2,7.6,23.4,40.9,28.1,4041365,2040966,994951,111010,19233,864708,1005448,144216,28023,14152,6899,770,133,5996,6972,2254418,1647250,417161,277791,139370,190007,-3740,193747,74752,51417,23335,503,22832,30159,32037,8486,18
7,0,2,2,4.4,21.1,38.3,36.2,11892004,8451417,1341276,155066,37839,1148371,2099311,315911,37644,26753,4246,491,120,3635,6645,6976120,4812891,1337607,935349,402258,825622,3687,821935,158317,117227,41090,423,40667,44064,41056,20211,78
7,0,2,2,9.9,29.2,37,24,7915617,5102302,1320645,185622,41859,1093164,1492670,236342,33492,21589,5588,785,177,4625,6316,4977578,3618188,971994,672423,299571,387396,3465,383931,122056,96597,25459,1001,24458,40781,37457,15698,34
7,0,2,2,6,16,38.6,39.4,16225925,11096795,2219427,351067,57895,1810465,2909703,539776,30060,20558,4112,650,107,3354,5391,10358864,7634741,1771543,1162582,608961,952580,41791,910789,273616,196111,77505,2170,75335,37859,38931,12090,361
7,0,1,1,9.8,22.7,33.8,33.6,43816498,29668811,5406606,750482,142380,4513744,8741081,1064489,41162,27871,5079,705,134,4240,8212,40542566,29430977,6761912,4444653,2317259,4349677,1043,4348634,776002,625687,150315,542,149773,52245,47038,29035,530
7,0,0,0,8.2,22.8,36.4,32.5,103227839,68626660,14110743,1929640,374714,11806389,20490436,2854222,36167,24044,4944,676,131,4136,7179,76464478,55084989,13326083,8912186,4413897,8053406,130624,7922782,1706060,1303995,402065,15724,386341,44819,42243,20507,0
7,0,8,7,12.5,41.9,29.7,15.9,231247,104136,44438,2676,604,41158,82673,4640,49838,22443,9577,577,130,8870,17817,120605,81755,18601,12631,5970,20249,-596,20845,3012,2384,628,96,532,40042,34293,39182,1
7,0,8,7,11.8,40.4,33.6,14.2,206983,114721,57298,3974,618,52706,34964,6695,30916,17135,8558,594,92,7872,5222,114929,80548,24509,18443,6066,9872,-512,10384,2874,2074,800,336,464,39989,38837,22379,2
7,0,1,1,8.6,33.3,31.2,26.9,423228,215767,84570,5067,824,78679,122891,8910,47500,24216,9492,569,92,8830,13792,89327,45236,11634,8265,3369,32457,264,32193,2953,1614,1339,45,1294,30250,28027,24879,0
7,0,2,2,9.4,41.4,30,19.2,168756,97979,41907,3518,846,37543,28870,5138,32845,19069,8156,685,165,7307,5619,37696,22909,6363,4658,1705,8424,-1260,9684,1357,718,639,182,457,27779,31907,21190,0
7,0,1,1,11.4,27.1,27.9,33.6,404735,229439,53099,3137,856,49106,122197,7405,54657,30984,7171,424,116,6631,16502,131519,71678,14929,10443,4486,44912,-1824,46736,3380,1700,1680,336,1344,38911,42164,34774,1
7,0,8,4,14.5,41.9,24.7,18.9,241967,148737,55776,5540,1063,49173,37454,7009,34522,21221,7958,790,152,7016,5344,72086,43123,10938,7679,3259,18025,2692,15333,1873,1143,730,99,631,38487,37728,24300,0
7,0,8,4,13,36,24.1,26.9,29733,340244,91480,7791,1105,82584,110906,13133,41318,25908,6966,593,84,6288,8445,201695,103766,25635,17696,7939,72294,-971,73265,5307,3257,2050,444,1606,38005,31859,45620,1
7,0,8,4,11.9,33,33,22.1,456538,216117,111572,7801,1160,102611,128849,10845,42097,19928,10288,719,107,9462,11881,183791,106769,28509,20720,7789,48513,979,47534,5279,3484,1795,57,1738,34815,30646,27350,0
7,0,8,4,18.5,37.7,27.1,16.7,303792,175231,81304,10105,1202,69997,47257,9839,30876,17810,8263,1027,122,7114,4803,74633,41421,11972,8827,3145,21240,7415,13825,2166,1402,764,233,531,34457,29544,26036,0
7,0,8,4,16.1,31.5,33.3,19.1,244447,151326,53504,5519,1208,46777,39617,6839,35743,22127,7823,807,177,6840,5793,233583,174836,47098,35157,11941,11649,5573,6076,2937,2384,553,105,448,79531,73337,13563,0
7,0,6,4,23.4,37.7,25.3,13.7,466653,217363,155685,17876,1491,136318,93605,15756,29617,13796,9881,1135,95,8652,5941,284431,207278,65001,47872,17129,12152,1187,10965,7540,6061,1479,312,1167,37723,34199,9396,0
7,0,1,1,19.2,35.7,30.6,14.5,459614,288464,102226,10426,1595,90205,68924,12747,36057,22630,8020,818,125,7077,5407,163242,88367,21314,14592,6722,53561,17586,35975,4255,2613,1642,357,1285,38365,33818,27996,0
7,0,1,1,21.9,40.3,25.1,12.8,262628,158970,55947,5231,1595,49121,47711,7126,36855,22308,7851,734,224,6893,6695,100330,68035,16043,10768,5275,16252,4242,12010,2260,1740,520,65,455,44394,39101,26396,1
7,0,1,1,26.7,40.5,21,11.7,327415,183269,93936,11419,1625,80892,50210,11917,27475,15379,7883,958,136,6788,4213,195793,139835,37056,26815,10241,18902,10151,8751,4627,3849,778,101,677,42315,36330,12926,1
7,0,3,2,14.3,32.2,22.7,30.8,621132,338120,135541,11288,1653,122600,147471,14803,41960,22841,9156,763,112,8282,9962,208354,119305,30400,21628,8772,58649,1349,57300,6539,3830,2709,391,2318,31863,31150,24720,1
7,0,8,7,18.6,41.9,27.6,11.9,360182,177708,116127,13523,1668,100936,66347,12395,29059,14337,9369,1091,135,8143,5353,139350,87986,25536,18888,6648,25828,2234,23594,4900,2999,1901,473,1428,28439,29338,16522,0
7,0,1,1,13.1,28.4,27,31.5,762276,499668,87687,5096,1695,80896,174921,14242,53523,35084,6157,358,119,5680,12282,276295,170417,36566,23671,12895,69312,7821,61491,6797,4106,2691,414,2277,40650,41504,27005,1
7,0,3,2,23.1,41.5,24,11.4,434339,246645,119885,16150,2125,101610,67809,17068,25448,14451,7024,946,125,5953,3973,191612,126642,34696,25361,9335,30274,5648,24626,4886,3542,1344,331,1013,39217,35754,24310,1
7,0,3,2,15.7,33.4,31.6,19.4,502958,293432,120246,10857,2180,107209,89280,15431,32594,19016,7792,704,141,6948,5786,153641,90953,24066,17105,6961,38622,-855,39477,5732,3209,2523,760,1763,26804,28343,22392,0
7,0,6,4,17.4,32.9,24.7,24.9,605143,322318,170184,21430,2235,146519,112641,23166,26122,13913,7346,925,96,6325,4862,428793,307070,80465,57030,23435,41258,2762,38496,11789,9598,2191,363,1828,36372,31993,21059,1
7,0,6,4,17.4,35.4,28.3,18.9,395469,219045,101332,11953,2253,87126,75092,11129,35535,19682,9105,1074,202,7829,6747,184430,128024,30940,21280,9660,25466,2886,22580,5419,4160,1259,84,1175,34034,30775,19217,0
7,0,9,12,9.9,30.8,27.4,31.9,532516,202974,130532,9055,2267,119210,199010,11125,47867,18245,11733,814,204,10716,17889,243695,169223,38330,25901,12429,36142,-463,36605,7002,5044,1958,49,1909,34804,33549,19175,5
7,0,3,2,15.4,30.6,27.4,26.7,685313,462282,114640,10819,2325,101496,108391,18816,36422,24569,6093,575,124,5394,5761,216750,138115,31121,20615,10506,47514,-80,47594,5760,3822,1938,182,1756,37630,36137,27104,2
7,0,1,1,8.7,25.3,27.1,38.9,1744788,1039390,165449,7767,2373,155309,539949,21279,81996,48846,7775,365,112,7299,25375,1197742,969637,161309,99230,62079,66796,-23,66819,16318,12861,3457,269,3188,73400,75394,20960,5
7,0,9,12,18.9,38.8,29.5,12.8,431257,209039,146619,14305,2395,129919,75599,15143,28479,13804,9682,945,158,8579,4992,114485,71699,20978,15408,5570,21808,-453,22261,4563,2584,1979,688,1291,25090,27747,17243,1
7,0,1,1,7.4,34.1,31.7,26.9,1157065,890538,118492,7155,2410,108927,148035,19149,60424,46506,6188,374,126,5688,7731,224068,142260,34809,23920,10889,46999,1103,45896,6748,4024,2724,118,2606,33205,35353,17612,1
7,0,1,1,10.4,37.2,33.5,19,628151,426186,106500,9282,2414,94804,95465,15977,39316,26675,6666,581,151,5934,5975,211979,147331,33459,22542,10917,31189,1737,29452,5403,3674,1729,109,1620,39234,40101,18180,1
7,0,2,2,20.1,37.5,29.2,13.3,665666,338273,224516,23015,2434,199067,102877,22959,28994,14734,9779,1002,106,8671,4481,228073,162525,42210,29625,12585,23338,-4314,27652,7960,5230,2730,1200,1530,28652,31076,18073,0
7,0,6,4,6.2,27.2,32.4,34.2,1140854,795501,124766,12750,2590,109426,220587,24610,46357,32324,5070,518,105,4446,8963,1107805,784872,241643,178061,63582,81290,-66,81356,13562,11203,2359,140,2219,81684,70059,36663,7
7,0,3,2,8.3,26,33.4,32.3,952639,604785,164526,10772,2606,151148,183328,25885,36803,23364,6356,416,101,5839,7082,258400,162342,43107,31086,12021,52951,-427,53378,7406,4529,2877,260,2617,34891,35845,20397,0
7,0,8,7,21.3,34.3,30.1,14.3,525114,263985,171432,16837,2727,151868,89697,18326,28654,14405,9355,919,149,8287,4895,226850,148325,40912,29082,11830,37613,1307,36306,7660,5406,2254,506,1748,29615,27437,20770,1
7,0,6,4,21.3,38.4,27.3,13.1,475039,239255,159419,20140,2740,136539,76365,17035,27886,14045,9358,1182,161,8015,4483,197536,140822,38114,27375,10739,18600,5463,13137,5768,4537,1231,272,959,34247,31039,13699,0
7,0,9,12,9.3,32.3,32,26.4,17752,197655,136956,9534,2882,124540,181815,12423,41570,15910,11024,767,232,10025,14635,141456,89816,22593,15718,6875,29047,1394,27653,4399,2717,1682,73,1609,32156,33057,17186,0
7,0,9,12,19.5,38.9,28.2,13.4,269650,142586,70224,7384,2984,59856,56840,9082,29691,15700,7732,813,329,6591,6259,148999,105969,28725,21105,7620,14305,2222,12083,3917,2992,925,77,848,38039,35417,14249,1
7,0,1,1,9.2,30.6,31.8,28.4,1229261,854729,163897,9141,3012,151744,210635,28171,43636,30341,5818,324,107,5387,7477,404249,270379,68366,48535,19831,65504,164,65340,10599,7313,3286,216,3070,38140,36972,21283,0
7,0,8,7,25.4,33.5,29.9,11.1,679783,334080,248393,35206,3062,210125,97310,25421,26741,13142,9771,1385,120,8266,3828,263910,182731,53668,39748,13920,27511,-3572,31083,7908,5542,2366,929,1437,33373,32972,21630,0
7,0,6,4,13.6,33.8,31.4,21.1,26376,322508,156386,16669,3170,136547,159307,17507,36454,18422,8933,952,181,7800,9100,173138,112181,28774,20349,8425,32183,4495,27688,5836,3801,2035,125,1910,29667,29514,14496,0
7,0,9,12,23.7,37,28.8,10.6,29123,170408,214,8723,3422,325739,188260,12638,27660,13484,8384,1067,120,7196,5792,128161,91446,24140,17187,6953,12575,-435,13010,3772,2781,991,334,657,33977,32882,19802,0
7,0,9,10,28.4,36.4,24.4,10.8,771001,398843,271020,31003,3587,236430,101138,23813,32377,16749,11381,1302,151,9929,4247,544747,415771,95235,64893,30342,33741,-168,33909,10191,8949,1242,97,1145,53454,46460,29615,0
7,0,3,2,13,38,31.9,17,28560,334133,260,8236,3776,321006,205483,17017,33950,19635,9065,776,156,8132,5250,289814,206216,52834,37261,15573,30764,-1361,32125,7005,5299,1706,342,1364,41372,38916,23552,0
7,0,6,4,14,38.5,28.4,19.2,31107,926298,204,8413,3857,105827,54332,42532,36508,21779,7560,635,133,6792,7169,710364,462760,113856,78585,35271,133748,17932,115816,19804,14094,5710,865,4845,35870,32834,23904,1
7,0,8,4,18.9,33.4,24.5,23.2,25759,242233,186,8405,3869,284964,182856,12218,39543,19826,10665,1310,220,9135,9052,259844,159755,38942,26783,12159,61147,29425,31722,6522,4801,1721,97,1624,39841,33275,19533,3
7,0,1,1,10.2,32.7,34.3,22.8,28463,1002250,267306,23072,3872,240362,302879,36834,42690,27210,7257,626,105,6526,8223,464689,309006,78165,55488,22677,77518,1478,76040,13870,10109,3761,111,3650,33503,30567,20833,6
7,0,2,2,15.1,35.9,28.3,20.6,24906,281661,194,8199,3981,55716,31481,15241,31728,18480,8455,927,167,7361,4792,145815,99764,26613,19185,7428,19438,-1018,20456,5079,3391,1688,360,1328,28709,29420,15404,0
7,0,6,4,11.4,34.5,28.6,25.6,1426597,851666,275153,19648,3996,251509,299778,34280,41616,24844,8027,573,117,7337,8745,485743,321497,78213,54661,23552,86033,-3031,89064,13455,9135,4320,449,3871,36101,35194,23008,3
7,0,9,8,25.5,37.4,27.8,9.3,31147,214692,220,8096,4060,79327,45580,15712,28407,13664,11121,1196,172,9753,3622,220680,163299,39634,28113,11521,17747,-1965,19712,4889,4079,810,136,674,45138,40034,29246,0
7,0,2,2,15.9,34.4,29.7,19.9,1024298,594620,260317,24222,4075,232020,169361,32436,31579,18332,8026,747,126,7153,5221,466191,337215,87860,62966,24894,41116,-1797,42913,12588,9738,2850,373,2477,37035,34629,17325,4
7,0,2,2,7.5,32.9,31.3,28.3,1416051,925528,244705,12944,4097,227664,245818,33118,42758,27946,7389,391,124,6874,7422,552423,382971,90721,61127,29594,78731,-1171,79902,13837,9853,3984,514,3470,39924,38868,23027,20
7,0,8,6,17.8,39,23.6,19.6,1181700,619490,308690,39049,4413,265228,253520,33264,35525,18623,9280,1174,133,7973,7621,686244,466175,124563,89012,35551,95506,26814,68692,17588,13780,3808,167,3641,39018,33830,18866,2
7,0,6,6,20.3,35.9,27.8,15.9,1094259,555461,336064,40017,4689,291358,202734,35717,30637,15552,9409,1120,131,8157,5676,595786,429943,114013,80967,33046,51830,4168,47662,16241,12909,3332,839,2493,36684,33306,19118,1
7,0,8,4,15.4,35,26.3,23.2,1198259,761232,235299,22186,4693,208420,201728,33499,35770,22724,7024,662,140,6222,6022,592507,418090,102566,72297,30269,71851,-1454,73305,12568,8863,3705,422,3283,47144,47173,22329,5
7,0,8,7,15.5,35.6,23.9,25,27461,33752,204,7509,4732,120926,71722,2234,38494,15108,9345,511,108,8726,14040,31679,16467,4836,3638,1198,10376,5637,4739,1308,610,698,233,465,24219,26995,10191,0
7,0,7,9,18.4,33.3,30,18.2,1004043,491067,313528,33042,4755,275731,199448,31692,31681,15495,9893,1043,150,8700,6293,543700,397114,101048,70361,30687,45538,2403,43135,15725,12752,2973,464,2509,34576,31141,17192,0
7,0,1,1,12.4,27.9,32.7,26.9,22195,1178757,265390,21799,4829,238762,260065,35339,48225,33356,7510,617,137,6756,7359,602830,431316,93915,63502,30413,77599,7817,69782,14150,10616,3534,172,3362,42603,40629,20756,0
7,0,6,6,16.6,38.4,26.8,18.3,890295,473362,264458,22672,4859,236927,152475,29317,30368,16146,9021,773,166,8082,5201,537516,386498,102374,72280,30094,48644,-1297,49941,15646,12221,3425,848,2577,34355,31626,19380,0
7,0,7,9,21.2,35.7,29.5,13.6,861934,462106,279655,31114,5041,243500,120173,28400,30350,16271,9847,1096,178,8574,4231,397270,283461,71317,49054,22263,42492,-4082,46574,10213,7701,2512,888,1624,38898,36808,28679,0
7,0,1,1,15.1,31.7,29.7,23.4,1915390,1299269,298844,31000,5077,262767,317277,47841,40037,27158,6247,648,106,5493,6632,946215,627259,149017,101981,47036,169939,127,169812,22484,16030,6454,632,5822,42084,39130,29167,2
7,0,1,1,16.5,36.9,27.5,19.2,28554,674883,199667,22281,5098,172288,156442,28954,35608,23309,6896,770,176,5950,5403,305806,209395,59041,42935,16106,37370,-6,37376,8528,5870,2658,192,2466,35859,35672,15157,5
7,0,6,4,19,44.8,23,13.2,768992,431183,196301,19253,5147,171901,141508,23839,32258,18087,8234,808,216,7211,5936,290256,177673,47843,32792,15051,64740,16979,47761,8659,6005,2654,488,2166,33521,29588,22050,0
7,0,5,8,20.3,35.8,28.6,15.2,1510263,807128,440310,42784,5934,391592,262825,44277,34109,18229,9944,966,134,8844,5936,813142,586186,147431,103632,43799,79525,25,79500,21227,17471,3756,519,3237,38307,33552,24560,1
7,0,3,2,14.6,33.2,33.7,18.5,1182865,670742,320785,28160,6032,286593,191338,34737,34052,19309,9235,811,174,8250,5508,670247,484482,123866,84557,39309,61899,1927,59972,16290,13597,2693,392,2301,41145,35632,26063,1
7,0,1,1,13.9,36.1,29.1,20.9,1528522,1041709,244091,25023,6259,212809,242722,37865,40368,27511,6446,661,165,5620,6410,658935,459128,108132,72760,35372,91675,-1965,93640,16879,12624,4255,306,3949,39039,36369,23712,1
7,0,7,11,17,37.9,30.6,14.5,23572,532905,303447,34367,6479,262601,157332,31903,31147,16704,9512,1077,203,8231,4932,589765,415390,113253,80407,32846,61122,184,60938,15495,12281,3214,705,2509,38062,33824,24288,0
7,0,2,2,13.8,33,32.5,20.7,1931649,1092227,458827,40778,7030,411019,380595,56299,34311,19400,8150,724,125,7301,6760,719943,465253,112350,75833,36517,142340,12338,130002,21482,14521,6961,923,6038,33514,32040,21531,8
7,0,1,1,8.6,27.4,28.8,35.3,4090143,2702496,363508,23948,7195,332365,1024139,66591,61422,40584,5459,360,108,4991,15380,1563146,1029081,222590,147281,75309,311475,-15341,326816,33708,23324,10384,1048,9336,46373,44121,35006,17
7,0,2,2,10.4,30.6,30.7,28.3,2973578,1853749,579859,40525,8870,530464,539970,75758,39251,24469,7654,535,117,7002,7128,1033521,700208,163358,109436,53922,169955,-4418,174373,29755,20289,9466,1220,8246,34734,34512,21146,7
7,0,1,1,6.3,22.4,32.7,38.7,6564332,4847350,629396,51551,11780,566065,1087586,133376,49217,36343,4719,387,88,4244,8154,2991530,2153641,570987,404128,166859,266902,-3832,270734,55593,43373,12220,181,12039,53811,49654,22488,5
7,0,1,1,7.1,26.2,28.8,37.9,4873271,3438421,596858,33829,12637,550392,837992,100344,48566,34266,5948,337,126,5485,8351,2651807,1937904,409009,263340,145669,304894,5265,299629,62307,49085,13222,511,12711,42560,39481,23572,15
7,0,1,1,11.4,28,33.4,27.2,3887469,2543018,623344,74059,12812,536473,721107,85251,45600,29830,7312,869,150,6293,8459,1795556,1305765,291927,194834,97093,197864,7528,190336,37098,28666,8432,260,8172,48400,45551,23291,1
7,0,1,1,6.1,8,11.8,74.1,17406,14231522,785006,60487,15258,709261,3659398,221729,84229,64184,3540,273,69,3199,16504,20468349,15148384,3371867,2259658,1112209,1948098,0,1948098,212248,183283,28965,0,28965,96436,82650,67257,51
7,0,2,2,15,31.8,30,23.2,3886837,2103427,913227,124370,16793,772064,870183,98098,39622,21442,9309,1268,171,7870,8871,4117480,3086691,704336,457186,247150,326453,0,326453,80666,71627,9039,0,9039,51044,43094,36116,10
7,0,1,1,14,29.3,34.8,21.9,3495170,2005218,840679,127230,18596,694853,649273,96465,36233,20787,8715,1319,193,7203,6731,3602306,2619082,879297,657345,221952,103927,0,103927,58573,51486,7087,0,7087,61501,50870,14664,6
7,0,1,1,8.6,11.9,17.7,61.8,12111454,8803589,649396,64582,19454,565360,2658469,147528,82096,59674,4402,438,132,3832,18020,10183159,7124708,1547141,1010887,536254,1511310,0,1511310,122492,101270,21222,0,21222,83133,70354,71214,30
7,0,1,1,9.3,27.5,37.5,25.6,5172570,3087448,1080909,129796,25392,925721,1004213,137099,37729,22520,7884,947,185,6752,7325,4176014,3093590,911054,654348,256706,171370,0,171370,76460,66628,9832,0,9832,54617,46431,17430,3
7,0,1,1,10.7,27.8,36.6,24.8,6905478,4302405,1288872,191297,29488,1068087,1314201,180100,38342,23889,7156,1062,164,5931,7297,7111851,5238214,1440942,1031341,409601,432695,0,432695,119956,105905,14051,0,14051,59287,49461,30795,18
7,0,1,1,8,25.7,34.8,31.5,10083797,6989502,1383696,138846,30156,1214694,1710599,228100,44208,30642,6066,609,132,5325,7499,5472005,4137814,917322,605181,312141,416869,1938,414931,122642,102009,20633,208,20425,44618,40563,20315,12
7,0,1,1,6.5,12.9,20.8,59.8,23089076,18880440,1019831,73104,30891,915836,3188805,338275,68255,55814,3015,216,91,2707,9427,11783343,9026629,1719088,1092733,626355,1037626,-15109,1052735,195925,151431,44494,1197,43297,60142,59609,24314,403
8,0,3,2,16.9,32.5,33.7,16.9,3279165,1782298,1020058,103364,9664,907030,476809,103865,31571,17160,9821,995,93,8733,4591,1801313,1255441,305581,206993,98588,240291,15052,225239,48600,37430,11170,775,10395,37064,33541,21668,4
8,0,3,2,10.1,24.5,30.6,34.9,4846318,3087881,843264,108140,11705,723419,915173,151445,32001,20389,5568,714,77,4777,6043,2702290,1919080,515956,371664,144292,267254,14852,252402,73933,57982,15951,280,15671,36551,33098,16106,34
8,0,3,2,17.5,29.9,31.8,20.9,4097985,2476432,964716,98217,11911,854588,656837,119539,34282,20717,8070,822,100,7149,5495,2698012,1962345,483209,332921,150288,252458,25620,226838,62671,49342,13329,1120,12209,43050,39770,18580,9
8,0,3,2,16.8,32.2,33.1,17.9,3729885,2010980,1060336,122204,12246,925886,658569,116482,32021,17264,9103,1049,105,7949,5654,2412482,1719093,475099,340793,134306,218290,25788,192502,58415,47679,10736,535,10201,41299,36056,18871,10
8,0,1,1,7.9,20.9,28.9,42.2,9385940,6656334,1186235,83543,15049,1087643,1543371,203897,46033,32646,5818,410,74,5334,7569,5474692,4007808,830552,541639,288913,636332,5124,631208,112349,86259,26090,347,25743,48729,46462,24520,30
8,0,2,2,14.3,25.6,27.8,32.3,8638127,4953903,1870785,307912,24035,1538838,1813439,227927,37899,21735,8208,1351,105,6751,7956,8148227,6035128,1557858,1092837,465021,555241,62596,492645,169641,141828,27813,530,27283,48032,42552,18057,11
8,0,2,2,9.2,21.1,29.2,40.6,15222150,9912799,2323453,220130,31282,2072041,2985898,346373,43947,28619,6708,636,90,5982,8620,13839548,10575035,2471742,1658227,813515,792771,27006,765765,237808,197280,40528,911,39617,58196,53604,19329,177
8,0,9,8,15.8,47.7,24.2,12.3,149128,89483,43683,3807,973,38903,15962,5193,28717,17231,8412,733,187,7491,3074,154330,121783,27423,17786,9637,5124,381,4743,2834,2479,355,80,275,54457,49126,17247,0
8,0,9,8,18.9,40.7,24.7,15.7,199129,93610,74407,7087,1141,66179,31112,8054,24724,11623,9239,880,142,8217,3863,58313,31442,9981,7490,2491,16890,1038,15852,2790,1256,1534,599,935,20901,25033,16954,0
8,0,9,10,16.5,43.7,26.8,13.1,205553,87374,85503,7009,1181,77313,32676,7981,25755,10948,10713,878,148,9687,4094,80389,46413,13358,9336,4022,20618,2134,18484,3550,1851,1699,553,1146,22645,25075,16129,1
8,0,8,7,19.3,41.8,23.9,15,228696,125873,72067,9172,1291,61604,30756,7284,31397,17281,9894,1259,177,8457,4222,92933,46755,12390,8693,3697,33788,24393,9395,2234,1503,731,235,496,41599,31108,18942,0
8,0,8,7,17.2,42.4,26.6,13.8,283537,172200,78498,6763,1315,70420,32839,8377,33847,20556,9371,807,157,8406,3920,127639,56900,13863,9123,4740,56876,43144,13732,2878,1838,1040,383,657,44350,30958,20901,0
8,0,6,6,22,40.7,27.1,10.2,283141,151858,95957,10803,1413,83741,35326,10907,25960,13923,8798,990,130,7678,3239,159877,94504,26698,18969,7729,38675,20983,17692,4795,3310,1485,560,925,33342,28551,19126,0
8,0,7,9,14.2,44.7,24,17,249160,124639,91286,9682,1416,80188,33235,8774,28398,14205,10404,1103,161,9139,3788,132847,87994,22382,14727,7655,22471,10030,12441,3655,2594,1061,321,740,36347,33922,16812,0
8,0,6,6,16.9,42.4,26.7,14.1,219764,101196,90364,9020,1574,79770,28204,7887,27864,12831,11457,1144,200,10114,3576,113723,86439,21790,14228,7562,5494,456,5038,3515,2886,629,77,552,32354,29951,9127,0
8,0,9,9,15.5,39.4,32.9,12.1,306336,134207,127092,9356,1683,116053,45037,12171,25169,11027,10442,769,138,9535,3700,102904,61678,17841,12947,4894,23385,8589,14796,3783,2205,1578,695,883,27202,27972,16757,0
8,0,7,9,30,39.3,22.3,8.4,297061,167611,93405,16709,1707,74989,36045,10012,29670,16741,9329,1669,170,7490,3600,170636,75212,19927,14025,5902,75497,53975,21522,3418,2339,1079,205,874,49923,32156,24625,1
8,0,9,10,16.7,36.3,32,14.9,306919,158722,98564,9302,1759,87503,49633,11110,27625,14286,8872,837,158,7876,4467,126986,72873,19503,13565,5938,34610,12726,21884,3957,2556,1401,307,1094,32091,28511,20004,0
8,0,2,2,16.6,40.3,30.1,12.9,321563,187808,92507,8685,1907,81915,41248,10329,31132,18183,8956,841,185,7931,3993,84666,45812,12251,8331,3920,26603,10104,16499,2899,1471,1428,384,1044,29205,31143,15804,0
8,0,7,9,18.6,42.2,24.8,14.4,352888,185604,125911,13271,1927,110713,41373,11120,31735,16691,11323,1193,173,9956,3721,180535,115696,30560,20775,9785,34279,15923,18356,4756,3660,1096,170,926,37959,31611,19823,0
8,0,6,6,18.7,35,31.1,15.3,413805,247279,120017,13471,1957,104589,46509,13555,30528,18243,8854,994,144,7716,3431,345921,222462,61501,42500,19001,61958,38637,23321,9046,7469,1577,496,1081,38240,29785,21574,0
8,0,2,2,20.4,45.9,22.2,11.6,463231,280121,122461,12288,1969,108204,60649,15674,29554,17872,7813,784,126,6903,3869,202168,107556,29457,20503,8954,65155,37434,27721,6559,3635,2924,1143,1781,30823,29589,15565,0
8,0,8,7,21.2,36.9,29.6,12.3,240779,115570,88850,7112,1997,79741,36359,9249,26033,12495,9606,769,216,8622,3931,92122,48199,13383,9438,3945,30540,14677,15863,3054,1780,1274,410,864,30164,27078,18360,0
8,0,9,9,23.2,33.6,29.8,13.4,324980,124659,138525,10956,2020,125549,61796,12422,26162,10035,11152,882,163,10107,4975,125444,74054,20431,14390,6041,30959,8863,22096,4843,2798,2045,489,1556,25902,26467,14201,0
8,0,9,10,17.1,37.9,32.1,12.9,362068,169115,142754,10326,2062,130366,50199,13400,27020,12621,10653,771,154,9729,3746,170642,103785,29100,20757,8343,37757,10382,27375,5529,3485,2044,585,1459,30863,29780,18763,0
8,0,3,2,14.9,40.4,34.4,10.3,383111,216043,120054,11354,2127,106573,47014,12741,30069,16957,9423,891,167,8365,3690,253670,181776,41006,27158,13848,30888,15010,15878,5302,3978,1324,404,920,47844,45695,17259,1
8,0,7,9,19.8,40.8,26.2,13.2,410023,233875,130915,18127,2210,110578,45233,11347,36135,20611,11537,1598,195,9745,3986,233946,112323,28314,18968,9346,93309,72704,20605,4855,3665,1190,290,900,48187,30647,22894,0
8,0,6,6,28.2,34.8,26.3,10.6,462665,287475,126542,16197,2314,108031,48648,17322,26710,16596,7305,935,134,6237,2808,260294,162735,46182,30966,15216,51377,30905,20472,7019,5494,1525,498,1027,37084,29620,19934,0
8,0,9,10,13.8,37.6,32.6,16,432229,180861,178329,13308,2380,162641,73039,16442,26288,11000,10846,809,145,9892,4442,172359,114978,35146,25017,10129,22235,-332,22567,6065,3957,2108,441,1667,28419,29057,13537,1
8,0,6,6,19.1,40,29.6,11.3,521112,294201,156604,14200,2529,139875,70307,17900,29112,16436,8749,793,141,7814,3928,245474,163321,48860,36090,12770,33293,12452,20841,6915,4828,2087,754,1333,35499,33828,15635,1
8,0,2,2,9.9,42.5,28.6,19,589522,379525,140900,11541,2647,126712,69097,18035,32688,21044,7813,640,147,7026,3831,211044,143234,35370,23845,11525,32440,4675,27765,5971,4176,1795,239,1556,35345,34299,17844,1
8,0,7,9,17.2,42.1,30.2,10.5,476741,196215,212338,16872,2775,192691,68188,17042,27974,11514,12460,990,163,11307,4001,180273,109965,28714,19924,8790,41594,7314,34280,6518,4017,2501,595,1906,27658,27375,17985,0
8,0,6,5,21.1,42.8,22.4,13.7,621414,356428,188302,18950,2829,166523,76684,21779,28533,16366,8646,870,130,7646,3521,327215,202555,56705,39862,16843,67955,37639,30316,9599,7075,2524,703,1821,34088,28630,16648,0
8,0,7,11,14.8,39.7,33,12.5,534076,265156,191368,18279,2923,170166,77552,20344,26252,13034,9407,898,144,8364,3812,303367,186684,52983,37351,15632,63700,24983,38717,9671,6462,3209,820,2389,31369,28890,16206,0
8,0,8,6,15.2,45.5,26.4,12.9,467758,209295,178028,12721,2984,162323,80435,16972,27561,12332,10490,750,176,9564,4739,223337,158441,38835,27401,11434,26061,240,25821,6292,4097,2195,538,1657,35495,38672,15583,0
8,0,6,4,19.6,43.6,23,13.8,584610,350292,164243,19757,3067,141419,70075,17511,33385,20004,9379,1128,175,8076,4002,311938,176814,44701,30448,14253,90423,47927,42496,7956,5499,2457,301,2156,39208,32154,19711,1
8,0,6,6,16,39.7,28.8,15.5,507385,269710,171221,15943,3107,152171,66454,17050,29759,15819,10042,935,182,8925,3898,255034,135389,37229,25902,11327,82416,42134,40282,6751,4617,2134,502,1632,37777,29324,24683,1
8,0,7,9,17.5,36.3,31.7,14.5,502233,249656,190352,16842,3163,170347,62225,17625,28495,14165,10800,956,179,9665,3530,241422,143704,39909,27620,12289,57809,15437,42372,7511,5149,2362,621,1741,32142,27909,24338,0
8,0,6,6,17.4,39,29.5,14.1,781825,528324,165460,18492,3262,143706,88041,18746,41706,28183,8826,986,174,7666,4697,663463,390818,95255,62342,32913,177390,104906,72484,12911,10475,2436,402,2034,51387,37310,35636,10
8,0,6,6,16.2,44.4,27.3,12,659470,354398,225477,21338,3409,200730,79595,22011,29961,16101,10244,969,155,9120,3616,314612,186728,50879,35587,15292,77005,41532,35473,8632,5992,2640,878,1762,36447,31163,20132,1
8,0,6,6,22.6,43.2,25,9.2,596248,366149,168805,17711,3418,147676,61294,17730,33629,20651,9521,999,193,8329,3457,410542,200734,51125,35244,15881,158683,50008,108675,7416,5808,1608,385,1223,55359,34562,88859,1
8,0,6,6,19.9,39,28,13.1,616874,343090,197612,26389,3487,167736,76172,22430,27502,15296,8810,1177,155,7478,3396,413101,284169,74683,51738,22945,54249,26459,27790,10611,8501,2110,677,1433,38931,33428,19393,2
8,0,6,6,14.3,35.9,30.5,19.3,770537,397512,232596,19940,3514,209142,140429,27771,27746,14314,8375,718,127,7531,5057,446245,299834,80212,54922,25290,66199,21649,44550,15364,10740,4624,996,3628,29045,27918,12279,0
8,0,6,6,14.8,43.8,25.6,15.8,738300,434342,205811,19763,3743,182305,98147,21071,35039,20613,9768,938,178,8652,4658,413962,260559,64513,43917,20596,88890,51491,37399,10232,7427,2805,748,2057,40458,35083,18181,0
8,0,7,9,20.5,43.3,20.5,15.7,678102,394788,205173,23516,3831,177826,78141,25901,26181,15242,7921,908,148,6866,3017,404570,275413,72506,49874,22632,56651,17468,39183,11504,9129,2375,577,1798,35168,30169,21793,0
8,0,6,6,16.8,38.1,26.6,18.5,616804,363644,175252,19138,3840,152274,77908,18672,33034,19475,9386,1025,206,8155,4172,379055,220948,59763,42154,17609,98344,42810,55534,9167,7138,2029,281,1748,41350,30954,31770,0
8,0,7,8,15.2,40.4,22.9,21.5,807005,458986,225210,26465,3999,194746,122809,24247,33283,18930,9288,1091,165,8032,5065,494652,332680,85664,59410,26254,76308,8804,67504,11795,9157,2638,249,2389,41937,36331,28256,0
8,0,3,2,20.5,43.1,26.7,9.8,740750,417613,246962,30989,4055,211918,76175,24172,30645,17277,10217,1282,168,8767,3151,370258,190524,46894,31608,15286,132840,75348,57492,8232,5774,2458,357,2101,44978,32997,27364,0
8,0,6,3,24.2,31.1,33.4,11.3,619195,326442,218537,44707,4182,169648,74216,20443,30289,15968,10690,2187,205,8299,3630,363245,210656,54840,37584,17256,97749,57156,40593,8735,6774,1961,262,1699,41585,31098,23892,0
8,0,6,6,15.6,39.2,29.3,15.9,859798,448773,253566,16205,4529,232832,157459,25638,33536,17504,9890,632,177,9082,6142,381963,241537,63857,43415,20442,76569,3785,72784,11881,7646,4235,722,3513,32149,31590,20718,0
8,0,7,8,11.8,31.7,30.1,26.4,686409,387349,203521,17162,4559,181800,95539,22574,30407,17159,9016,760,202,8054,4232,447743,326836,87345,60609,26736,33562,4891,28671,12731,10356,2375,342,2033,35170,31560,14103,3
8,0,7,11,17,41.5,28.1,13.4,680216,385705,222644,23283,4673,194688,71867,21281,31964,18124,10462,1094,220,9148,3377,452736,316620,75664,49558,26106,60452,23554,36898,10199,8057,2142,346,1796,44390,39298,20545,0
8,0,7,8,14.8,42.1,27.8,15.3,799563,446249,251138,30254,4706,216178,102176,24941,32058,17892,10069,1213,189,8668,4097,383142,258031,71320,50978,20342,53791,2246,51545,10257,8161,2096,163,1933,37354,31618,26666,0
8,0,6,3,21.3,39.4,29.8,9.5,704801,377917,243770,44093,4892,194785,83114,27491,25638,13747,8867,1604,178,7085,3023,467416,287444,80386,56480,23906,99586,52761,46825,11491,8644,2847,285,2562,40677,33254,18277,1
8,0,6,5,14.4,41.4,30.4,13.8,885681,470805,295850,28302,5074,262474,119026,33506,26434,14051,8830,845,151,7834,3552,421726,298646,79873,54788,25085,43207,-264,43471,11977,9064,2913,492,2421,35211,32949,17956,0
8,0,7,8,14.8,32.4,36.6,16.2,1140582,618557,347035,28992,5589,312454,174990,37305,30575,16581,9303,777,150,8376,4691,733252,520726,134066,92699,41367,78460,6338,72122,20222,14881,5341,1176,4165,36260,34993,17316,0
8,0,7,8,12.7,35.2,33.7,18.4,1288755,562409,480223,26849,6044,447330,246123,40976,31451,13725,11720,655,148,10917,6007,706225,509889,128921,87535,41386,67415,-2014,69429,20605,15214,5391,494,4897,34274,33514,14178,0
8,0,3,2,14.9,36.8,32.5,15.8,1264916,743253,343504,47357,6683,289464,178159,43456,29108,17104,7905,1090,154,6661,4100,706987,499454,118045,78921,39124,89488,-1893,91381,18127,13892,4235,472,3763,39002,35953,24284,0
8,0,7,8,14.9,37.6,29.5,18,1111265,623740,342949,30323,6700,305926,144576,36834,30170,16934,9311,823,182,8306,3925,794632,538128,140526,95677,44849,115978,30929,85049,19912,15691,4221,908,3313,39907,34295,25671,1
8,0,7,8,16.1,36.3,27.5,20.1,1736908,1046446,390541,41809,6711,342021,299921,40593,42788,25779,9621,1030,165,8426,7388,1351542,829228,203858,139780,64078,318456,2715,315741,24668,18903,5765,253,5512,54789,43868,57282,0
8,0,4,5,13.4,42.5,28,16.1,1349327,816783,368825,37734,7811,323280,163719,43145,31274,18931,8548,875,181,7493,3795,858680,549628,145218,96779,48439,163834,48158,115676,19950,15752,4198,644,3554,43042,34893,32548,2
8,0,2,2,11.5,34.3,34.1,20.1,2473343,1629635,517813,47715,9510,460588,325895,70651,35008,23066,7329,675,135,6519,4613,756274,475309,111889,73818,38071,169076,44758,124318,21791,14747,7044,660,6384,34706,32231,19473,6
8,0,1,1,18.6,35.7,28.8,16.9,1647567,1014146,452937,85674,9959,357304,180484,49731,33130,20393,9108,1723,200,7185,3629,939987,588833,150653,100351,50302,200501,53961,146540,23163,17777,5386,228,5158,40581,33123,28410,0
8,0,2,2,14.1,39.2,32.1,14.5,1792107,1076582,511444,50475,10006,450963,204081,61664,29062,17459,8294,819,162,7313,3310,974742,708369,173536,114493,59043,92837,16876,75961,26365,20599,5766,802,4964,36971,34389,15302,0
8,0,4,3,17.7,39.2,31,12.2,1323776,757042,409622,65791,10345,333486,157112,44676,29631,16945,9169,1473,232,7465,3517,1132624,828008,196786,129979,66807,107830,34064,73766,23480,20162,3318,288,3030,48238,41068,24345,4
8,0,5,8,16,34.1,27.7,22.2,1922861,1191354,489819,44329,10438,435052,241688,62542,30745,19049,7832,709,167,6956,3864,1439741,1038067,266344,181380,84964,135330,43648,91682,35622,29068,6554,885,5669,40417,35712,16173,1
8,0,4,5,15.4,38.4,25.4,20.8,2431165,1466850,631708,59660,13102,558946,332607,78471,30982,18693,8050,760,167,7123,4239,1356320,974544,230054,152349,77705,151722,-1202,152924,36630,27377,9253,1675,7578,37028,35597,20180,1
8,0,3,2,11.8,30.9,37.2,20.1,3272745,1638724,1009170,84864,14753,909553,624851,97627,33523,16786,10337,869,151,9317,6400,1856996,1297094,307338,202057,105281,252564,3077,249487,51640,38904,12736,316,12420,35960,33341,20088,8
8,0,2,2,9.9,32.1,32.5,25.5,4123374,2700759,920530,64504,14882,841144,502085,113276,36401,23842,8126,569,131,7426,4432,1229028,788105,186971,123684,63287,253952,655,253297,35111,23728,11383,344,11039,35004,33214,22946,3
8,0,3,2,14.7,38.2,30.3,16.8,2303983,1319050,689173,104758,16326,568089,295760,73163,31491,18029,9420,1432,223,7765,4042,1783447,1250147,341033,236717,104316,192267,92673,99594,38619,32421,6198,373,5825,46181,38560,17098,0
8,0,3,2,11.7,33.2,28.5,26.5,3433665,2218832,802618,90060,16548,696010,412215,101513,33825,21858,7907,887,163,6856,4061,2638479,1755263,429282,287113,142169,453934,95418,358516,60930,49062,11868,515,11353,43303,35776,31579,6
8,0,2,2,8.8,30.5,31,29.7,3930312,2629477,821691,74029,21449,726213,479144,119096,33001,22079,6899,622,180,6098,4023,2370196,1750522,396212,259706,136506,223462,-177,223639,57625,44841,12784,1181,11603,41131,39038,19274,7
8,0,2,2,17.4,31.8,31.7,19,4628430,2847435,1021628,109388,21805,890435,759367,127067,36425,22409,8040,861,172,7008,5976,3945069,2727983,645570,427938,217632,571516,18929,552587,83027,68869,14158,701,13457,47515,39611,41063,6
8,0,2,2,15.8,26.6,25.7,31.9,7092314,4729446,1248812,146826,28393,1073593,1114056,215525,32907,21944,5794,681,132,4981,5169,5824020,4275879,1005016,678922,326094,543125,71448,471677,130924,103565,27359,2241,25118,44484,41287,18778,35
8,0,2,2,12.5,29.7,26.1,31.7,15131106,6596592,1439102,125032,30380,1283690,7095412,238902,63336,27612,6024,523,127,5373,29700,7417656,5780647,1134627,718601,416026,502382,81988,420394,132475,107347,25128,1896,23232,55993,53850,18095,19
8,0,2,2,9.6,26.5,30.2,33.7,17021959,10601843,3228705,391835,60397,2776473,3191411,391068,43527,27110,8256,1002,154,7100,8161,16700477,12461330,3006274,2021467,984807,1232873,26691,1206182,315352,269178,46174,366,45808,52958,46294,26331,35
8,0,7,9,10.3,37,40.5,12.1,312265,210438,72618,4255,713,67650,29209,8892,35118,23666,8167,479,80,7608,3285,437367,351467,74600,48610,25990,11300,1973,9327,6078,5575,503,136,367,71959,63043,25414,1
8,0,6,4,22.8,37,29,11.2,554562,243684,205308,18299,1737,185272,105570,20479,27080,11899,10025,894,85,9047,5155,294221,194603,55538,40392,15146,44080,5578,38502,7439,5975,1464,115,1349,39551,32570,28541,0
8,0,7,8,14.2,31.3,40.4,14.1,1041085,577408,334061,29904,2864,301293,129616,37419,27822,15431,8928,799,77,8052,3464,530733,362301,100012,73078,26934,68420,18953,49467,11764,9462,2302,372,1930,45115,38290,25631,1
8,0,4,3,15,27.5,38.5,19,1732321,701648,681952,54399,5070,622483,348721,52982,32696,13243,12871,1027,96,11749,6582,856880,630251,167596,121064,46532,59033,-328,59361,21238,15475,5763,172,5591,40347,40727,10617,5
8,0,4,5,24.6,26.4,26.8,22.1,1466260,866009,342928,60875,7798,274255,257323,46845,31300,18487,7320,1299,166,5855,5493,988222,585042,166980,120535,46445,236200,-992,237192,19947,13636,6311,204,6107,49542,42904,38839,2
8,0,6,6,21.4,33,34.2,11.5,2020967,920300,806044,118542,10395,677107,294623,72292,27956,12730,11150,1640,144,9366,4075,1043322,761106,250479,190985,59494,31737,-4732,36469,28034,18813,9221,5554,3667,37216,40456,9945,2
8,0,3,2,12.9,23,40.5,23.6,4463184,2278326,1301223,110802,12432,1177989,883635,129332,34510,17616,10061,857,96,9108,6832,2672088,1881787,593501,436068,157433,196800,20195,176605,53141,41759,11382,956,10426,50283,45063,16939,9
8,0,4,5,17.4,30,37.1,15.5,2852808,1271637,1122095,148987,14823,958285,459076,107077,26643,11876,10479,1391,138,8949,4287,1504131,1078067,309879,221598,88281,116185,5651,110534,40610,28075,12535,3795,8740,37038,38400,12647,5
8,0,3,2,10.3,21.3,32.9,35.4,5235880,3205511,944129,102970,14980,826179,1086240,136448,38373,23493,6919,755,110,6055,7961,3459515,2460489,709107,525800,183307,289919,451,289468,80103,63743,16360,2208,14152,43188,38600,20454,52
8,0,3,2,9.8,25.9,39.3,25,6845763,2880524,2191860,129454,17808,2044598,1773379,214198,31960,13448,10233,604,83,9545,8279,3065096,2128646,532001,372414,159587,404449,-2641,407090,90104,58574,31530,839,30691,34017,36341,13264,24
8,0,3,2,15.3,35.6,36.8,12.3,5433435,2614045,1924013,173860,19723,1730430,895377,203026,26762,12875,9477,856,97,8523,4410,2451452,1691050,428819,299397,129422,331583,170,331413,63999,46810,17189,283,16906,38305,36126,19603,5
8,0,1,1,14.8,29.9,36.8,18.6,10027602,5950762,2786254,258285,29408,2498561,1290586,384258,26096,15486,7251,672,77,6502,3359,3565061,2341500,650473,472801,177672,573088,125455,447633,86662,59677,26985,783,26202,41138,39236,17084,40
8,0,3,2,28.4,26,31.3,14.3,5929784,3655153,1389263,211515,60871,1116877,885368,201810,29383,18112,6884,1048,302,5534,4387,4044401,2537239,738308,523234,215074,768854,368474,400380,83072,69473,13599,448,13151,48685,36521,30445,9
8,0,2,2,11.8,22.5,34.1,31.6,36601437,20720966,8293936,787349,78188,7428399,7586535,994759,36794,20830,8338,791,79,7468,7627,23320528,16448115,4197381,2972306,1225075,2675032,25304,2649728,489825,382749,107076,736,106340,47610,42974,24918,567
8,0,1,1,12.9,22.8,32.9,31.4,158054524,102782341,27141145,2815741,314983,24010421,28131038,4006307,39451,25655,6775,703,79,5993,7022,118614257,89147106,18851267,12411999,6439268,10615884,138221,10477663,2289203,1797704,491499,2147,489352,51815,49589,21411,1504
8,0,8,4,10.2,34.2,30,25.6,67205,37600,13112,1187,273,11652,16493,1127,59632,33363,11634,1053,242,10339,14634,57335,40497,10422,8268,2154,6416,0,6416,1059,890,169,0,169,54141,45502,37964,2
8,0,8,7,7.1,25.4,46.1,21.4,112628,55949,28753,2531,1179,25043,27926,3030,37171,18465,9489,835,389,8265,9217,36017,19591,9630,8422,1208,6796,1981,4815,1074,592,482,37,445,33535,33093,10820,1
8,0,6,6,14.5,30.5,38.5,16.6,351881,168551,108552,10062,2641,95849,74778,9154,38440,18413,11858,1099,289,10471,8169,185665,94347,39121,32121,7000,52197,29237,22960,4214,2740,1474,359,1115,44059,34433,20592,0
8,0,8,6,10.2,31.9,38.4,19.5,405426,144785,155816,13282,3870,138664,104825,13422,30206,10787,11609,990,288,10331,7810,172158,96565,41625,34965,6660,33968,-3642,37610,4717,2816,1901,218,1683,36497,34292,22347,0
8,0,7,11,11.4,30.3,33,25.3,878349,534893,178249,13518,5106,159625,165207,18377,47796,29107,9700,736,278,8686,8990,629155,329154,124367,103600,20767,175634,10150,165484,10449,7901,2548,88,2460,60212,41660,67270,1
8,0,7,11,15.3,18.9,34.3,31.5,591704,362091,61356,5861,5284,50211,168257,13997,42274,25869,4384,419,378,3587,12021,450681,268799,84729,65037,19692,97153,16820,80333,9577,7307,2270,61,2209,47059,36787,36366,1
8,0,8,7,9.9,28.2,37.5,24.4,698504,370268,184762,12155,5974,166633,143474,17820,39198,20778,10368,682,335,9351,8051,315183,185716,67765,54161,13604,61702,1688,60014,7835,5488,2347,318,2029,40228,33840,29578,11
8,0,7,12,6.4,25.5,45.5,22.6,816117,379625,221206,15180,7574,198452,215286,18899,43183,20087,11705,803,401,10501,11391,434114,253539,96567,77573,18994,84008,1700,82308,9488,6366,3122,106,3016,45754,39827,27290,0
8,0,7,8,18.4,32.1,35.1,14.4,853296,421248,285599,40231,8035,237333,146449,27830,30661,15136,10262,1446,289,8528,5262,503780,300697,125381,106482,18899,77702,11248,66454,10541,8301,2240,101,2139,47792,36224,31068,1
8,0,7,8,17.7,32.4,37.5,12.4,980956,551611,242783,25204,8100,209479,186562,32135,30526,17165,7555,784,252,6519,5806,704615,445804,199597,170056,29541,59214,18636,40578,12699,10437,2262,385,1877,55486,42714,21619,1
8,0,6,6,27.5,27.3,32.2,13,1108967,686555,241440,29503,9086,202851,180972,27866,39796,24638,8664,1059,326,7280,6494,697193,312435,105159,80602,24557,279599,206826,72773,12102,8616,3486,1135,2351,57610,36262,30954,0
8,0,6,4,10.3,27.1,40.6,22.1,1381381,729231,348484,20120,11233,317131,303666,36635,37707,19905,9512,549,307,8657,8289,787879,484723,174161,142884,31277,128995,16017,112978,16939,11764,5175,390,4785,46513,41204,23611,2
8,0,6,6,10,27.6,43.1,19.3,1729741,845367,456256,32176,13359,410721,428118,44667,38725,18926,10215,720,299,9195,9585,573132,307146,110787,89569,21218,155199,6729,148470,15334,8573,6761,577,6184,37377,35827,24009,4
8,0,6,4,30.6,23.2,30.5,15.7,960588,662167,151920,16990,15021,119909,146501,21336,45022,31035,7120,796,704,5620,6866,770000,338364,106743,80431,26312,324893,248661,76232,11264,8834,2430,677,1753,68359,38302,43487,0
8,0,4,5,9.3,29.2,41,20.6,2028746,974665,568569,39312,15707,513550,485512,54018,37557,18043,10526,728,291,9507,8988,1036973,660916,226002,180572,45430,150055,-3171,153226,24328,17066,7262,351,6911,42625,38727,22171,13
8,0,6,6,10.7,25.1,41.5,22.7,1569469,692595,524524,53149,15803,455572,352350,43543,36044,15906,12046,1221,363,10463,8092,809536,474090,170665,133997,36668,164781,55853,108928,19779,13285,6494,777,5717,40929,35686,19053,5
8,0,4,5,16,32.4,37.3,14.4,2045994,1046865,600363,74619,16837,508907,398766,62916,32519,16639,9542,1186,268,8089,6338,1022234,631988,200641,152691,47950,189605,63080,126525,22875,16761,6114,1533,4581,44688,37706,27620,4
8,0,4,5,15.3,30.3,39.1,15.3,2189009,1072824,717202,82403,20533,614266,398983,63855,34281,16801,11232,1290,322,9620,6248,953671,549323,189230,149703,39527,215118,49303,165815,23409,15859,7550,729,6821,40740,34638,24309,8
8,0,4,5,13.1,26.2,35.9,24.8,3513109,1819279,903552,95519,20890,787143,790278,87164,40305,20872,10366,1096,240,9031,9067,2038795,1146860,370918,286886,84032,521017,45048,475969,47683,32427,15256,1033,14223,42757,35367,33465,12
8,0,1,1,20.9,24.7,35.2,19.2,2312966,1597164,341937,40062,21987,279888,373865,57370,40317,27840,5960,698,383,4879,6517,1092656,644067,199598,150829,48769,248991,60878,188113,22146,15829,6317,540,5777,49339,40689,32562,44
8,0,3,2,17.9,24.6,41.2,16.4,2495749,1391981,747573,103958,24974,618641,356195,73159,34114,19027,10218,1421,341,8456,4869,1582975,1014057,396850,315594,81256,172068,54844,117224,27056,21267,5789,694,5095,58507,47682,23008,5
8,0,4,3,6.5,18.5,39.2,35.8,4951410,2867011,906192,53643,29279,823270,1178207,97992,50529,29258,9248,547,299,8401,12024,2333540,1267133,375662,283738,91924,690745,1288,689457,51438,30909,20529,662,19867,45366,40996,34704,51
8,0,5,8,9.5,24,37.1,29.4,5228584,2945123,1229248,133577,30732,1064939,1054213,134444,38890,21906,9143,994,229,7921,7841,3250231,1785327,606293,480376,125917,858611,114336,744275,68413,48966,19447,809,18638,47509,36461,39933,8