Year since Katrina,Affected by Katrina,Rural-urban Continuum Code ,Urban Influence Code,Percent of adults with less than a high school diploma,Percent of adults with a high school diploma only,Percent of adults completing some college or associate's degree,Percent of adults with a bachelor's degree or higher,Personal income (thousands of dollars), Net earnings by place of residence, Personal current transfer receipts,  Income maintenance benefits,  Unemployment insurance compensation,  Retirement and other," Dividends, interest, and rent", Population (persons), Per capita personal income, Per capita net earnings, Per capita personal current transfer receipts,  Per capita income maintenance benefits,  Per capita unemployment insurance compensation,  Per capita retirement and other," Per capita dividends, interest, and rent", Earnings by place of work,  Wages and salaries,  Supplements to wages and salaries,   Employer contributions for employee pension and insurance funds,   Employer contributions for government social insurance,  Proprietors' income,   Farm proprietors' income,   Nonfarm proprietors' income,Total employment (number of jobs), Wage and salary employment, Proprietors employment,  Farm proprietors employment,  Nonfarm proprietors employment,Average earnings per job (dollars), Average wages and salaries, Average nonfarm proprietors' income,Patent Grants
3,0,9,10,14.5,39.9,31.3,14.3,241867,149068,47858,3028,438,44392,44941,6704,36078,22236,7139,452,65,6622,6704,143121,64880,16569,11501,5068,61672,53170,8502,3834,2329,1505,580,925,37329,27857,9191,1
8,0,6,6,9.7,41.1,28.3,20.8,328881,198026,67194,7386,436,59372,63661,10282,31986,19259,6535,718,42,5774,6191,173613,92399,22827,15899,6928,58387,18769,39618,5301,3090,2211,570,1641,32751,29903,24143,0
7,0,6,6,15.3,37.5,30.1,17.1,335363,192126,90191,8763,1009,80419,53046,9348,35875,20553,9648,937,108,8603,5675,170624,85371,24157,16928,7229,61096,35204,25892,4264,2626,1638,594,1044,40015,32510,24801,0
7,0,3,2,8.4,37.2,34.1,20.3,701461,470825,125272,10308,5060,109904,105364,16493,42531,28547,7595,625,307,6664,6388,429503,268612,78472,60291,18181,82419,41285,41134,7412,5559,1853,420,1433,57947,48320,28705,0
5,0,3,2,11.1,36.8,31.8,20.4,2571457,1462731,740432,74985,42319,623128,368294,82750,31075,17677,8948,906,511,7530,4451,2032864,1559693,374944,259160,115784,98227,59,98168,44555,37275,7280,452,6828,45626,41843,14377,46
9,0,3,2,14.6,33.2,33.7,18.5,1215594,688875,328055,26605,3295,298155,198664,34341,35398,20060,9553,775,96,8682,5785,744962,546432,143041,99797,43244,55489,4359,51130,16785,14103,2682,394,2288,44383,38746,22347,2
7,0,6,4,30.6,23.2,30.5,15.7,809558,510353,150504,17701,16495,116308,148701,21350,37918,23904,7049,829,773,5448,6965,600114,320295,97409,72443,24966,182410,107905,74505,10937,8526,2411,655,1756,54870,37567,42429,0
6,0,3,2,15.5,40.4,33.3,10.8,334612,212858,85751,8018,2896,74837,36003,9502,35215,22401,9025,844,305,7876,3789,139203,58059,17014,12425,4589,64130,48883,15247,3056,1923,1133,371,762,45551,30192,20009,0
8,0,4,5,22.9,34.8,29.4,12.8,3544162,1806885,1314848,220778,22082,1071988,422429,135217,26211,13363,9724,1633,163,7928,3124,1960724,1327027,362747,256882,105865,270950,70617,200333,53194,41289,11905,802,11103,36860,32140,18043,2
7,0,2,2,8.6,30.2,31.7,29.5,11243567,7626815,1539480,140832,70124,1328524,2077272,252761,44483,30174,6091,557,277,5256,8218,9628711,6889099,1819962,1277594,542368,919650,77058,842592,182467,156650,25817,1017,24800,52770,43978,33975,28
2,0,6,6,18.8,39.9,30.4,10.8,1527202,961437,375969,42826,15891,317252,189796,63560,24028,15126,5915,674,250,4991,2986,780176,534721,161872,118637,43235,83583,15249,68334,23832,16807,7025,1095,5930,32736,31815,11523,6
6,0,6,6,10,50.5,25.6,14,660500,409807,152094,14360,6125,131609,98599,19372,34096,21155,7851,741,316,6794,5090,294630,162787,50225,35875,14350,81618,46007,35611,7200,4792,2408,609,1799,40921,33971,19795,1
0,0,8,7,16.2,39.1,30.7,14,207228,135148,38953,2380,242,36331,33127,6166,33608,21918,6317,386,39,5892,5373,135550,61379,16661,11904,4757,57510,32626,24884,3957,2538,1419,423,996,34256,24184,24984,0
2,0,6,6,26.8,46.6,19.2,7.4,564935,336594,166110,20658,2882,142570,62231,23612,23926,14255,7035,875,122,6038,2636,167275,101789,32089,24578,7511,33397,6068,27329,6393,4034,2359,507,1852,26165,25233,14756,1
2,0,1,1,16.7,33.6,26.2,23.5,12731253,9032173,1900712,165744,33570,1701398,1798368,361192,35248,25007,5262,459,93,4711,4979,8371074,6170469,1490390,1028095,462295,710215,1819,708396,189362,155946,33416,839,32577,44207,39568,21745,121
5,0,7,11,17,41.5,28.1,13.4,643329,358593,214483,24081,8112,182290,70253,21833,29466,16424,9824,1103,372,8349,3218,432197,325239,74187,48082,26105,32771,1843,30928,10602,8500,2102,363,1739,40766,38263,17785,0
8,0,8,7,15.5,35.6,23.9,25,27625,33997,158,7876,4467,126986,72873,2205,39332,15418,9634,492,76,9066,14280,32973,16708,5185,3966,1219,11080,7901,3179,1323,613,710,235,475,24923,27256,6693,0
4,0,6,6,37,29.9,24,9.2,105970,75260,18335,1633,885,15817,12375,3377,31380,22286,5429,484,262,4684,3664,82509,58526,13043,9411,3632,10940,-2324,13264,2126,1422,704,108,596,38810,41158,22255,0
7,0,3,2,7.4,39.3,32,21.2,689671,459605,130503,8975,4935,116593,99563,18877,36535,24347,6913,475,261,6176,5274,203255,120934,32159,22180,9979,50162,9769,40393,6743,3722,3021,893,2128,30143,32492,18982,1
4,0,9,8,31.3,43.5,17.9,7.3,135559,78004,42712,3768,2229,36715,14843,5421,25006,14389,7879,695,411,6773,2738,167415,134276,30614,20737,9877,2525,-684,3209,3396,3041,355,88,267,49298,44155,12019,0
6,0,8,4,7.4,39.1,34.9,18.5,529306,265358,160068,10115,4658,145295,103880,15461,34235,17163,10353,654,301,9398,6719,241466,147936,55164,42891,12273,38366,4842,33524,7227,5055,2172,400,1772,33412,29265,18919,3
5,0,4,5,9.3,44.7,29.8,16.2,1216049,754473,310182,26304,19051,264827,151394,39082,31115,19305,7937,673,487,6776,3874,844843,590478,154907,105730,49177,99458,17931,81527,20528,15912,4616,973,3643,41156,37109,22379,0
7,0,9,8,6.9,36.4,28.8,27.9,167946,111681,16182,1343,161,14678,40083,2976,56433,37527,5438,451,54,4932,13469,93222,45301,10297,6815,3482,37624,23869,13755,2099,1459,640,159,481,44413,31049,28597,0
6,0,3,2,12.2,35.7,34.7,17.4,906206,550271,203270,19873,10772,172625,152665,29651,30562,18558,6855,670,363,5822,5149,240554,150646,46673,34830,11843,43235,3610,39625,7731,4734,2997,704,2293,31116,31822,17281,0
6,0,6,3,28,43.9,17.5,10.5,665283,373709,185880,31805,4437,149638,105694,27657,24055,13512,6721,1150,160,5410,3822,409633,256512,71459,51731,19728,81662,56813,24849,10912,8406,2506,810,1696,37540,30515,14652,0
6,0,7,8,16.8,32.3,31.4,19.6,857631,546457,122838,12150,972,109716,188336,17693,48473,30885,6943,687,55,6201,10645,591991,299442,77074,53938,23136,215475,132308,83167,11616,9018,2598,665,1933,50963,33205,43025,2
0,0,1,1,20.2,34.3,28.9,16.6,8106337,4630503,1773411,111780,9943,1651688,1702423,267587,30294,17305,6627,418,37,6173,6362,3874820,2757773,662959,468119,194840,454088,34223,419865,112088,85544,26544,1375,25169,34569,32238,16682,21
5,0,2,2,5.1,31,29.4,34.5,1389098,849475,271251,24871,9561,236819,268372,35235,39424,24109,7698,706,271,6721,7617,1054346,749019,215433,158752,56681,89894,3199,86695,21610,16585,5025,199,4826,48790,45162,17964,7
7,0,1,1,14.3,23.2,28.3,34.1,12490521,7735341,2904023,497382,70426,2336215,1851157,319363,39111,24221,9093,1557,221,7315,5796,18183282,13098577,2993965,2056771,937194,2090740,0,2090740,270092,238005,32087,0,32087,67323,55035,65158,96
5,0,4,5,4.8,19.6,32.4,43.1,2125626,1299695,264110,19197,19576,225337,561821,51338,41405,25316,5145,374,381,4389,10944,1499539,1040417,221384,151301,70083,237738,-8886,246624,37081,25002,12079,992,11087,40440,41613,22244,5
4,0,9,10,18,40.8,30.4,10.8,102456,59386,25448,1393,414,23641,17622,3129,32744,18979,8133,445,132,7555,5632,46526,23298,7204,5342,1862,16024,11081,4943,1696,947,749,359,390,27433,24602,12674,0
1,0,7,11,23.4,39.9,22.5,14.2,502696,280999,153743,12498,1277,139968,67954,20715,24267,13565,7422,603,62,6757,3280,314294,212383,60856,45229,15627,41055,16914,24141,11148,7592,3556,1229,2327,28193,27975,10374,2
6,0,3,2,16.5,30,33.8,19.7,4030065,2363911,1008075,128144,38010,841921,658079,124080,32480,19052,8124,1033,306,6785,5304,2573763,1799783,517426,367193,150233,256554,81800,174754,60034,50291,9743,469,9274,42872,35787,18843,5
9,0,7,9,13.4,37.8,31.3,17.5,1151945,660782,314039,20820,3046,290173,177124,30983,37180,21327,10136,672,98,9366,5717,753355,537200,137507,95146,42361,78648,11700,66948,15653,11583,4070,653,3417,48128,46378,19593,1
8,0,6,6,13.9,38.8,31.9,15.4,1249736,706635,356394,36646,3911,315837,186707,40960,30511,17252,8701,895,95,7711,4558,735831,500706,131165,87597,43568,103960,1792,102168,18317,13015,5302,1434,3868,40172,38471,26414,2
8,0,2,2,8.9,40.8,30.8,19.5,1259157,851042,233734,15592,4296,213846,174381,33280,37835,25572,7023,469,129,6426,5240,687947,457803,115920,81361,34559,114224,48800,65424,16149,11979,4170,635,3535,42600,38217,18507,20
10,0,3,2,8.7,25.6,28.8,36.9,6518729,4241880,1070216,114955,9078,946183,1206633,186076,35033,22796,5751,618,49,5085,6485,5458451,4013173,1021373,723015,298358,423905,-17807,441712,108601,92837,15764,597,15167,50262,43228,29123,188
10,0,2,2,11.2,30.8,35.3,22.7,6033232,3547249,1221334,135494,21754,1064086,1264649,146249,41253,24255,8351,926,149,7276,8647,5724571,4353587,1081582,782672,298910,289402,8188,281214,89923,77563,12360,539,11821,63661,56130,23789,30
7,0,6,3,21.7,31.9,31,15.4,2077350,1052467,672606,71664,18767,582175,352277,68927,30138,15269,9758,1040,272,8446,5111,1104846,744052,201260,144210,57050,159534,12338,147196,30319,22465,7854,832,7022,36441,33120,20962,2
10,0,5,8,32.6,25.6,23.7,18.1,1668859,1020365,392000,57698,6240,328062,256494,48906,34124,20864,8015,1180,128,6708,5245,1124260,753834,243814,182046,61768,126612,6643,119969,24326,19455,4871,379,4492,46216,38748,26707,0
2,0,3,2,20.6,32.9,27.8,18.6,32573,3357264,54,5411,6063,105563747,77268978,153969,33175,21805,5873,508,122,5243,5497,3717000,2564912,778354,584844,193510,373734,41306,332428,84923,70329,14594,675,13919,43769,36470,23883,4
6,0,6,4,12.2,42.4,31.5,13.9,1313350,709441,404940,41693,18014,345233,198969,42704,30755,16613,9482,976,422,8084,4659,622015,368544,108831,77813,31018,144640,76877,67763,17421,11288,6133,1293,4840,35705,32649,14001,4
1,0,9,8,18.6,46.6,23.2,11.6,92775,52057,29202,2158,341,26703,11516,4267,21742,12200,6844,506,80,6258,2699,32247,16792,6332,5106,1226,9123,1049,8074,1644,817,827,470,357,19615,20553,22616,0
1,0,1,1,9.9,19.8,25.9,44.4,9476184,7520271,507350,28874,8605,469871,1448563,161902,58530,46450,3134,178,53,2902,8947,6240927,3860096,739652,474586,265066,1641179,-5934,1647113,121988,86521,35467,1336,34131,51160,44615,48259,38
0,0,7,11,17.5,31.3,33.3,17.9,186892,89743,48104,2813,1582,43709,49045,7708,24246,11643,6241,365,205,5671,6363,101076,68641,20868,14797,6071,11567,-2253,13820,4409,2872,1537,304,1233,22925,23900,11208,0
6,0,6,3,11.1,35.3,35.8,17.8,1302854,835676,267927,16016,15195,236716,199251,35594,36603,23478,7527,450,427,6650,5598,781800,479136,138476,103407,35069,164188,90547,73641,16696,12563,4133,707,3426,46826,38139,21495,2
0,0,8,4,28.6,44.4,19.3,7.6,230411,160996,45373,4000,1061,40312,24042,10165,22667,15838,4464,394,104,3966,2365,101072,75324,15279,10002,5277,10469,1367,9102,3534,2576,958,363,595,28600,29241,15297,0
6,0,6,5,18.6,40.7,27.3,13.4,1609668,883914,455520,45727,11246,398547,270234,53212,30250,16611,8560,859,211,7490,5078,822199,563123,156726,109972,46754,102350,7216,95134,23951,17280,6671,1296,5375,34328,32588,17699,4
2,0,7,8,16,49.7,21.6,12.7,1341821,922959,212613,12739,3256,196618,206249,41055,32683,22481,5179,310,79,4789,5024,859532,583824,158145,113942,44203,117563,28883,88680,23977,18655,5322,1104,4218,35848,31296,21024,4
5,0,6,3,13.8,44.6,25.9,15.7,990455,614255,242291,25018,14971,202302,133909,33225,29811,18488,7292,753,451,6089,4030,565166,403487,105233,74476,30757,56446,14575,41871,14642,11357,3285,551,2734,38599,35528,15315,2
5,0,6,6,18.9,40.4,24.5,16.1,598044,312062,204071,29211,6400,168460,81911,20944,28554,14900,9744,1395,306,8043,3911,304276,206608,56810,39785,17025,40858,12862,27996,9097,7046,2051,398,1653,33448,29323,16936,1
9,0,5,8,12.8,28.6,36.6,22.1,1479571,941454,305837,30475,2368,272994,232280,36468,40572,25816,8386,836,65,7486,6369,1068967,705733,182130,124573,57557,181104,67842,113262,23638,18212,5426,759,4667,45222,38751,24269,4
6,0,3,2,4.1,32.9,34,29,1016606,666289,168712,7703,5088,155921,181605,24376,41705,27334,6921,316,209,6396,7450,560360,355113,90570,62049,28521,114677,60813,53864,14341,10301,4040,831,3209,39074,34474,16785,4
4,0,6,5,30.5,40.4,18,11.1,1145141,641035,337415,37822,20245,279348,166691,42171,27155,15201,8001,897,480,6624,3953,709988,511915,136644,96384,40260,61429,3921,57508,22887,16598,6289,1835,4454,31021,30842,12912,1
0,0,7,11,21.7,31.3,32.8,14.2,453194,327207,53837,4920,1369,47548,72150,15046,30121,21747,3578,327,91,3160,4795,368022,265984,70530,53031,17499,31508,4985,26523,9077,7329,1748,211,1537,40544,36292,17256,0
9,0,5,8,27.1,31.3,28.5,13.1,2857067,2041236,496040,57783,4254,434003,319791,69757,40957,29262,7111,828,61,6222,4584,2426926,1911043,383499,244303,139196,132384,107329,25055,41725,34948,6777,398,6379,58165,54682,3928,0
1,0,7,11,13.7,27.7,37.5,21,311234,193587,59144,3210,405,55529,58503,9658,32226,20044,6124,332,42,5750,6057,222276,136226,31980,21539,10441,54070,19075,34995,6730,4748,1982,439,1543,33028,28691,22680,1
2,0,2,2,22.3,32.7,29.9,15.1,8091367,4707909,1696982,140529,26438,1530015,1686476,266860,30321,17642,6359,527,99,5733,6320,3731830,2746803,642067,446185,195882,342960,7588,335372,102802,76613,26189,257,25932,36301,35853,12933,21
10,0,4,5,3.8,16.1,30.3,49.8,1518128,937174,212063,10654,2889,198520,368891,38036,39913,24639,5575,280,76,5219,9698,1024226,679164,244273,176992,67281,100789,18683,82106,23612,18779,4833,401,4432,43377,36166,18526,20
0,0,3,2,17.7,24.3,36.1,21.8,6170006,3736383,1321900,179197,32395,1110308,1111723,214752,28731,17399,6155,834,151,5170,5177,4015834,2446317,741983,534909,207074,827534,69322,758212,103948,79251,24697,1701,22996,38633,30868,32971,7
7,0,7,9,18.4,37,30.1,14.5,719080,360628,226453,21176,4461,200816,131999,23207,30985,15540,9758,912,192,8653,5688,373321,274728,61708,44237,17471,36885,-11282,48167,10777,6900,3877,1367,2510,34641,39816,19190,1
0,0,6,6,15.4,37,34,13.5,123314,74695,23885,1650,193,22042,24734,3925,31418,19031,6085,420,49,5616,6302,77237,42875,13029,9774,3255,21333,13312,8021,2587,1707,880,294,586,29856,25117,13688,0
0,0,9,12,11.6,31.4,34.8,22.2,30453,20608,3916,182,220,3514,5929,1069,28487,19278,3663,170,206,3287,5546,18626,10522,2741,1867,874,5363,422,4941,646,397,249,91,158,28833,26504,31272,0
8,0,3,2,9.1,37.6,32.6,20.7,582704,371492,129336,10547,3987,114802,81876,16080,36238,23103,8043,656,248,7139,5092,169348,86007,27635,20556,7079,55706,21865,33841,5916,3151,2765,899,1866,28625,27295,18136,2
7,0,2,2,9.2,23.9,28.4,38.5,9274475,5135215,2005070,184327,61694,1759049,2134190,243741,38051,21068,8226,756,253,7217,8756,6451367,4622758,1144713,779859,364854,683896,8360,675536,158726,121353,37373,878,36495,40645,38093,18510,28
7,0,1,1,12.5,23.1,29,35.3,28673078,21331877,3655909,585843,149934,2920132,3685292,839144,34169,25421,4357,698,179,3480,4392,21724701,16616043,3298261,2152320,1145941,1810397,5254,1805143,460167,332584,127583,141,127442,47210,49960,14164,336
2,0,7,8,27.5,35.6,23.3,13.7,1486271,742845,466390,35612,4125,426653,277036,54534,27254,13622,8552,653,76,7824,5080,811430,511186,128554,91528,37026,171690,-13429,185119,25958,17994,7964,759,7205,31259,28409,25693,1
3,0,4,3,29.7,31.2,26.6,12.5,1160866,738879,253424,27579,3970,221875,168563,36708,31624,20129,6904,751,108,6044,4592,685176,478943,121540,90239,31301,84693,27438,57255,16314,11745,4569,790,3779,41999,40778,15151,0
9,0,4,3,8.5,24.8,42.2,24.5,1410931,747857,373670,29757,5817,338096,289404,37421,37704,19985,9986,795,155,9035,7734,966599,650051,179445,117264,62181,137103,2908,134195,22993,17825,5168,186,4982,42039,36468,26936,7
2,0,7,11,19.9,25.2,36.1,18.8,396757,237308,78887,6553,1258,71076,80562,11320,35049,20964,6969,579,111,6279,7117,269212,161727,40887,27800,13087,66598,34784,31814,8105,6048,2057,531,1526,33216,26741,20848,3
6,0,8,7,7.9,37.8,35.1,19.2,344093,232879,51021,2595,781,47645,60193,5826,59062,39972,8757,445,134,8178,10332,230599,77925,21506,15647,5859,131168,107075,24093,3802,2459,1343,381,962,60652,31690,25045,0
10,0,2,2,31.1,25.1,30,13.8,9686983,5639662,2474035,362868,64402,2046765,1573286,267406,36226,21090,9252,1357,241,7654,5884,5571452,3149557,1072139,843752,228387,1349756,771061,578695,100098,80231,19867,2172,17695,55660,39256,32704,8
0,0,2,2,22.3,32.7,29.9,15.1,6979638,4074786,1443621,132326,15094,1296201,1461231,241965,28846,16840,5966,547,62,5357,6039,3444455,2463624,613489,439592,173897,367342,38876,328466,97208,74170,23038,266,22772,35434,33216,14424,10
7,0,1,1,5.6,28.7,38.3,27.4,5192896,3866650,695695,52115,32082,611498,630551,127257,40806,30385,5467,410,252,4805,4955,2281510,1447213,366680,243265,123415,467617,34372,433245,55834,39923,15911,1273,14638,40862,36250,29597,53
0,0,6,6,20.1,37.4,25.9,16.6,1235688,742234,289407,22353,5337,261717,204047,48377,25543,15343,5982,462,110,5410,4218,862885,556652,192745,146485,46260,113488,17295,96193,24207,18113,6094,702,5392,35646,30732,17840,0
3,0,3,2,35.5,32.8,21,10.7,284191,157736,75377,14383,1216,59778,51078,9648,29456,16349,7813,1491,126,6196,5294,120025,78408,20220,14917,5303,21397,13268,8129,3834,2727,1107,214,893,31305,28752,9103,0
1,0,9,8,12.7,22.6,36.6,28.1,260601,187789,24089,2256,275,21558,48723,8270,31512,22707,2913,273,33,2607,5892,171744,83739,21327,13421,7906,66678,5474,61204,4642,3003,1639,253,1386,36998,27885,44159,0
6,0,3,2,14.2,32.9,30.5,22.4,3754348,2474969,724197,87580,26613,610004,555182,102622,36584,24117,7057,853,259,5944,5410,2778857,1789594,445678,297443,148235,543585,60275,483310,63279,52699,10580,854,9726,43914,33959,49693,8
8,0,1,1,9,29.7,25.6,35.7,23668,17076538,4339491,370694,105185,3863612,4594479,549486,47336,31077,7897,675,191,7031,8361,22568319,17147258,3873517,2653363,1220154,1547544,25080,1522464,356946,295256,61690,286,61404,63226,58076,24794,430
6,0,7,9,17.2,42.1,30.2,10.5,456299,177503,212795,16120,4064,192611,66001,17269,26423,10279,12322,933,235,11154,3822,153434,104436,26466,17837,8629,22532,-9120,31652,6690,4007,2683,616,2067,22935,26063,15313,0
2,0,7,11,19,35.1,29.1,16.8,157455,90405,25606,1717,262,23627,41444,4969,31687,18194,5153,346,53,4755,8341,122172,71783,20442,13596,6846,29947,9086,20861,3312,2294,1018,275,743,36888,31292,28077,0
9,0,1,1,6.6,28.9,27.7,36.8,24087247,16408035,3687875,238488,111233,3338154,3991337,450318,53489,36437,8189,530,247,7413,8863,16009957,11522185,2930198,1983486,946712,1557574,1733,1555841,266888,214434,52454,716,51738,59988,53733,30072,112
0,0,4,5,15.2,41,26.8,16.9,2407725,1631149,397140,29072,14153,353915,379436,74981,32111,21754,5297,388,189,4720,5060,2059456,1486753,402980,289531,113449,169723,15732,153991,50807,41984,8823,999,7824,40535,35412,19682,5
5,0,7,8,25.9,34.3,25.6,14.2,1003710,626309,220496,22623,8437,189436,156905,31718,31645,19746,6952,713,266,5973,4947,570467,356547,91047,63810,27237,122873,25450,97423,16004,11441,4563,1074,3489,35645,31164,27923,2
0,0,6,6,19.1,45.3,23.9,11.7,562777,345986,127468,9138,3771,114559,89323,20477,27483,16896,6225,446,184,5595,4362,352880,226895,70029,51661,18368,55956,12382,43574,11203,8251,2952,443,2509,31499,27499,17367,2
1,0,9,12,26.3,26.6,32.4,14.7,316057,177063,99169,23814,1808,73547,39825,13625,23197,12995,7278,1748,133,5398,2923,204125,135782,41093,29829,11264,27250,1261,25989,6671,4983,1688,510,1178,30599,27249,22062,0
7,0,1,1,19.9,38.8,27.1,14.3,911251,490258,297867,43616,8974,245277,123126,32686,27879,14999,9113,1334,275,7504,3767,452049,327200,85802,59282,26520,39047,8409,30638,11130,8705,2425,422,2003,40615,37588,15296,2
2,0,6,6,25,38.2,24.8,12,800026,447516,245122,20558,1855,222709,107388,30176,26512,14830,8123,681,61,7380,3559,385694,259717,65741,48138,17603,60236,11346,48890,12622,8505,4117,968,3149,30557,30537,15526,0
7,0,6,6,16.9,42.4,26.7,14.1,222789,104531,89998,8617,2231,79150,28260,7947,28034,13154,11325,1084,281,9960,3556,119420,91328,23120,14885,8235,4972,187,4785,3761,3100,661,78,583,31752,29461,8208,0
1,0,3,2,11.9,37.8,27.9,22.5,6310793,4580717,694851,45446,27970,621435,1035225,171632,36769,26689,4048,265,163,3621,6032,5447147,4039268,1026600,708076,318524,381279,16911,364368,127026,108868,18158,1211,16947,42882,37102,21500,124
3,0,7,11,38.7,29.9,21.7,9.7,1132193,585905,422194,58224,5801,358169,124094,39964,28330,14661,10564,1457,145,8962,3105,697279,460643,123324,88589,34735,113312,-238,113550,16006,13193,2813,68,2745,43564,34916,41366,2
0,0,7,9,27.1,38.3,24.3,10.3,383607,182818,143619,11836,1730,130053,57170,17391,22058,10512,8258,681,99,7478,3287,160681,95750,25335,17763,7572,39596,13491,26105,7218,4374,2844,636,2208,22261,21891,11823,0
9,0,9,10,7.8,32.6,38.6,20.9,305955,207556,42875,2541,645,39689,55524,6636,46105,31277,6461,383,97,5981,8367,236281,172085,40973,28991,11982,23223,2309,20914,4551,3331,1220,274,946,51918,51662,22108,0
5,0,9,12,9.9,30.8,27.4,31.9,493898,197255,121832,8601,3165,110066,174811,11362,43469,17361,10723,757,279,9687,15386,239057,162585,39446,27686,11760,37026,-875,37901,7121,5097,2024,49,1975,33571,31898,19190,3
3,0,4,5,22.8,48.3,18.2,10.7,4885724,2941817,1239700,72518,64063,1103119,704207,148463,32909,19815,8350,488,432,7430,4743,2657929,1819068,571080,420070,151010,267781,2625,265156,66377,54654,11723,823,10900,40043,33283,24326,8
4,0,3,2,17,36.1,23.8,23.1,1872742,1110326,433343,32252,9063,392028,329073,44355,42222,25033,9770,727,204,8838,7419,1583621,1022975,259220,178422,80798,301426,-1278,302704,36535,31701,4834,209,4625,43345,32269,65450,8
8,0,3,2,9.2,41.8,18.4,30.5,888137,600103,167055,10004,4830,152221,120979,18370,48347,32668,9094,545,263,8286,6586,1336770,1028493,263274,198867,64407,45003,-68,45071,19728,17619,2109,417,1692,67760,58374,26638,1
10,0,9,10,6.6,32.6,40,20.9,284318,192981,41361,2022,224,39115,49976,5174,54951,37298,7994,391,43,7560,9659,157347,55133,15266,11254,4012,86948,65502,21446,2785,1633,1152,372,780,56498,33762,27495,1
9,0,1,1,10.9,28.2,29.4,31.5,60372413,36295270,11899966,1402230,121343,10376393,12177177,1262459,47821,28750,9426,1111,96,8219,9646,54581197,40632537,9337494,6484513,2852981,4611166,2559,4608607,908783,753600,155183,96,155087,60060,53918,29716,577
0,0,6,6,14.6,35.5,34.6,15.3,1011494,592389,257067,23851,5988,227228,162038,41612,24308,14236,6178,573,144,5461,3894,489217,311675,96727,64247,32480,80815,5434,75381,16084,10791,5293,1099,4194,30416,28883,17974,3
6,0,8,7,17.2,42.4,26.6,13.8,245696,135922,79835,6878,2117,70840,29939,8600,28569,15805,9283,800,246,8237,3481,93259,49375,11996,7670,4326,31888,16798,15090,2861,1782,1079,390,689,32597,27708,21901,0
7,0,7,11,15.3,18.9,34.3,31.5,581192,363620,59512,5840,6863,46809,158060,14248,40791,25521,4177,410,482,3285,11093,440384,255917,77966,59061,18905,106501,20696,85805,9360,7104,2256,59,2197,47050,36024,39056,2
9,0,1,1,8.3,31.5,29.4,30.9,6247544,4353963,989890,75806,8433,905651,903691,147017,42495,29615,6733,516,57,6160,6147,2753996,1876776,463032,315861,147171,414188,10256,403932,67319,51563,15756,512,15244,40910,36398,26498,40
5,0,3,2,27.1,25.5,34.3,13,4070314,2516480,906363,146237,72863,687263,647471,152404,26707,16512,5947,960,478,4509,4248,3022852,2005493,705159,555338,149821,312200,80003,232197,56175,48598,7577,904,6673,53811,41267,34796,3
1,0,5,8,27.9,36.6,21.7,13.8,1705796,893565,559973,53703,4751,501519,252258,61297,27828,14578,9135,876,78,8182,4115,1004310,683281,200603,127456,73147,120426,-1502,121928,28527,23701,4826,383,4443,35206,28829,27443,2
4,0,7,9,15.5,43,26.8,14.7,270045,140464,78335,5417,2660,70258,51246,9260,29163,15169,8460,585,287,7587,5534,132841,93945,25703,16713,8990,13193,-419,13612,4251,3247,1004,95,909,31249,28933,14975,0
9,0,3,2,6.7,21.3,35.1,36.9,3837939,2524931,554381,74058,6528,473795,758627,117867,32562,21422,4703,628,55,4020,6436,2748530,1837075,539577,389507,150070,371878,40444,331434,71150,53874,17276,1082,16194,38630,34099,20466,73
4,0,2,2,32.4,30.4,24.4,12.8,2434031,1317619,736202,68754,50856,616592,380210,91178,26695,14451,8074,754,558,6763,4170,1384691,980627,281838,203800,78038,122226,2960,119266,37874,30619,7255,403,6852,36560,32027,17406,3
8,0,1,1,6.7,34.4,36.3,22.6,2738913,2147281,299475,21028,17832,260615,292157,50184,54577,42788,5968,419,355,5193,5822,2034560,962909,278778,211358,67420,792873,86347,706526,22629,17971,4658,355,4303,89909,53581,164194,4
4,0,9,10,24.4,33.4,26,16.2,155006,86084,27519,1736,524,25259,41403,4608,33638,18681,5972,377,114,5482,8985,84580,45547,11057,7803,3254,27976,12363,15613,2627,1599,1028,425,603,32196,28485,25892,0
4,0,3,2,37,29,21.1,12.8,2663779,1607419,606534,84472,39900,482162,449826,101009,26372,15914,6005,836,395,4773,4453,2699864,2077473,491393,341281,150112,130998,1953,129045,64074,55845,8229,364,7865,42137,37201,16408,5
2,0,3,2,16.2,49.9,20,13.9,4100209,2485148,996104,81621,30260,884223,618957,127048,32273,19561,7840,642,238,6960,4872,3035213,2103633,646237,467520,178717,285343,27648,257695,76076,65156,10920,473,10447,39897,32286,24667,7
4,0,4,5,25.5,34.6,26.3,13.6,2713767,1135489,987528,69846,22738,894944,590750,98956,27424,11475,9979,706,230,9044,5970,1241571,891534,226139,160721,65418,123898,42880,81018,37758,29683,8075,667,7408,32882,30035,10937,5
9,0,8,7,14,35.9,38,12.1,186061,84118,67506,9212,835,57459,34437,5502,33817,15289,12269,1674,152,10443,6259,99806,64618,20438,15633,4805,14750,4518,10232,2767,2057,710,269,441,36070,31414,23202,0
7,0,4,5,13,34.3,31.6,21.1,1718914,1103284,303234,33695,8656,260883,312396,42860,40105,25742,7075,786,202,6087,7289,1349920,983015,242009,156798,85211,124896,33864,91032,26670,22676,3994,615,3379,50616,43350,26941,7
10,0,6,3,19.5,31.2,32.2,17.2,1175964,783134,218217,20089,2672,195456,174613,28145,41782,27825,7753,714,95,6945,6204,828634,519829,122606,82679,39927,186199,88060,98139,16739,12614,4125,668,3457,49503,41210,28388,1
8,0,6,6,20.8,33,31.7,14.5,1062272,575116,354620,45799,6792,302029,132536,34704,30609,16572,10218,1320,196,8703,3819,682337,430638,116302,83038,33264,135397,101300,34097,15837,12933,2904,398,2506,43085,33298,13606,1
0,0,9,9,27.8,39,22.7,10.5,225261,115382,79319,6674,1014,71631,30560,12127,18575,9514,6541,550,84,5907,2520,84951,45391,13577,10072,3505,25983,10881,15102,3901,2123,1778,679,1099,21777,21381,13742,0
9,0,3,2,9.3,30.4,28.8,31.4,7788353,4601890,1737807,151123,21373,1565311,1448656,180763,43086,25458,9614,836,118,8659,8014,3945090,2481192,886121,673396,212725,577777,5555,572222,88659,62507,26152,394,25758,44497,39695,22215,82
0,0,7,8,16,49.7,21.6,12.7,1215982,856266,188511,11068,3099,174344,171205,40967,29682,20901,4602,270,76,4256,4179,782685,533455,141535,100998,40537,107695,10622,97073,23191,18052,5139,1150,3989,33750,29551,24335,9
4,0,9,8,37.5,31.4,20.2,10.8,595534,292899,218897,28088,5238,185571,83738,22102,26945,13252,9904,1271,237,8396,3789,253114,176045,48281,33980,14301,28788,12359,16429,7628,5798,1830,274,1556,33182,30363,10558,0
1,0,6,6,19.5,45.6,23.3,11.6,417288,253904,105884,6864,1999,97021,57500,17376,24015,14612,6094,395,115,5584,3309,150061,92271,27717,20688,7029,30073,2752,27321,5548,3684,1864,398,1466,27048,25046,18636,1
1,0,7,9,36.4,40.1,15.2,8.3,267777,139514,88299,11305,1007,75987,39964,15401,17387,9059,5733,734,65,4934,2595,164803,116720,33025,24812,8213,15058,5784,9274,6082,4990,1092,266,826,27097,23391,11228,0
0,0,7,9,16.5,35.1,33.3,15,43308,261943,100860,8205,1624,91031,61823,16591,25594,15788,6079,495,98,5487,3726,319114,214842,55848,38223,17625,48424,15393,33031,10510,8037,2473,678,1795,30363,26732,18402,2
7,0,7,11,7.4,36,36.8,19.8,384132,254172,65931,3339,1101,61491,64029,9229,41622,27541,7144,362,119,6663,6938,237757,159832,43523,27101,16422,34402,7053,27349,5540,4148,1392,357,1035,42916,38532,26424,0
3,0,3,2,34.2,25.7,28.2,11.8,5041311,3109067,1118968,143847,45695,929426,813276,191202,26366,16261,5852,752,239,4861,4253,3485709,2402512,665730,465145,200585,417467,81670,335797,83665,71379,12286,382,11904,41663,33659,28209,3
10,0,2,2,16.2,33,31.9,18.9,10698531,6703691,2426562,245212,36655,2144695,1568278,254889,41973,26300,9520,962,144,8414,6153,9903337,7119831,1812395,1319115,493280,971111,-4076,975187,159031,130622,28409,659,27750,62273,54507,35142,15
2,0,3,2,20,32.5,23,24.5,836997,544300,116847,7634,972,108241,175850,25134,33301,21656,4649,304,39,4307,6996,236849,149101,37413,26730,10683,50335,-2585,52920,7598,4555,3043,286,2757,31173,32733,19195,1
9,0,6,4,13.3,42.2,32.5,12,463795,272493,120785,12580,1919,106286,70517,13407,34593,20325,9009,938,143,7928,5260,185595,91797,30247,23876,6371,63551,33157,30394,4613,2787,1826,562,1264,40233,32938,24046,1
5,0,7,10,37,33.2,20.3,9.5,41589,212305,845,8528,7805,45458,24340,21661,23709,9801,11546,2345,336,8865,2362,221144,145003,48083,37049,11034,28058,-1478,29536,5415,4364,1051,250,801,40839,33227,36874,0
1,0,2,2,19.6,32.8,27.3,20.3,8992758,4581834,816829,63434,13160,740235,3594095,195569,45983,23428,4177,324,67,3785,18378,5236709,3975420,833040,541317,291723,428249,33408,394841,121766,100299,21467,1866,19601,43006,39636,20144,11
6,0,6,6,9.2,39.4,34.1,17.3,614036,357476,144599,11230,5195,128174,111961,14461,42462,24720,9999,777,359,8863,7742,354073,161971,49822,36326,13496,142280,92805,49475,7983,5262,2721,729,1992,44353,30781,24837,1
10,0,9,8,7.5,32.2,31.7,28.6,666895,303567,186991,11532,2029,173430,176337,17391,38347,17455,10752,663,117,9972,10140,220944,140753,39002,27164,11838,41189,938,40251,7068,4359,2709,147,2562,31260,32290,15711,1
3,0,2,2,11.9,31.3,38.6,18.3,3363923,2324784,604098,46166,14471,543461,435041,84079,40009,27650,7185,549,172,6464,5174,1189647,748115,216199,158553,57646,225333,-1737,227070,31209,20217,10992,240,10752,38119,37004,21119,0
5,0,9,10,20.6,38.8,33.4,7.2,128648,59659,39244,5039,2460,31745,29745,5813,22131,10263,6751,867,423,5461,5117,74095,62053,18808,13795,5013,-6766,-17138,10372,3134,2166,968,128,840,23642,28649,12348,1
10,0,3,2,13.9,43.7,31.3,11.1,309522,200250,76929,6330,1051,69548,32343,8645,35804,23164,8899,732,122,8045,3741,396204,305809,66818,43922,22896,23577,2416,21161,5646,4531,1115,316,799,70174,67493,26484,0
7,0,1,1,13.3,39.5,29.1,18.1,2357729,1612646,486590,56120,9515,420955,258493,66728,35333,24167,7292,841,143,6309,3874,1193349,712447,210645,155374,55271,270257,24266,245991,29827,21053,8774,1068,7706,40009,33841,31922,4
1,0,4,5,25.2,36.1,23.9,14.8,1554762,983609,385270,31294,4103,349873,185883,53821,28888,18276,7158,581,76,6501,3454,1130119,855149,177261,118267,58994,97709,-3265,100974,24495,19634,4861,555,4306,46137,43554,23450,2
1,0,6,6,19.3,43.5,22.7,14.6,1493625,903067,328710,20859,8509,299342,261848,52031,28706,17356,6318,401,164,5753,5033,819572,495423,160234,118845,41389,163915,6434,157481,23277,16898,6379,520,5859,35210,29318,26878,6
0,0,1,1,29.6,36,24.8,9.6,1331674,921153,260864,22715,2347,235802,149657,54624,24379,16864,4776,416,43,4317,2740,446783,258836,68489,48965,19524,119458,33475,85983,15068,10120,4948,1122,3826,29651,25577,22473,0
2,0,7,11,16.3,39.8,27.9,16,762436,470320,132559,7699,1310,123550,159557,20869,36534,22537,6352,369,63,5920,7646,566412,374154,91560,64067,27493,100698,36696,64002,16676,12682,3994,799,3195,33966,29503,20032,0
1,0,1,1,28.7,37,23,11.3,435495,279340,99077,10573,1158,87346,57078,17115,25445,16321,5789,618,68,5103,3335,176533,116637,31644,23614,8030,28252,6765,21487,5602,3932,1670,226,1444,31512,29664,14880,0
9,0,7,9,7.1,31.3,41.1,20.5,679503,376556,116602,5802,2021,108779,186345,18567,36597,20281,6280,312,109,5859,10036,401725,271364,85745,59491,26254,44616,4184,40432,9874,6207,3667,547,3120,40685,43719,12959,6
4,0,1,1,29.6,36,24.8,9.6,1570082,992993,377714,36568,9934,331212,199375,57341,27381,17317,6587,638,173,5776,3477,462511,292901,78746,56706,22040,90864,16589,74275,15000,10038,4962,1200,3762,30834,29179,19743,1
1,0,8,7,25.5,42.2,21.3,11,213001,130810,52314,3755,633,47926,29877,9235,23065,14165,5665,407,69,5190,3235,62969,40259,12404,9446,2958,10306,-950,11256,3319,1639,1680,811,869,18972,24563,12953,1
9,0,9,8,25.6,41.8,25.1,7.6,122139,68370,36121,4339,264,31518,17648,4120,29645,16595,8767,1053,64,7650,4283,64539,35540,11309,8373,2936,17690,11763,5927,1790,1278,512,62,450,36055,27809,13171,0
1,0,7,9,26.8,34.8,26.3,12.1,32396,320736,181148,22700,1297,157151,103433,24997,24216,12831,7247,908,52,6287,4138,345577,231333,62192,43168,19024,52052,-781,52833,11448,8125,3323,1035,2288,30187,28472,23091,0
8,0,7,11,7.8,34.9,38.1,19.2,658146,417455,112567,8821,2603,101143,128124,15497,42469,26938,7264,569,168,6527,8268,495103,314592,89095,61383,27712,91416,65476,25940,11617,8584,3033,866,2167,42619,36649,11970,11
8,0,2,2,19.8,34.8,30.7,14.6,1940492,1030790,655826,70851,7203,577772,253876,66199,29313,15571,9907,1070,109,8728,3835,1071207,790181,204525,141355,63170,76501,6166,70335,25384,20919,4465,712,3753,42200,37773,18741,3
3,0,1,1,5.1,17.5,29.6,47.7,31512593,21949929,2386823,117570,75380,2193873,7175841,532175,59215,41246,4485,221,142,4122,13484,22624719,16237747,3193350,2009670,1183680,3193622,2443,3191179,418089,338095,79994,496,79498,54115,48027,40142,263
9,0,3,2,13,28.8,36.7,21.6,2274840,1274694,495862,36416,8276,451170,504284,54155,42006,23538,9156,672,153,8331,9312,2011622,1293540,462111,384825,77286,255971,3626,252345,37575,28678,8897,16,8881,53536,45106,28414,11
8,0,3,2,16.1,31.2,33,19.8,2238983,1416092,393463,45101,4538,343824,429428,60613,36939,23363,6491,744,75,5672,7085,1886907,1343868,339550,238907,100643,203489,75890,127599,44038,37047,6991,459,6532,42847,36275,19534,4
4,0,6,4,21.2,35.9,21.2,21.7,918543,463276,191248,12150,7236,171862,264019,20132,45626,23012,9500,604,359,8537,13114,512651,316219,83690,58996,24694,112742,18137,94605,12829,8875,3954,288,3666,39960,35630,25806,0
2,0,7,9,35.2,39,17.8,7.9,651125,368460,186570,19066,1919,165585,96095,25250,25787,14592,7389,755,76,6558,3806,337839,211540,58951,43494,15457,67348,-8310,75658,11330,7459,3871,953,2918,29818,28360,25928,2
1,0,6,5,15.9,39,29.4,15.7,1075503,724303,194537,14929,4769,174839,156663,35183,30569,20587,5529,424,136,4969,4453,645467,452007,125744,92764,32980,67716,1210,66506,17671,13545,4126,932,3194,36527,33371,20822,17
0,0,7,11,15.5,41.2,28.9,14.5,325716,201264,66035,4644,576,60815,58417,10839,30050,18569,6092,428,53,5611,5390,218710,109817,29634,21530,8104,79259,56463,22796,7186,4559,2627,992,1635,30436,24088,13943,1
8,0,6,6,13.1,39.6,29.7,17.5,576389,362965,113202,9501,2569,101132,100222,14051,41021,25832,8057,676,183,7197,7133,331111,164945,48740,35489,13251,117426,60620,56806,8291,5447,2844,862,1982,39936,30282,28661,1
0,0,2,2,14.9,26.5,31.6,26.9,23577860,16155353,2718759,285168,27377,2406214,4703748,568199,41496,28433,4785,502,48,4235,8278,21254750,13147756,3061286,1984187,1077099,5045708,2246,5043462,425334,352990,72344,1021,71323,49972,37247,70713,47
5,0,2,2,25.8,26.5,31.4,16.3,2424914,1631435,507515,100192,29297,378026,285964,79093,30659,20627,6417,1267,370,4780,3616,1578527,1032857,302283,191608,110675,243387,79450,163937,35773,29482,6291,692,5599,44126,35033,29280,8
9,0,6,6,15.4,37.2,30.9,16.5,1224094,588373,394985,38247,2918,353820,240736,41678,29370,14117,9477,918,70,8489,5776,484782,287089,78380,54349,24031,119313,45758,73555,15084,9480,5604,1222,4382,32139,30284,16786,7
8,0,7,11,19.8,44.7,22.9,12.6,663806,408143,185082,51841,9197,124044,70581,17847,37194,22869,10370,2905,515,6950,3955,451580,300884,127466,105972,21494,23230,0,23230,8732,7240,1492,0,1492,51716,41559,15570,0
7,0,3,2,11.2,29,38,21.7,5085250,2786157,1428301,171229,46569,1210503,870792,160735,31637,17334,8886,1065,290,7531,5418,3120884,2337140,542177,361783,180394,241567,-743,242310,75114,60584,14530,799,13731,41549,38577,17647,13
1,0,6,3,28.6,42.5,20,8.8,612400,408522,141026,15247,3351,122428,62852,23982,25536,17035,5880,636,140,5105,2621,310861,221892,62353,45230,17123,26616,1437,25179,10156,7831,2325,329,1996,30609,28335,12615,5
1,0,6,4,20.2,45.1,24.4,10.3,391468,245313,79634,5747,1446,72441,66521,13713,28547,17889,5807,419,105,5283,4851,235862,158164,41649,30223,11426,36049,15373,20676,6707,4894,1813,447,1366,35167,32318,15136,0
2,0,3,2,17.8,29.3,29.2,23.8,2966178,1691522,447292,42408,4521,400363,827364,76513,38767,22108,5846,554,59,5233,10813,2113413,1489491,348099,249520,98579,275823,-482,276305,51329,41973,9356,33,9323,41174,35487,29637,1
6,0,1,1,15.8,30,33.1,21,1750965,1102681,427304,48306,27257,351741,220980,60964,28721,18087,7009,792,447,5770,3625,646568,443373,114008,79333,34675,89187,10155,79032,18356,12523,5833,478,5355,35224,35405,14759,4
2,0,7,9,13,39.5,31,16.5,312409,195071,55767,3585,498,51684,61571,8527,36638,22877,6540,420,58,6061,7221,136629,88194,23741,16881,6860,24694,9461,15233,5213,3714,1499,490,1009,26209,23746,15097,0
1,0,7,12,9.6,23.2,28.8,38.4,927101,557879,88514,7651,3380,77483,280708,15768,58796,35380,5614,485,214,4914,17802,619749,310461,70452,46781,23671,238836,-548,239384,14099,8099,6000,52,5948,43957,38333,40246,2
2,0,7,9,30.9,30.4,25.3,13.3,266998,150651,87721,7642,537,79542,28626,10779,24770,13976,8138,709,50,7379,2656,141995,91806,25629,18490,7139,24560,1142,23418,4972,3296,1676,657,1019,28559,27854,22981,0
8,0,3,2,10.9,35.4,32,21.6,3646860,2188668,859035,87605,15704,755726,599157,98289,37103,22268,8740,891,160,7689,6096,2489347,1723883,444525,311476,133049,320939,101481,219458,57300,47355,9945,748,9197,43444,36403,23862,11
9,0,6,6,25.8,40.1,24.7,9.4,258287,125155,93570,15930,570,77070,39562,9701,26625,12901,9645,1642,59,7945,4078,163694,115808,35473,26561,8912,12413,5260,7153,3926,2996,930,120,810,41695,38654,8831,0
7,0,6,4,17.6,41.3,25.7,15.4,564918,339224,145288,17284,4267,123737,80406,18600,30372,18238,7811,929,229,6653,4323,278002,184003,54733,40395,14338,39266,-2287,41553,7739,5366,2373,956,1417,35922,34291,29325,0
9,0,6,3,21.3,39.4,29.8,9.5,685086,341269,256080,43814,2699,209567,87737,27078,25300,12603,9457,1618,100,7739,3240,437272,293228,83175,58622,24553,60869,10574,50295,11439,8640,2799,281,2518,38226,33938,19974,8
2,0,6,6,39.7,34.5,16.9,8.9,833520,460796,261855,32943,1913,226999,110869,31729,26270,14523,8253,1038,60,7154,3494,428271,279484,79449,58941,20508,69338,-8310,77648,14563,10417,4146,998,3148,29408,26830,24666,0
4,0,5,8,12.6,30.6,34.3,22.4,2972928,1642676,601996,44990,47577,509429,728256,90910,32702,18069,6622,495,523,5604,8011,1891043,1303588,317826,190139,127687,269629,-213,269842,57763,39679,18084,953,17131,32738,32853,15752,13
0,0,7,9,28.8,44.4,16.9,9.9,491369,331416,99705,7046,1176,91483,60248,18602,26415,17816,5360,379,63,4918,3239,383310,274193,70807,50753,20054,38310,3714,34596,12168,9581,2587,856,1731,31501,28618,19986,1
1,0,8,7,20.9,37,30.2,12,290678,179488,66176,3512,2077,60587,45014,9802,29655,18311,6751,358,212,6181,4592,128184,74809,20766,14518,6248,32609,17586,15023,4983,2703,2280,1179,1101,25724,27676,13645,1
9,0,9,10,19.2,48,22.9,9.9,161635,77957,62335,5248,398,56689,21343,5653,28593,13790,11027,928,70,10028,3776,56633,30738,11243,8927,2316,14652,602,14050,1572,946,626,221,405,36026,32493,34691,1
9,0,1,1,17.4,28.3,31.2,23.1,17657959,12642641,2834866,325467,51414,2457985,2180452,479488,36827,26367,5912,679,107,5126,4547,13286013,9704334,2141490,1437828,703662,1440189,16850,1423339,242258,196351,45907,726,45181,54842,49423,31503,129
7,0,3,2,10.3,21.3,32.9,35.4,5005591,3043389,920535,104192,22500,793843,1041667,136002,36805,22378,6769,766,165,5837,7659,3257349,2342240,652083,476882,175201,263026,-808,263834,78072,61730,16342,2239,14103,41722,37943,18708,63
1,0,7,11,21.4,21.1,29.8,27.7,279991,179348,46629,4180,413,42036,54014,8790,31853,20404,5305,476,47,4782,6145,200555,140609,33918,24761,9157,26028,1622,24406,5976,4507,1469,121,1348,33560,31198,18105,1
10,0,6,5,21.4,43.3,26.7,8.7,1128159,520105,477429,44772,6015,426642,130625,34419,32777,15111,13871,1301,175,12396,3795,586360,448307,112321,76549,35772,25732,-4,25736,12549,10971,1578,10,1568,46726,40863,16413,0
4,0,6,6,15.4,39.1,26.5,19,368962,228123,81462,7403,3007,71052,59377,9972,37000,22876,8169,742,302,7125,5954,285375,184495,44369,30482,13887,56511,32860,23651,7327,5656,1671,474,1197,38948,32619,19759,0
3,0,7,11,13.4,35.9,35.7,15,202222,117337,47955,3232,256,44467,36930,6017,33608,19501,7970,537,43,7390,6138,133085,80040,20886,14785,6101,32159,21013,11146,4065,2895,1170,326,844,32739,27648,13206,0
4,0,9,10,26.7,36.5,25.1,11.7,321738,136408,136389,9201,5173,122015,48941,13679,23521,9972,9971,673,378,8920,3578,125028,83854,22564,15797,6767,18610,382,18228,5468,3255,2213,587,1626,22865,25762,11210,2
7,0,3,2,18.6,35.5,28,17.8,2091650,1207125,612756,90069,14408,508279,271769,68150,30692,17713,8991,1322,211,7458,3988,1158638,861479,207211,141831,65380,89948,8911,81037,25975,20480,5495,316,5179,44606,42064,15647,6
9,0,7,9,17.3,44.8,25.5,12.3,779438,413534,261234,28525,1256,231453,104670,26229,29717,15766,9960,1088,48,8824,3991,394874,236534,65344,47995,17349,92996,-2212,95208,10822,7273,3549,840,2709,36488,32522,35145,3
3,0,2,2,7.7,21.3,31.5,39.5,11086749,7325560,1323058,82987,28781,1211290,2438131,291650,38014,25118,4536,285,99,4153,8360,7530263,5712122,1225752,821012,404740,592389,-1292,593681,192586,142129,50457,1505,48952,39101,40190,12128,315
3,0,7,11,20.7,43,23.7,12.6,334898,203582,63881,4041,1788,58052,67435,9625,34795,21151,6637,420,186,6031,7006,222108,130692,41123,31054,10069,50293,25444,24849,6755,4555,2200,729,1471,32881,28692,16893,1
7,0,9,12,15.4,36.2,33.8,14.6,212307,129683,49413,12493,965,35955,33211,5531,38385,23447,8934,2259,174,6501,6005,146320,75533,23395,17624,5771,47392,16133,31259,3128,2405,723,293,430,46777,31407,72695,0
2,0,1,1,32.2,34.7,20.6,12.5,1703942,1057320,391723,54002,4824,332897,254899,62682,27184,16868,6249,862,77,5311,4067,1073556,804248,199344,146054,53290,69964,-1122,71086,32281,25325,6956,303,6653,33257,31757,10685,6
2,0,6,4,27,35.4,26.3,11.3,631489,374608,154256,8912,932,144412,102625,19822,31858,18899,7782,450,47,7285,5177,264451,153384,37474,27460,10014,73593,-585,74178,10318,5396,4922,1380,3542,25630,28426,20942,1
0,0,5,8,12.3,31,24,32.7,3466449,2330096,442989,25161,4382,413446,693364,86287,40173,27004,5134,292,51,4792,8036,3222225,2176901,483269,325733,157536,562055,9863,552192,68994,55473,13521,443,13078,46703,39243,42223,27
0,0,3,2,19.3,37.6,26.1,17,2765320,1803488,532610,51607,9643,471360,429222,93150,29687,19361,5718,554,104,5060,4608,2000680,1373091,382477,279238,103239,245112,42659,202453,54591,45573,9018,900,8118,36649,30129,24939,7
8,0,8,7,9.3,36.8,35.7,18.3,153695,102816,28563,1621,269,26673,22316,3559,43185,28889,8026,455,76,7495,6270,98414,40988,10853,7847,3006,46573,38575,7998,1948,1191,757,308,449,50521,34415,17813,0
7,0,7,8,32.8,35.9,22,9.3,727838,309951,326958,52957,7550,266451,90929,28295,25723,10954,11555,1872,267,9417,3214,421797,294676,91228,68289,22939,35893,-461,36354,11283,9509,1774,74,1700,37383,30989,21385,0
4,0,4,5,25.9,39.9,24.1,10.1,2222719,1155339,787578,107798,32317,647463,279802,79241,28050,14580,9939,1360,408,8171,3531,1196962,852073,253629,186282,67347,91260,300,90960,32852,25561,7291,655,6636,36435,33335,13707,2
3,0,9,10,20,38.3,26.3,15.4,201459,105923,43105,2805,324,39976,52431,5638,35732,18787,7645,498,57,7090,9300,106493,56202,14784,10450,4334,35507,27194,8313,3602,2239,1363,583,780,29565,25101,10658,0
6,0,4,5,18.7,36.6,30.5,14.2,1274519,614239,475108,98464,11534,365110,185172,43256,29465,14200,10984,2276,267,8441,4281,696038,478786,131017,92054,38963,86235,14244,71991,18591,14758,3833,460,3373,37440,32442,21343,0
3,0,8,7,30.8,36.7,24.2,8.3,595609,339703,174127,19535,4270,150322,81779,23912,24908,14206,7282,817,179,6286,3420,172030,106289,31639,23576,8063,34102,16321,17781,5475,3577,1898,480,1418,31421,29715,12539,0
4,0,6,5,25,33.8,25.2,16,1541567,808954,447457,44990,19940,382527,285156,47485,32464,17036,9423,947,420,8056,6005,831147,569513,158712,114208,44504,102922,27869,75053,22887,17353,5534,282,5252,36315,32819,14290,1
2,0,6,6,15.4,37,34,13.5,143689,86648,28576,1609,181,26786,28465,3809,37724,22748,7502,422,48,7032,7473,88407,45901,13562,10005,3557,28944,10134,18810,2487,1616,871,294,577,35548,28404,32600,0
10,0,1,1,10.9,31.7,35.2,22.1,1591121,1021433,293543,18397,4292,270854,276145,37654,42256,27127,7796,489,114,7193,7334,670135,430690,131881,100672,31209,107564,16656,90908,16967,12059,4908,745,4163,39496,35715,21837,1
3,0,6,6,21.5,49.5,19.2,9.9,657494,431237,146424,10668,4199,131557,79833,21467,30628,20088,6821,497,196,6128,3719,436585,267663,75846,55500,20346,93076,51425,41651,11574,8867,2707,768,1939,37721,30186,21481,0
8,0,2,2,6.4,31.8,38,23.9,1566623,924825,402788,36178,5960,360650,239010,43733,35822,21147,9210,827,136,8247,5465,1007624,698096,227516,164892,62624,82012,278,81734,21637,17675,3962,338,3624,46569,39496,22554,3
10,0,1,1,8.1,30.2,39.1,22.6,2056783,1479419,294509,36194,4084,254231,282855,62641,32834,23617,4702,578,65,4059,4515,909732,670686,172672,119919,52753,66374,21196,45178,21258,15946,5312,432,4880,42795,42060,9258,4
7,0,4,5,12.4,32.6,32.5,22.4,2876275,1811505,653965,63525,28387,562053,410805,79516,36172,22782,8224,799,357,7068,5166,1612456,1033696,356036,267180,88856,222724,53692,169032,34930,27328,7602,819,6783,46162,37826,24920,26
7,0,6,5,12,26.4,31.2,30.5,1090644,543609,303156,24942,11042,267172,243879,40679,26811,13363,7452,613,271,6568,5995,704854,510256,143074,103887,39187,51524,2136,49388,20835,16039,4796,204,4592,33830,31813,10755,1
2,0,5,8,12.7,33.3,33.7,20.3,1694796,1105836,294819,20246,5843,268730,294141,44461,38119,24872,6631,455,131,6044,6616,1346892,875614,210284,141735,68549,260994,46230,214764,32838,27089,5749,630,5119,41016,32324,41954,0
4,0,1,1,21.1,20,24.4,34.5,27656231,18367795,3499234,431596,234816,2832822,5789202,589011,46954,31184,5941,733,399,4809,9829,33196543,24751535,5052996,3325431,1727565,3392012,-54,3392066,537738,439149,98589,10,98579,61734,56362,34410,31
5,0,5,8,10.1,17.2,27.6,45.1,2302730,1413461,162030,12812,25361,123857,727239,52102,44197,27129,3110,246,487,2377,13958,1538810,1187276,223891,134675,89216,127643,-333,127976,40796,29146,11650,131,11519,37720,40735,11110,4
10,0,2,2,7.8,41.1,32.4,18.7,645926,380654,139626,8933,2371,128322,125646,15747,41019,24173,8867,567,151,8149,7979,170957,115947,37518,29166,8352,17492,-14585,32077,5533,3468,2065,608,1457,30898,33433,22016,0
5,0,3,2,19.9,40.1,27.4,12.6,277303,146318,79061,10811,3304,64946,51924,11969,23168,12225,6605,903,276,5426,4338,135391,96824,27328,20628,6700,11239,1642,9597,4324,3123,1201,149,1052,31312,31004,9123,0
9,0,8,6,8.3,41.3,32.4,17.9,536545,325049,112717,6719,1293,104705,98779,13247,40503,24538,8509,507,98,7904,7457,242114,150475,49827,37715,12112,41812,5835,35977,7385,4230,3155,975,2180,32785,35573,16503,5
9,0,6,6,18.4,41.7,27.1,12.8,1124471,615145,303469,30418,2151,270900,205857,35330,31828,17411,8590,861,61,7668,5827,825760,537290,136985,97477,39508,151485,81738,69747,19477,14334,5143,1278,3865,42397,37484,18046,2
0,0,6,6,33.3,38.1,18.8,9.8,32222,255617,50,4378,6221,137528773,101120355,21887,19416,11679,5559,864,49,4647,2178,230804,144557,43964,31416,12548,42283,16736,25547,8780,5941,2839,1073,1766,26287,24332,14466,0
0,0,3,2,11.9,20.3,29.1,38.7,7468700,4882308,1033118,126082,7199,899837,1553274,233756,31951,20886,4420,539,31,3849,6645,6142935,4506056,1259485,945576,313909,377394,10185,367209,157313,134175,23138,1231,21907,39049,33583,16762,96
2,0,9,10,23.4,31.5,27.3,17.7,82671,49041,17974,1074,114,16786,15656,2530,32676,19384,7104,425,45,6635,6188,48151,23403,5786,4096,1690,18962,15291,3671,1751,882,869,453,416,27499,26534,8825,0
6,0,6,5,27,38.9,24.1,10.1,637997,337861,216316,27209,6194,182913,83820,25677,24847,13158,8425,1060,241,7124,3264,279503,185442,56371,42457,13914,37690,4506,33184,8304,6063,2241,250,1991,33659,30586,16667,2
10,0,5,8,14.4,40.6,29.3,15.7,1709131,981601,473655,43577,3316,426762,253875,46067,37101,21308,10282,946,72,9264,5511,1054468,761421,194827,134839,59988,98220,22986,75234,23008,18709,4299,643,3656,45830,40698,20578,1
2,0,1,1,21.6,29.6,29.2,19.6,9005384,5848221,1247616,205394,20583,1021639,1909547,241248,37328,24242,5172,851,85,4235,7915,14214389,9893660,2828876,2041503,787373,1491853,0,1491853,227099,209752,17347,0,17347,62591,47168,86001,12
8,0,4,5,9.9,40.3,31.2,18.7,2209489,1342310,538707,45698,9137,483872,328472,61334,36024,21885,8783,745,149,7889,5355,1512878,1055216,290681,210402,80279,166981,7802,159179,33787,25854,7933,1026,6907,44777,40814,23046,5
10,0,3,2,8.6,29.2,42,20.2,8308684,5301140,1372461,142905,3900,1225656,1635083,193088,43031,27455,7108,740,20,6348,8468,6212664,4256029,1595436,1177017,418419,361199,115674,245525,110282,94799,15483,285,15198,56334,44895,16155,11
4,0,7,9,13.7,38.4,32.6,15.4,357120,220975,73637,4798,3118,65721,62508,9843,36282,22450,7481,487,317,6677,6351,211815,122568,36170,26841,9329,53077,34588,18489,5787,3965,1822,486,1336,36602,30912,13839,0
9,0,8,7,12.9,52.2,21.5,13.5,550119,332063,136955,10443,2714,123798,81101,14637,37584,22687,9357,713,185,8458,5541,342839,214031,64922,46849,18073,63886,22224,41662,7289,5151,2138,592,1546,47035,41551,26948,1
6,0,5,8,6.6,20,25.6,47.8,1288357,736107,98200,6923,9845,81432,454050,27988,46032,26301,3509,247,352,2910,16223,865837,638371,121619,71611,50008,105847,-161,106008,25164,18385,6779,27,6752,34408,34722,15700,2
3,0,6,6,13.6,37.5,29.4,19.5,371914,211347,97428,5042,2253,90133,63139,10872,34208,19440,8961,464,207,8290,5807,223586,161692,43258,30463,12795,18636,-1,18637,6172,4638,1534,30,1504,36226,34862,12392,1
3,0,1,1,30.8,33.1,23.3,12.8,1445173,934813,358207,61729,10234,286244,152153,50699,28505,18438,7065,1218,202,5646,3001,840294,585943,140150,92853,47297,114201,27538,86663,22962,18638,4324,206,4118,36595,31438,21045,0
10,0,3,2,8,28.7,36.1,27.2,6693539,4315398,1212261,117364,21023,1073874,1165880,155636,43008,27728,7789,754,135,6900,7491,5504789,3876324,936246,631264,304982,692219,150784,541435,112662,91468,21194,3076,18118,48861,42379,29884,19
1,0,3,2,10.5,23.8,35.9,29.8,8696020,5761766,1232845,96997,26314,1109534,1701409,232688,37372,24762,5298,417,113,4768,7312,5625175,3952484,1074595,715285,359310,598096,-464,598560,128590,103023,25567,1010,24557,43745,38365,24374,33
1,0,8,7,43.8,32.6,15.3,8.4,33297,16851,11935,1998,150,9787,4511,1863,17873,9045,6406,1072,81,5253,2421,10471,6434,2142,1724,418,1895,1450,445,481,281,200,60,140,21769,22897,3179,0
7,0,2,2,7.6,37.1,38.6,16.8,281078,188261,58246,7119,1299,49828,34571,10295,27302,18287,5658,692,126,4840,3358,151727,111337,29840,20374,9466,10550,-1108,11658,4842,3310,1532,290,1242,31336,33637,9386,0
9,0,9,12,6.2,39.3,37.1,17.3,247283,176106,37013,2578,390,34045,34164,3878,63766,45412,9544,665,101,8779,8810,164192,45935,13400,9942,3458,104857,26351,78506,2253,1371,882,396,486,72877,33505,161535,0
1,0,4,5,27.1,35.7,21.7,15.5,1808545,1147247,426549,36604,7490,382455,234749,72728,24867,15774,5865,503,103,5259,3228,1069086,754444,177394,117470,59924,137248,22671,114577,36446,26573,9873,1814,8059,29333,28391,14217,2
8,0,1,1,6.5,12.9,20.8,59.8,23409629,19215489,1079560,76400,26119,977041,3114580,350858,66721,54767,3077,218,74,2785,8877,12512396,9534628,1882900,1217662,665238,1094868,-11078,1105946,203898,157212,46686,1210,45476,61366,60648,24319,465
9,0,6,6,20.5,42.6,28.3,8.6,592167,303821,192918,22380,1214,169324,95428,22575,26231,13458,8546,991,54,7501,4227,397265,283211,74402,53874,20528,39652,2557,37095,8754,7190,1564,162,1402,45381,39390,26459,0
9,0,2,2,10.3,34,34.5,21.2,3708584,2309010,805097,77235,7939,719923,594477,93199,39792,24775,8638,829,85,7725,6379,2261946,1560437,401568,274611,126957,299941,109996,189945,49935,40739,9196,876,8320,45298,38303,22830,8
1,0,7,9,23.9,40.4,26.9,8.8,709724,363860,239792,23511,7629,208652,106072,31612,22451,11510,7585,744,241,6600,3355,335393,224145,71760,53315,18445,39488,1878,37610,11263,7820,3443,387,3056,29778,28663,12307,0
6,0,6,3,20.8,36.9,29.3,12.9,775792,410484,248181,35088,7200,205893,117127,26928,28810,15244,9216,1303,267,7646,4350,356614,243838,66074,48436,17638,46702,8318,38384,9864,7568,2296,268,2028,36153,32220,18927,1
0,0,7,9,29.1,29,20,21.9,494372,304356,129989,14739,2393,112857,60027,22362,22108,13610,5813,659,107,5047,2684,391721,276704,90023,69391,20632,24994,729,24265,12553,10642,1911,359,1552,31205,26001,15635,0
10,0,3,2,17.3,29,32.9,20.7,3039981,1549809,918250,162263,4799,751188,571922,91569,33199,16925,10028,1772,52,8204,6246,2750730,2025024,542602,397628,144974,183104,13507,169597,61995,50297,11698,102,11596,44370,40261,14625,3
7,0,1,1,9.9,21.4,27.3,41.5,23451150,14666362,4213402,598001,124323,3491078,4571386,521356,44981,28131,8082,1147,238,6696,8768,23794440,18354990,3949922,2566844,1383078,1489528,865,1488663,398859,342053,56806,46,56760,59656,53661,26227,387
0,0,7,9,11.9,31.4,25.4,31.2,477568,274411,73192,7035,1615,64542,129965,16315,29272,16820,4486,431,99,3956,7966,347831,237039,61260,41618,19642,49532,13863,35669,11297,8069,3228,637,2591,30790,29377,13766,2
0,0,9,11,20.1,43.9,23,13,129351,86267,25559,2000,177,23382,17525,4198,30813,20550,6088,476,42,5570,4175,89290,36473,10171,7550,2621,42646,31526,11120,2411,1525,886,315,571,37034,23917,19475,0
4,0,8,7,18.7,35.6,29.8,15.8,196620,117119,47532,2681,3759,41092,31969,5521,35613,21213,8609,486,681,7443,5790,115863,68045,17592,11153,6439,30226,11228,18998,3351,2246,1105,468,637,34576,30296,29824,0
9,0,1,1,16.5,36.9,27.5,19.2,23527,714788,214882,22513,2357,190012,173796,29754,37086,24023,7222,757,79,6386,5841,326430,225595,67270,49988,17282,33565,-2700,36265,8705,6111,2594,193,2401,37499,36916,15104,1
5,0,7,9,12.5,30.7,39.7,17,699771,302687,254890,23129,12045,219716,142194,20877,33519,14499,12209,1108,577,10524,6811,309731,200226,66987,47005,19982,42518,3826,38692,9317,6423,2894,313,2581,33244,31173,14991,0
4,0,8,7,30.2,31.7,22.6,15.5,178861,103977,53122,6114,2112,44896,21762,4859,36810,21399,10933,1258,435,9240,4479,90246,27287,8737,6589,2148,54222,-1752,55974,1895,922,973,496,477,47623,29595,117346,1
3,0,8,4,29.1,38.9,21.6,10.4,607220,290659,183522,12380,2806,168336,133039,23416,25932,12413,7837,529,120,7189,5682,255934,170784,41572,29671,11901,43578,2440,41138,10306,6062,4244,203,4041,24833,28173,10180,0
6,0,1,1,4,23.6,29.5,42.9,22221018,15544941,2455768,96094,131670,2228004,4220309,390810,56859,39776,6284,246,337,5701,10799,15604701,11473428,2841065,1922757,918308,1290208,13368,1276840,288606,237266,51340,491,50849,54069,48357,25110,277
2,0,8,7,34.5,33.8,20.1,11.7,134855,77067,37356,6341,462,30553,20432,6269,21511,12293,5959,1011,74,4874,3259,71968,41244,13111,10663,2448,17613,15316,2297,2269,1730,539,104,435,31718,23840,5280,0
1,0,7,11,20.4,33.5,33.7,12.5,425877,326224,53711,4644,808,48259,45942,13115,32473,24874,4095,354,62,3680,3503,302489,204036,51947,37231,14716,46506,13206,33300,7638,5545,2093,374,1719,39603,36796,19372,1
2,0,2,2,15,27.6,37.5,19.9,7113352,4726832,892285,109613,12966,769706,1494235,217567,32695,21726,4101,504,60,3538,6868,4670638,3405191,914518,636120,278398,350929,-4168,355097,125287,101136,24151,878,23273,37280,33669,15258,28
4,0,8,7,15.9,40.6,29.3,14.2,250055,149569,57747,3379,1381,52987,42739,6885,36319,21724,8387,491,201,7696,6208,116945,56431,15877,11536,4341,44637,33458,11179,3363,1961,1402,448,954,34774,28777,11718,0
8,0,1,1,10.6,27.9,32.8,28.7,34519258,21151908,6661629,885076,121743,5654810,6705721,886595,38935,23857,7514,998,137,6378,7563,32467276,25113959,5657601,3774280,1883321,1695716,2124,1693592,589421,496005,93416,288,93128,55083,50632,18186,55
1,0,1,1,8,27.6,30.2,34.1,20236321,14447080,1624550,67012,40492,1517046,4164691,380799,53142,37939,4266,176,106,3984,10937,15053257,10924852,2573353,1733478,839875,1555052,4467,1550585,295121,247619,47502,581,46921,51007,44120,33047,284
0,0,6,6,13.6,35.4,36.3,14.7,415947,285269,57214,4458,912,51844,73464,12595,33025,22649,4543,354,72,4116,5833,270661,183707,45791,30036,15755,41163,7247,33916,7151,5282,1869,315,1554,37849,34780,21825,0
0,0,1,1,30.3,37.2,21,11.5,345398,224886,64781,8286,739,55756,55731,12985,26600,17319,4989,638,57,4294,4292,136502,87990,22644,16557,6087,25868,5410,20458,4809,3003,1806,251,1555,28385,29301,13156,1
5,0,8,7,10.3,32.7,32,25,96964,44221,24945,1330,1180,22435,27798,3080,31482,14357,8099,432,383,7284,9025,37176,22385,6899,4607,2292,7892,604,7288,1486,831,655,131,524,25017,26937,13908,0
9,0,6,6,27.7,31.7,27.2,13.4,433190,331689,62088,7159,600,54329,39413,7909,54772,41938,7850,905,76,6869,4983,316099,103778,24064,16187,7877,188257,168979,19278,4038,2745,1293,448,845,78281,37806,22814,0
7,0,7,9,11.2,36.4,30.3,22,1369502,654082,405977,26940,9266,369771,309443,44175,31002,14807,9190,610,210,8371,7005,732145,503345,126104,85885,40219,102696,-2744,105440,24132,16861,7271,501,6770,30339,29853,15575,15
8,0,6,6,17,34.8,35.4,12.7,961832,474414,204115,14546,2326,187243,283303,18277,52625,25957,11168,796,127,10245,15501,587296,340410,79400,55668,23732,167486,-6391,173877,12197,8246,3951,1074,2877,48151,41282,60437,1
6,0,1,1,20.8,26.2,33.2,19.8,64038851,41169591,13770701,2343509,969301,10457891,9098559,2062381,31051,19962,6677,1136,470,5071,4412,40636001,27679658,8275957,6171693,2104264,4680386,197657,4482729,850962,645503,205459,1087,204372,47753,42881,21934,157
5,0,9,12,15,30.4,35.4,19.2,204034,108246,65126,11075,3330,50721,30662,8312,24547,13023,7835,1332,401,6102,3689,71118,41822,11974,9012,2962,17322,1147,16175,3066,1497,1569,530,1039,23196,27937,15568,0
5,0,3,2,15.2,41.2,27.1,16.5,455637,261761,140585,16241,4387,119957,53291,17193,26501,15225,8177,945,255,6977,3100,180589,107099,30013,21349,8664,43477,707,42770,5452,3732,1720,396,1324,33123,28697,32304,0
1,0,7,11,16.2,28.2,37.8,17.7,1313290,690924,356226,43060,8601,304565,266140,44487,29521,15531,8007,968,193,6846,5982,791288,458372,151981,113889,38092,180935,22457,158478,22235,15235,7000,680,6320,35587,30087,25076,0
7,0,7,9,29.8,28,27.2,15.1,379683,288675,50418,4416,923,45079,40590,8037,47242,35918,6273,549,115,5609,5050,394190,252802,51782,34415,17367,89606,-4878,94484,5616,4331,1285,292,993,70191,58370,95150,0
7,0,8,7,14.2,36,38.6,11.2,187407,90247,71854,9485,2118,60251,25306,5961,31439,15140,12054,1591,355,10108,4245,130280,91222,30743,24396,6347,8315,1685,6630,2863,2150,713,192,521,45505,42429,12726,0
5,0,6,6,7.5,39.1,33.2,20.2,644479,412983,112241,6884,6571,98786,119255,16335,39454,25282,6871,421,402,6048,7301,459697,297382,98210,68276,29934,64105,18611,45494,11823,8955,2868,857,2011,38882,33208,22623,10
8,0,6,6,21.5,36,23.4,19.1,372267,213147,103833,8453,1134,94246,55287,10185,36551,20928,10195,830,111,9253,5428,179941,102772,28402,21441,6961,48767,16995,31772,5598,3230,2368,845,1523,32144,31818,20861,0
2,0,1,1,15.5,38.5,33.3,12.7,2800165,1960450,470067,36902,20192,412973,369648,91130,30727,21513,5158,405,222,4532,4056,1038206,701946,215034,155646,59388,121226,-2237,123463,32477,22518,9959,1155,8804,31967,31173,14024,21
7,0,4,3,7.6,29.5,31.4,31.5,3003805,1842330,510061,46073,7621,456367,651414,60327,49792,30539,8455,764,126,7565,10798,1575246,994621,256230,179190,77040,324395,2773,321622,37096,26582,10514,294,10220,42464,37417,31470,7
5,0,9,12,11.5,30.7,34.6,23.3,92673,53200,23795,1459,464,21872,15678,2385,38857,22306,9977,612,195,9171,6574,46298,20945,5746,3891,1855,19607,9329,10278,1385,789,596,302,294,33428,26546,34959,0
6,0,4,3,8,29.1,28,35,9892217,6646055,1388908,78452,100960,1209496,1857254,189076,52319,35150,7346,415,534,6397,9823,4765220,2620380,703531,494369,209162,1441309,10672,1430637,95598,63285,32313,1031,31282,49846,41406,45734,92
5,0,9,8,25.5,37.4,27.8,9.3,29092,219705,320,7818,3535,79578,46753,15853,28525,13859,11234,1187,187,9860,3432,218611,162172,41015,29710,11305,15424,-1687,17111,5149,4291,858,145,713,42457,37794,23999,0
1,0,1,1,28.7,27.5,24.7,19.1,10123070,5918668,2317432,362307,31899,1923226,1886970,320131,31622,18488,7239,1132,100,6008,5894,15847995,12200219,2831091,1975631,855460,816685,0,816685,277562,253595,23967,0,23967,57097,48109,34075,68
6,0,4,5,13.3,27.2,31.6,27.9,1937503,1156797,447430,60602,18364,368464,333276,72687,26655,15915,6156,834,253,5069,4585,1085160,763574,225570,172854,52716,96016,21020,74996,31121,24352,6769,482,6287,34869,31356,11929,1
8,0,9,12,12.8,36,40.8,10.4,73262,35542,22629,2106,188,20335,15091,1921,38137,18502,11780,1096,98,10586,7856,39823,17032,5562,4154,1408,17229,3614,13615,957,604,353,169,184,41612,28199,73995,0
3,0,2,2,16.2,38.8,25.3,19.7,1978704,1379149,338637,24463,5814,308360,260918,55051,35943,25052,6151,444,106,5601,4740,1286846,954624,231115,155150,75965,101107,2373,98734,27665,22488,5177,555,4622,46515,42450,21362,4
6,0,4,5,14.8,36.4,29.9,18.9,2200046,1156940,663633,76329,13126,574178,379473,70736,31102,16356,9382,1079,186,8117,5365,1636107,1164871,330033,233503,96530,141203,-8752,149955,40337,32107,8230,1634,6596,40561,36281,22734,5
6,0,1,1,8.1,33.7,31.6,26.6,5435344,3712390,1014452,101341,37300,875811,708502,147140,36940,25230,6894,689,254,5952,4815,2151001,1442901,382585,268204,114381,325515,21996,303519,58033,42031,16002,1035,14967,37065,34329,20279,15
4,0,9,8,12.7,22.6,36.6,28.1,256449,160777,34665,3394,3130,28141,61007,10041,25540,16012,3452,338,312,2803,6076,150561,95661,24731,15851,8880,30169,6238,23931,5191,3009,2182,257,1925,29004,31792,12432,0
10,0,3,2,8.9,31.5,32,27.5,5430851,3319965,1115853,107196,27174,981483,995033,133435,40700,24881,8363,803,204,7356,7457,4530975,3392057,817376,566589,250787,321542,24780,296762,92276,78682,13594,738,12856,49102,43111,23084,38
7,0,9,10,9.4,40.5,32.1,18,177504,110643,23978,1520,198,22260,42883,3579,49596,30915,6700,425,55,6220,11982,104874,33444,8149,5632,2517,63281,49388,13893,2120,1141,979,517,462,49469,29311,30071,1
4,0,9,12,24.1,31,23.3,21.7,14235,167441,118700,8308,3000,107392,156608,12379,35766,13526,9589,671,242,8675,12651,130451,82446,21973,15867,6106,26032,1764,24268,4389,2748,1641,89,1552,29722,30002,15637,1
8,0,9,8,9.5,32.6,37.3,20.6,42987,26968,6361,530,237,5594,9658,1045,41136,25807,6087,507,227,5353,9242,39444,21240,4733,2887,1846,13471,3725,9746,729,448,281,106,175,54107,47411,55691,0
3,0,2,2,16.6,40.4,32.3,10.8,1676499,1117014,354162,36852,17182,300128,205323,65167,25726,17141,5435,566,264,4606,3151,862476,594705,181766,132499,49267,86005,31533,54472,24169,18077,6092,1034,5058,35685,32898,10769,10
10,0,1,1,5.5,19.1,37.9,37.5,22349010,14975828,3004538,156401,41120,2807017,4368644,373469,59842,40099,8045,419,110,7516,11697,12249412,8564104,2025626,1395007,630619,1659682,-4484,1664166,218962,158729,60233,1181,59052,55943,53954,28181,161
2,0,1,1,3,13.1,32,51.9,14636230,11831252,573436,29855,14562,529019,2231542,267177,54781,44282,2146,112,55,1980,8352,6446875,4592780,858242,532384,325858,995853,-2581,998434,146445,97032,49413,938,48475,44022,47333,20597,83
3,0,3,2,21.3,38.4,27.9,12.5,2517880,1542829,604773,74027,20704,510042,370278,81930,30732,18831,7382,904,253,6225,4519,1687572,1148473,347469,264584,82885,191630,94276,97354,39183,31515,7668,822,6846,43069,36442,14221,2
1,0,7,8,22.1,30.3,23.6,24,985387,643678,195097,14554,3635,176908,146612,36375,27090,17696,5363,400,100,4863,4031,730942,474401,150138,114838,35300,106403,20572,85831,22183,17760,4423,749,3674,32951,26712,23362,0
0,0,6,4,20.3,43.9,25.8,10,1141014,697476,274341,22575,9362,242404,169197,44837,25448,15556,6119,503,209,5406,3774,557561,357683,111203,81279,29924,88675,23566,65109,18940,12797,6143,1373,4770,29438,27951,13650,4
1,0,8,6,15,42.4,28.7,14,252859,160894,51816,3268,434,48114,40149,7622,33175,21109,6798,429,57,6313,5268,182182,113612,30165,21122,9043,38405,23115,15290,4891,3661,1230,371,859,37248,31033,17800,1
1,0,3,2,27,23.6,34.1,15.3,2860131,1916898,481379,64276,21339,395764,461854,91112,31391,21039,5283,705,234,4344,5069,1539944,958260,264581,184480,80101,317103,51412,265691,38627,28811,9816,983,8833,39867,33260,30079,3
8,0,4,3,16,35.1,32.3,16.5,3045362,1627940,988077,114273,18587,855217,429345,96874,31436,16805,10200,1180,192,8828,4432,1747021,1254756,323636,221831,101805,168629,16926,151703,44893,35507,9386,903,8483,38915,35338,17883,8
4,0,1,1,23.9,44.2,19.4,12.5,812073,506429,165821,13974,11840,140007,139823,23195,35011,21834,7149,602,510,6036,6028,227398,135122,36544,26114,10430,55732,11459,44273,7403,4637,2766,654,2112,30717,29140,20963,3
2,0,1,1,11.3,24.4,33.3,31,16598862,11658961,1812543,154850,27571,1630122,3127358,413571,40135,28191,4383,374,67,3942,7562,10156171,7787799,1605466,1056763,548703,762906,2571,760335,241693,193451,48242,313,47929,42021,40257,15864,99
8,0,7,11,8.2,25.8,39.6,26.4,457449,309969,73385,5004,954,67427,74095,9783,46760,31684,7501,511,98,6892,7574,355369,183525,47166,32784,14382,124678,67577,57101,7358,5057,2301,449,1852,48297,36291,30832,0
8,0,7,9,7.5,32.3,38.5,21.7,525674,357508,84789,5403,678,78708,83377,10832,48530,33005,7828,499,63,7266,7697,371079,150260,41403,30076,11327,179416,148060,31356,7471,4346,3125,1167,1958,49669,34574,16014,0
7,0,4,3,6.8,25.5,37.8,29.8,1549085,928878,255001,18000,16538,220463,365206,34426,44998,26982,7407,523,480,6404,10608,952475,603628,150313,98177,52136,198534,0,198534,28010,19596,8414,0,8414,34005,30804,23596,5
7,0,6,6,19.6,45.1,25.9,9.4,313613,148450,117209,13713,2667,100829,47954,13570,23111,10940,8637,1011,197,7430,3534,115098,72257,22329,16386,5943,20512,-3533,24045,4656,2600,2056,914,1142,24720,27791,21055,1
10,0,7,10,11.5,46.5,26,15.9,211065,111268,61168,4488,1309,55371,38629,4765,44295,23351,12837,942,275,11620,8107,122638,79193,26451,19303,7148,16994,-61,17055,2490,2056,434,31,403,49252,38518,42320,1
0,0,1,1,22.4,33.2,30.6,13.8,3858122,2824732,615519,59087,9220,547212,417871,140692,27422,20077,4375,420,66,3889,2970,1715428,1164794,279317,195009,84308,271317,4050,267267,57045,38393,18652,2399,16253,30071,30339,16444,14
9,0,3,2,13.1,43.5,23.1,20.4,5615637,3564685,1176008,91033,22218,1062757,874944,136510,41137,26113,8615,667,163,7785,6409,3137594,1969514,615086,449643,165443,552994,137140,415854,67212,52067,15145,1121,14024,46682,37827,29653,14
4,0,5,8,12.6,34.7,35.7,17,1809236,1388329,204796,12309,18245,174242,216111,44133,40995,31458,4640,279,413,3948,4897,1732856,1277572,290676,175933,114743,164608,-2006,166614,29597,25417,4180,221,3959,58548,50264,42085,5
1,0,7,9,23.3,36.3,27.8,12.6,128699,66136,42234,3663,227,38344,20329,6048,21280,10935,6983,606,38,6340,3361,64503,45711,13262,9653,3609,5530,1103,4427,2502,1672,830,470,360,25781,27339,12297,1
0,0,1,1,10.4,21.5,21.5,46.5,19570249,14614599,1274139,54077,53227,1166835,3681511,312617,62601,46749,4076,173,170,3732,11776,14928896,11326968,2368430,1600357,768073,1233498,2219,1231279,217095,180271,36824,369,36455,68767,62833,33775,310
2,0,6,3,27.9,28.5,24.5,19,1249778,754298,228004,17159,1432,209413,267476,32434,38533,23256,7030,529,44,6457,8247,772002,471423,109714,79032,30682,190865,2729,188136,21545,15241,6304,2189,4115,35832,30931,45720,2
6,0,3,2,26.8,28.3,28.9,15.9,8309420,4765195,2126949,384122,104282,1638545,1417276,246050,33771,19367,8644,1561,424,6659,5760,5325521,3416012,956306,590022,366284,953203,414118,539085,120041,99473,20568,2955,17613,44364,34341,30607,6
3,0,3,2,19.7,31.3,24.3,24.7,3458814,2281084,649403,67176,16324,565903,528327,109803,31500,20774,5914,612,149,5154,4812,2891148,2116183,563768,405926,157842,211197,5839,205358,73915,61260,12655,1581,11074,39114,34544,18544,7
3,0,6,6,12.7,43.2,29.4,14.7,393519,235870,91515,7804,2148,81563,66134,12447,31616,18950,7352,627,173,6553,5313,304604,195993,57285,40644,16641,51326,19876,31450,8635,6622,2013,552,1461,35276,29597,21526,1
9,0,7,11,13.7,34.7,37.6,14,151855,70568,52527,3890,769,47868,28760,4486,33851,15731,11709,867,171,10671,6411,99495,72670,22703,17822,4881,4122,-1661,5783,2098,1687,411,86,325,47424,43076,17794,0
4,0,1,1,15.7,27.6,26.2,30.6,38611158,25227398,5696779,439487,279178,4978114,7686981,801808,48155,31463,7105,548,348,6209,9587,25697264,18936780,4456513,3054322,1402191,2303971,20787,2283184,490819,388574,102245,570,101675,52356,48734,22456,147
7,0,6,6,8.2,33.4,37.7,20.7,842416,507967,149200,10411,3504,135285,185249,17358,48532,29264,8595,600,202,7794,10672,529511,259002,72037,51260,20777,198472,132343,66129,10874,7725,3149,681,2468,48695,33528,26795,1
7,0,6,6,36.7,33.5,20,9.9,1169116,829291,193198,19314,6832,167052,146627,37653,31050,22025,5131,513,181,4437,3894,790225,461374,122279,85095,37184,206572,64246,142326,19443,12808,6635,2177,4458,40643,36022,31926,0
8,0,1,1,19.9,38.8,27.1,14.3,919082,496028,305932,44273,5169,256490,117122,32722,28088,15159,9349,1353,158,7838,3579,470188,336517,89776,62873,26903,43895,14450,29445,11314,8850,2464,416,2048,41558,38025,14377,3
8,0,1,1,13.8,47.6,25.8,12.8,1365115,818458,383439,38891,7847,336701,163218,44126,30937,18548,8690,881,178,7630,3699,506314,308769,99503,77083,22420,98042,6172,91870,14149,8978,5171,1261,3910,35784,34392,23496,3
2,0,5,8,15.4,31.4,31.1,22.1,5584327,3295609,1012555,146972,18652,846931,1276163,177733,31420,18542,5697,827,105,4765,7180,3700721,2570462,627416,436295,191121,502843,7651,495192,103435,73134,30301,3847,26454,35778,35147,18719,7
7,0,2,2,7.6,21.2,32.8,38.4,9727615,5979736,2047552,265000,71255,1711297,1700327,282631,34418,21157,7245,938,252,6055,6016,9197238,6739760,1868551,1352354,516197,588927,5104,583823,188417,155757,32660,818,31842,48813,43271,18335,60
5,0,2,2,17,43.2,26.7,13.2,1584001,871494,531761,59380,14232,458149,180746,56872,27852,15324,9350,1044,250,8056,3178,624608,425507,114965,82321,32644,84136,-1558,85694,17517,12168,5349,1425,3924,35657,34969,21838,1
7,0,6,5,8.8,42.5,34,14.8,1541425,878668,401908,23930,11496,366482,260849,41345,37282,21252,9721,579,278,8864,6309,1066522,740496,235389,171637,63752,90637,17985,72652,24578,19896,4682,486,4196,43393,37218,17315,4
8,0,7,11,31.8,29.2,26.7,12.4,372603,290759,46896,4229,611,42056,34948,7102,52465,40940,6603,595,86,5922,4921,335536,158559,34738,22173,12565,142239,58212,84027,5763,3844,1919,330,1589,58222,41248,52880,0
9,0,2,2,12.1,30.7,28.7,28.4,10967344,7067051,2100641,240587,19246,1840808,1799652,267733,40964,26396,7846,899,72,6876,6722,7896143,5314944,1316410,906184,410226,1264789,2106,1262683,153975,128804,25171,605,24566,51282,41264,51400,111
1,0,1,1,31.6,28.2,21.1,19.1,20577241,12394687,4907668,718243,70527,4118898,3274886,621109,33130,19956,7901,1156,114,6632,5273,24013653,18109591,4041686,2711929,1329757,1862376,0,1862376,413159,362263,50896,0,50896,58122,49990,36592,40
0,0,2,2,21.6,34.5,26,17.9,3356994,2297980,607530,52095,8099,547336,451484,115336,29106,19924,5267,452,70,4746,3915,2269304,1586035,392025,277408,114617,291244,-1631,292875,58380,44764,13616,1125,12491,38871,35431,23447,7
7,0,9,10,11.6,39.1,34.2,15.2,324834,119596,135563,8304,3118,124141,69675,10570,30732,11315,12825,786,295,11745,6592,88169,53853,16315,11798,4517,18001,-7,18008,3035,1729,1306,206,1100,29051,31147,16371,0
5,0,2,2,7.7,24.7,33.2,34.4,5011878,3532876,698012,54287,32361,611364,780990,125004,40094,28262,5584,434,259,4891,6248,1578084,1079916,261909,185391,76518,236259,1226,235033,45127,31734,13393,133,13260,34970,34030,17725,25
5,0,3,2,13,28.8,36.7,21.6,2442605,1602245,427000,32797,39739,354464,413360,54988,44421,29138,7765,596,723,6446,7517,2301612,1253028,439903,369881,70022,608681,1573,607108,38440,28649,9791,18,9773,59875,43737,62121,7
9,0,2,2,14.1,42.3,29.1,14.5,2062040,1158015,674384,74970,5893,593521,229641,61538,33508,18818,10959,1218,96,9645,3732,694158,460813,139230,106551,32679,94115,-299,94414,18554,13750,4804,547,4257,37413,33514,22179,1
2,0,7,8,18.9,31.4,37.4,12.3,601425,375672,134067,12318,1102,120647,91686,20554,29261,18277,6523,599,54,5870,4461,441001,332909,88763,61942,26821,19329,-1192,20521,11894,9555,2339,261,2078,37078,34841,9875,2
3,0,3,2,31.3,27.4,26,15.3,7384511,4244339,1738950,268610,52423,1417917,1401222,235272,31387,18040,7391,1142,223,6027,5956,4828967,3366175,927456,596380,331076,535336,119551,415785,121722,101284,20438,3140,17298,39672,33235,24037,8
3,0,4,3,13.3,36.5,31.1,19.1,1808551,1200321,294115,17039,9274,267802,314115,45919,39386,26140,6405,371,202,5832,6841,1187097,817770,214611,150939,63672,154716,49524,105192,29949,22789,7160,1395,5765,39637,35884,18247,20
7,0,1,1,11.2,17.1,24.2,47.5,58575379,38957070,5004821,653902,184943,4165976,14613488,1096535,53419,35527,4564,596,169,3799,13327,49158123,34844234,6798929,4496227,2302702,7514960,6380,7508580,826345,636864,189481,993,188488,59489,54712,39836,793
2,0,2,2,10.9,26.8,37.3,25,15382944,9681760,2786273,293786,52377,2440110,2914911,456150,33723,21225,6108,644,115,5349,6390,11568974,8447875,2164054,1381213,782841,957045,11483,945562,281450,227774,53676,2304,51372,41105,37089,18406,68
3,0,2,2,12.9,30.1,29.5,27.4,18555974,7031279,3187426,119306,50561,3017559,8337269,377178,49197,18642,8451,316,134,8000,22104,8384758,6341991,1356652,919990,436662,686115,-332,686447,214691,160090,54601,230,54371,39055,39615,12625,31
5,0,7,10,25.7,34.1,28.8,11.5,92670,42504,31300,3074,1007,27219,18866,3590,25813,11840,8719,856,281,7582,5255,43387,31350,10808,8617,2191,1229,-4084,5313,1367,887,480,178,302,31739,35344,17593,0
0,0,7,8,11.5,35.4,31.7,21.3,250998,182077,36676,1954,335,34387,32245,6698,37474,27184,5476,292,50,5134,4814,154229,57337,15244,11047,4197,81648,46372,35276,3338,2246,1092,309,783,46204,25528,45052,1
9,0,8,7,10.3,35.9,36.3,17.5,169354,101541,34215,1972,199,32044,33598,3725,45464,27259,9185,529,53,8602,9020,113620,73973,18859,13046,5813,20788,4320,16468,2648,1727,921,307,614,42908,42833,26821,0
0,0,7,11,5.9,17.8,32.7,43.6,450994,290455,35235,2731,869,31635,125304,14456,31198,20092,2437,189,60,2188,8668,368292,247617,59402,40949,18453,61273,3907,57366,12133,8638,3495,156,3339,30355,28666,17181,0
4,0,1,1,29.8,33.1,21.4,15.6,1002245,571614,230666,17185,11394,202087,199965,29542,33926,19349,7808,582,386,6841,6769,363028,246785,64255,46748,17507,51988,4770,47218,12042,7455,4587,260,4327,30147,33103,10912,4
4,0,2,2,33,30.4,25.8,10.9,415488,253647,108972,9907,6116,92949,52869,16657,24944,15228,6542,595,367,5580,3174,156867,99174,26291,18953,7338,31402,2654,28748,5008,3198,1810,204,1606,31323,31011,17900,0
4,0,1,1,18.4,29.6,26.6,25.4,35218272,24023965,6349093,895365,418549,5035179,4845214,898394,39201,26741,7067,997,466,5605,5393,40815636,28054126,6338229,4278985,2059244,6423281,9594,6413687,681846,593130,88716,203,88513,59860,47298,72460,72
9,0,5,8,9.9,32.9,32.1,25,2359281,1515077,425628,40377,5423,379828,418576,55566,42459,27266,7660,727,98,6836,7533,1802898,1153237,293656,202897,90759,356005,18029,337976,38676,31759,6917,576,6341,46615,36312,53300,2
2,0,1,1,20.1,36.5,29,14.3,3431470,2341395,613593,47938,12110,553545,476482,105672,32473,22157,5807,454,115,5238,4509,2371612,1766165,456159,324347,131812,149288,1038,148250,60689,50810,9879,530,9349,39078,34760,15857,4
4,0,1,1,8.6,28.3,34.9,28.2,6941817,4986308,1031436,55044,110440,865952,924073,181082,38335,27536,5696,304,610,4782,5103,2490561,1755256,479976,338627,141349,255329,-720,256049,68483,47320,21163,643,20520,36368,37093,12478,84
2,0,4,5,17.9,43.7,26.5,11.9,1890358,1267317,370929,27147,7159,336623,252112,61571,30702,20583,6024,441,116,5467,4095,1294146,928872,270228,196601,73627,95046,7663,87383,32957,27629,5328,677,4651,39268,33619,18788,3
7,0,4,5,14.8,35.3,32.8,17,1783914,1023326,524121,57838,20803,445480,236467,49828,35801,20537,10519,1161,417,8940,4746,990993,677597,215178,155752,59426,98218,11261,86957,24622,19205,5417,607,4810,40248,35282,18078,5
10,0,7,9,16.5,42.7,29.8,11,367409,210616,91156,6903,506,83747,65637,10215,35968,20618,8924,676,50,8198,6426,698178,486471,171289,130747,40542,40418,22266,18152,8618,7381,1237,252,985,81014,65909,18428,1
8,0,1,1,18.9,27.7,22.6,30.8,91822554,56172787,23167416,3240900,600136,19326380,12482351,2307766,39789,24341,10039,1404,260,8374,5409,47076867,29920376,8986363,6472142,2514221,8170128,0,8170128,895609,631447,264162,0,264162,52564,47384,30928,129
6,0,2,2,17.4,31.8,31.7,19,4497422,2775793,987302,101663,34520,851119,734327,126926,35433,21869,7779,801,272,6706,5785,3845318,2699345,611993,392837,219156,533980,-5031,539011,83834,69818,14016,739,13277,45868,38663,40597,7
1,0,7,11,12.1,35,37.8,15.2,326273,188582,71740,4796,499,66445,65951,11194,29147,16847,6409,428,45,5936,5892,227545,154957,42556,29530,13026,30032,8542,21490,7223,5589,1634,317,1317,31503,27725,16317,1
0,0,7,8,29.5,34.3,24.6,11.6,1141362,663381,339688,34578,4114,300996,138293,41995,27179,15797,8089,823,98,7167,3293,856397,572831,158329,114072,44257,125237,30013,95224,25766,21170,4596,575,4021,33237,27059,23682,2
2,0,1,1,19.2,26.2,29.3,25.3,36964179,25989285,5190525,962082,65408,4163035,5784369,921119,40130,28215,5635,1044,71,4520,6280,33898712,24454202,5161389,3478673,1682716,4283121,-1413,4284534,650256,547071,103185,527,102658,52131,44700,41736,137
1,0,7,11,21.9,36.8,25.5,15.8,148705,72458,36457,2804,257,33396,39790,5469,27191,13249,6666,513,47,6106,7276,75143,53363,13641,9565,4076,8139,-3969,12108,3388,2393,995,230,765,22179,22300,15827,0
3,0,1,1,12.7,32,34.4,20.9,4081825,2905189,542232,40511,9324,492397,634404,109969,37118,26418,4931,368,85,4478,5769,1611225,1042805,235679,157768,77911,332741,23470,309271,43720,29672,14048,1248,12800,36853,35144,24162,8
1,0,6,6,26.7,39.7,22.4,11.2,766908,473724,202609,16893,3096,182620,90575,32248,23782,14690,6283,524,96,5663,2809,390925,272792,67669,46117,21552,50464,5365,45099,12216,9114,3102,535,2567,32001,29931,17569,0
8,0,7,8,12.5,26.6,33.2,27.7,1023491,459921,309651,36443,7914,265294,253919,32840,31166,14005,9429,1110,241,8078,7732,511101,344469,92193,63649,28544,74439,-2276,76715,17380,11145,6235,889,5346,29407,30908,14350,6
8,0,1,1,9.2,24,31.2,35.7,9132064,6819579,1186596,94012,24661,1067923,1125889,224487,40680,30379,5286,419,110,4757,5015,3025082,1986149,479569,340173,139396,559364,14206,545158,85304,52251,33053,336,32717,35462,38012,16663,100
5,0,7,11,30.4,36.6,23.4,9.6,432807,276125,99664,12015,3915,83734,57018,15519,27889,17793,6422,774,252,5396,3674,339566,255349,59158,41348,17810,25059,-4801,29860,7979,6330,1649,251,1398,42557,40339,21359,0
0,0,1,1,27.2,46.9,16.2,9.7,346861,239098,66501,7773,1459,57269,41262,14884,23304,16064,4468,522,98,3848,2772,116308,79798,23298,17438,5860,13212,-3556,16768,4820,2821,1999,828,1171,24130,28287,14319,1
3,0,1,1,12.4,25.3,28,34.3,21468293,13422619,3555362,426798,92850,3035714,4490312,502890,42690,26691,7070,849,185,6037,8929,22282169,17439055,3955216,2640853,1314363,887898,826,887072,409024,354211,54813,26,54787,54476,49234,16191,242
7,0,9,12,8.4,30.2,42.3,19.1,142626,92119,23423,1348,254,21821,27084,2789,51139,33029,8398,483,91,7824,9711,95113,43457,12605,9386,3219,39051,20744,18307,2306,1437,869,271,598,41246,30241,30614,2
8,0,0,0,13.9,26.3,24.5,35.3,1081132827,679972025,185876168,22132006,4998327,158745835,215284634,19712514,54845,34494,9429,1123,254,8053,10921,819356563,564948356,140973549,100291337,40682212,113434658,1418840,112015818,11619137,9051229,2567908,32230,2535678,70518,62417,44176,0
10,0,5,8,8.7,35.7,37.1,18.5,2608984,1992384,235222,14502,7716,213004,381378,49293,52928,40419,4772,294,157,4321,7737,2546905,1745610,415050,258217,156833,386245,-6083,392328,37472,29852,7620,694,6926,67968,58475,56646,1
8,0,2,2,10.6,22,21,46.5,91893783,61729580,7081236,538740,304119,6238377,23082967,942865,97462,65470,7510,571,323,6616,24482,56976689,36293200,6852575,4655075,2197500,13830914,12413,13818501,639196,447001,192195,367,191828,89138,81193,72036,699
0,0,6,6,38.1,27.9,20.6,13.4,193327,140903,36264,4243,370,31651,16160,6178,31293,22807,5870,687,60,5123,2616,121977,41370,11288,8612,2676,69319,62974,6345,2596,1582,1014,427,587,46987,26150,10809,0
6,0,8,6,9.4,36.7,32.2,21.7,564263,404892,70261,4761,1137,64363,89110,11691,48265,34633,6010,407,97,5505,7622,371463,140150,37381,26442,10939,193932,144438,49494,7140,4641,2499,852,1647,52026,30198,30051,0
1,0,8,7,15.9,40.6,29.3,14.2,206543,119787,51196,3295,479,47422,35560,7122,29001,16819,7188,463,67,6659,4993,86112,50529,14938,10926,4012,20645,10142,10503,3400,2037,1363,454,909,25327,24806,11554,1
1,0,7,11,22.8,35.1,30.6,11.5,125971,68843,34531,4370,388,29773,22597,6012,20953,11451,5744,727,65,4952,3759,65128,42217,11846,9131,2715,11065,7449,3616,2057,1509,548,228,320,31662,27977,11300,0
10,0,9,8,11.4,38.1,35.4,15,434400,280964,87441,7226,1443,78772,65995,10872,39956,25843,8043,665,133,7245,6070,166291,100194,29487,22217,7270,36610,11045,25565,4496,2808,1688,610,1078,36986,35682,23715,0
5,0,8,7,15.5,35.6,23.9,25,25174,30467,347,7208,3588,128070,79408,2297,32892,13264,8993,506,168,8318,10636,26757,15610,4741,3621,1120,6406,1092,5314,1306,604,702,224,478,20488,25844,11117,2
0,0,4,5,19.7,48.2,19.9,12.2,2595273,1746518,499682,39439,8992,451251,349073,92286,28122,18925,5414,427,97,4890,3783,1649474,1099833,296067,208952,87115,253574,8028,245546,47961,37832,10129,925,9204,34392,29072,26678,9
10,0,9,10,12.5,45.1,30,12.4,763905,419910,234650,22945,2239,209466,109345,23167,32974,18125,10129,990,97,9042,4720,434019,303677,77458,54277,23181,52884,3678,49206,10356,7030,3326,678,2648,41910,43197,18582,5
8,0,9,12,15,30.4,35.4,19.2,238499,133651,69869,11009,1841,57019,34979,8192,29114,16315,8529,1344,225,6960,4270,101131,48017,12947,9465,3482,40167,12156,28011,3191,1583,1608,553,1055,31693,30333,26551,0
7,0,3,2,9.8,36.9,31.9,21.4,5987361,3695994,1189469,123437,46795,1019237,1101898,160092,37400,23087,7430,771,292,6367,6883,3699992,2642195,752905,537371,215534,304892,16687,288205,79446,64691,14755,1329,13426,46572,40843,21466,39
5,0,8,7,13.3,42.9,32.2,11.6,446497,211207,172833,18759,11361,142713,62457,15847,28175,13328,10906,1184,717,9006,3941,199415,130865,44141,32755,11386,24409,2799,21610,6561,4845,1716,398,1318,30394,27010,16396,3
2,0,7,8,35.2,33,21.8,10,993207,608797,231379,34672,2945,193762,153031,41299,24049,14741,5603,840,71,4692,3705,728517,525289,134274,99145,35129,68954,26504,42450,21831,17757,4074,516,3558,33371,29582,11931,0
6,0,9,8,5.3,36.4,33.2,25.1,78699,36727,23308,1761,1037,20510,18664,2178,36134,16863,10702,809,476,9417,8569,18027,9549,3578,2712,866,4900,0,4900,682,443,239,0,239,26433,21555,20502,3
6,0,4,3,7.8,37.2,38.7,16.2,2187590,1333990,575938,56602,28152,491184,277662,69965,31267,19067,8232,809,402,7020,3969,876521,572590,176918,130650,46268,127013,28672,98341,25400,17500,7900,945,6955,34509,32719,14140,6
4,0,8,7,22.5,34.5,31.2,11.9,96031,50880,28750,4539,1523,22688,16401,5797,16566,8777,4959,783,263,3914,2829,56231,42627,10929,8326,2603,2675,-661,3336,1792,1229,563,226,337,31379,34684,9899,0
2,0,9,12,14.3,43.4,27.9,14.4,103087,69350,15517,610,137,14770,18220,2768,37242,25054,5606,220,49,5336,6582,91387,59135,13258,8260,4998,18994,2171,16823,2188,1441,747,239,508,41767,41037,33116,0
7,0,6,6,28.2,34.8,26.3,10.6,446665,270944,125393,15885,3112,106396,50328,17151,26043,15798,7311,926,181,6203,2934,238555,159542,45053,29283,15770,33960,13150,20810,6999,5524,1475,501,974,34084,28882,21366,0
9,0,2,2,6.1,34.6,34.9,24.5,1013966,665727,162616,10981,3521,148114,185623,23570,43019,28245,6899,466,149,6284,7875,643775,417938,117053,81141,35912,108784,41103,67681,15797,11057,4740,1449,3291,40753,37798,20565,5
3,0,3,2,32.3,35.9,21.1,10.6,545901,287368,187728,12944,2246,172538,70805,18291,29845,15711,10263,708,123,9433,3871,329591,239299,68766,48085,20681,21526,123,21403,7470,6058,1412,77,1335,44122,39501,16032,4
5,0,1,1,10.9,33.4,32,23.7,2181068,1433427,488671,44909,30973,412789,258970,65248,33427,21969,7489,688,475,6326,3969,1186976,698732,288167,228694,59473,200077,26519,173558,27270,20751,6519,633,5886,43527,33672,29487,20
5,0,4,3,12.7,30.6,28.3,28.4,1697643,970802,434065,45583,17235,371247,292776,49263,34461,19707,8811,925,350,7536,5943,1762596,1241739,421013,334795,86218,99844,-4018,103862,36936,31547,5389,527,4862,47720,39362,21362,4
7,0,4,5,8.6,38.8,32.9,19.7,3333194,2132895,635916,37278,33794,564844,564383,80729,41289,26420,7877,462,419,6997,6991,2186826,1431345,425397,304838,120559,330084,74434,255650,43972,35630,8342,1116,7226,49732,40172,35379,14
0,0,1,1,14,43.9,26.2,15.9,1469076,1138784,178706,14696,3961,160049,151586,46952,31289,24254,3806,313,84,3409,3229,1770388,1377746,323039,223965,99074,69603,-1947,71550,31974,27151,4823,862,3961,55370,50744,18064,11
5,0,4,5,14.1,39.7,22.5,23.8,1378055,893813,282341,17363,21745,243233,201901,44990,30630,19867,6276,386,483,5406,4488,969532,633227,190909,138356,52553,145396,23673,121723,21842,17248,4594,552,4042,44388,36713,30115,3
5,0,7,11,11.4,30.3,33,25.3,784012,473815,165181,12355,8090,144736,145016,18517,42340,25588,8921,667,437,7816,7832,549239,290489,103287,84734,18553,155463,7584,147879,10374,7864,2510,82,2428,52944,36939,60906,1
10,0,3,2,9.3,44.6,29.5,16.6,909417,533965,248682,21619,1479,225584,126770,26389,34462,20234,9424,819,56,8548,4804,401043,278741,75606,53647,21959,46696,-564,47260,10906,8164,2742,514,2228,36773,34143,21212,1
2,0,7,9,26.8,34.8,26.3,12.1,27155,322003,187934,23058,1387,163489,111976,25030,24847,12865,7508,921,55,6532,4474,351231,249668,64140,44489,19651,37423,-2750,40173,11797,8369,3428,1068,2360,29773,29832,17022,0
9,0,9,10,26.6,41.9,23.8,7.6,405343,138806,220992,32696,1616,186680,45545,17921,22618,7745,12331,1824,90,10417,2541,147585,96250,35143,27143,8000,16192,-976,17168,4087,2854,1233,139,1094,36111,33725,15693,0
9,0,3,2,9.6,35.3,30,25.1,3453757,2101831,865762,89489,10436,765837,486164,87414,39510,24045,9904,1024,119,8761,5562,2391228,1689735,530665,388716,141949,170828,437,170391,45297,38468,6829,347,6482,52790,43926,26287,81
9,0,4,3,12.5,46.5,27.3,13.7,2112371,1314657,495227,43146,7346,444735,302487,58562,36071,22449,8456,737,125,7594,5165,1315620,920153,251242,171213,80029,144225,22323,121902,27902,21944,5958,761,5197,47151,41932,23456,9
0,0,9,12,12.6,34,33.6,19.8,43303,25257,9117,366,63,8688,8929,1709,25338,14779,5335,214,37,5084,5225,27850,15241,3831,2439,1392,8778,4847,3931,1180,708,472,197,275,23602,21527,14295,0
10,0,3,2,15.8,35.8,25.7,22.7,1101158,690049,223802,19594,1115,203093,187307,26705,41234,25840,8381,734,42,7605,7014,456646,293097,95535,76120,19415,68014,19096,48918,10612,7596,3016,145,2871,43031,38586,17039,1
7,0,1,1,4.5,14.4,23,58.1,15200356,12270122,857381,49771,17168,790442,2072853,193073,78729,63552,4441,258,89,4094,10736,10767519,5824079,1092697,702437,390260,3850743,-3122,3853865,149534,106678,42856,1041,41815,72007,54595,92165,53
9,0,4,5,13.4,31.4,34.5,20.7,1621615,959197,369594,35544,4881,329169,292824,39371,41188,24363,9387,903,124,8361,7438,1079142,738796,177476,124526,52950,162870,12251,150619,21766,17470,4296,944,3352,49579,42289,44934,8
8,0,1,1,13,22.5,34.6,29.9,62592345,39578094,12304436,1636910,413312,10254214,10709815,1459474,42887,27118,8431,1122,283,7026,7338,50505004,35215615,10975066,8695215,2279851,4314323,61421,4252902,800681,637364,163317,1152,162165,63078,55252,26226,156
10,0,3,2,13.5,30.8,40.1,15.6,477580,303669,101182,14869,628,85685,72729,17861,26739,17002,5665,832,35,4797,4072,64279,35396,15134,12827,2307,13749,3243,10506,1891,1113,778,57,721,33992,31802,14571,0
5,0,3,2,20.8,22.2,29.6,27.4,6344861,3778770,1627416,251399,72455,1303562,938675,210114,30197,17984,7745,1196,345,6204,4467,4134891,2604621,732887,531391,201496,797383,164093,633290,95627,74249,21378,1667,19711,43240,35080,32129,21
10,0,6,6,8.8,42.4,30.3,18.5,2184740,1296956,509001,25742,5367,477892,378783,51684,42271,25094,9848,498,104,9246,7329,1179610,787126,235129,171659,63470,157355,35230,122125,28161,20783,7378,1062,6316,41888,37874,19336,10
10,0,6,6,13.1,39.6,29.7,17.5,608793,378570,118255,8427,1762,108066,111968,13852,43950,27330,8537,608,127,7801,8083,340649,174241,50691,37408,13283,115717,57432,58285,8219,5388,2831,852,1979,41447,32339,29452,2
10,0,1,1,8.6,25.3,34,32.1,11761373,7779004,1799639,144546,20917,1634176,2182730,273549,42995,28437,6579,528,76,5974,7979,5362751,3455056,915560,654398,261162,992135,-535,992670,124922,89666,35256,960,34296,42929,38533,28944,52
1,0,6,3,19,40.2,24.5,16.4,945721,600249,200657,14092,3880,182685,144815,32287,29291,18591,6215,436,120,5658,4485,632484,459743,130830,96731,34099,41911,280,41631,17351,14315,3036,625,2411,36452,32116,17267,6
7,0,2,2,15.7,35.5,29.3,19.5,19546204,10470754,5143913,620077,92758,4431078,3931537,615639,31749,17008,8355,1007,151,7198,6386,11269814,7993682,1877611,1280727,596884,1398521,91415,1307106,261791,205760,56031,1870,54161,43049,38850,24134,51
6,0,7,11,12.2,38.1,28.8,20.9,1089686,513383,402467,39152,9696,353619,173836,32715,33308,15693,12302,1197,296,10809,5314,572691,358518,103122,75233,27889,111051,14640,96411,16851,11061,5790,371,5419,33986,32413,17791,1
8,0,2,2,14.1,34.8,29.4,21.7,1244714,766677,302917,36069,6315,260533,175120,35553,35010,21564,8520,1015,178,7328,4926,728253,508243,135642,94731,40911,84368,7313,77055,17619,13648,3971,799,3172,41333,37239,24292,5
10,0,2,2,25.8,26.5,31.4,16.3,3117117,2078046,604823,95120,13744,495959,434248,88810,35099,23399,6810,1071,155,5584,4890,2146080,1319533,366538,224729,141809,460009,240410,219599,41025,34051,6974,682,6292,52312,38752,34901,8
3,0,4,5,16.5,37.8,28.1,17.6,2162156,1393076,348860,19959,15117,313784,420220,61231,35311,22751,5697,326,247,5125,6863,1724696,1269453,346418,245422,100996,108825,-867,109692,48818,39495,9323,1664,7659,35329,32142,14322,9
6,0,6,6,25.7,39.7,23.2,11.4,390846,203098,136242,18810,3670,113762,51506,14217,27491,14286,9583,1323,258,8002,3623,204869,117192,34889,25960,8929,52788,28871,23917,5267,3956,1311,177,1134,38897,29624,21091,0
6,0,3,2,9.8,25.9,39.3,25,6312934,2675069,2007867,129678,41636,1836553,1629998,210883,29936,12685,9521,615,197,8709,7729,2783218,1946374,496022,347877,148145,340822,-685,341507,87057,56126,30931,798,30133,31970,34679,11333,13
7,0,7,11,18.7,25.8,39.5,16,445003,259708,100286,14487,2545,83254,85009,12437,35781,20882,8064,1165,205,6694,6835,278515,155615,38819,27566,11253,84081,46242,37839,7062,4908,2154,493,1661,39439,31706,22781,0
9,0,9,12,10.9,25.4,44.2,19.4,225624,150742,32085,1690,149,30246,42797,3993,56505,37752,8035,423,37,7575,10718,167380,71023,18452,13123,5329,77905,59101,18804,3029,2013,1016,278,738,55259,35282,25480,0
4,0,9,10,14.2,32.6,33,20.3,134183,78410,29824,2998,2178,24648,25949,5068,26477,15472,5885,592,430,4863,5120,87441,65605,19674,13722,5952,2162,-3642,5804,3293,2386,907,235,672,26554,27496,8637,0
0,0,3,2,15.8,33.8,25.4,25,22784,188486,31106,3400,1383,26323,45464,7282,36399,25884,4272,467,190,3615,6243,69895,33309,10704,8012,2692,25882,2506,23376,2681,1353,1328,94,1234,26070,24619,18943,6
10,0,9,9,17.1,40.2,25,17.7,411801,230044,114920,9316,771,104833,66837,12008,34294,19158,9570,776,64,8730,5566,197732,131316,36581,26013,10568,29835,7486,22349,5690,3676,2014,917,1097,34751,35723,20373,0
5,0,7,11,11.3,40.6,33.9,14.2,707296,247665,331952,33184,14067,284701,127679,24438,28942,10134,13583,1358,576,11650,5225,262984,175174,58234,43752,14482,29576,-266,29842,8341,5881,2460,50,2410,31529,29786,12383,2
9,0,1,1,6.7,34.4,36.3,22.6,2533611,1924002,304060,21163,9453,273444,305549,50279,50391,38267,6047,421,188,5439,6077,1809517,1013142,282971,212562,70409,513404,39181,474223,23423,18761,4662,353,4309,77254,54003,110054,10
2,0,3,2,20.9,27.7,31.9,19.5,4675487,3035454,773206,70056,5923,697227,866827,118260,39536,25668,6538,592,50,5896,7330,4053758,2765393,568191,377860,190331,720174,-679,720853,93164,75151,18013,436,17577,43512,36798,41011,12
6,0,5,8,13.2,37.4,29,20.4,1756538,1036657,405153,43197,7906,354050,314728,48031,36571,21583,8435,899,165,7371,6553,1322719,910097,224215,150976,73239,188407,-5332,193739,31282,23829,7453,1248,6205,42284,38193,31223,7
5,0,2,2,8.2,28.9,33.1,29.8,6199751,4102330,1284571,124605,73312,1086654,812850,159365,38903,25742,8061,782,460,6819,5101,3319218,2294611,732909,542396,190513,291698,7817,283881,69814,55288,14526,456,14070,47544,41503,20176,38
10,0,6,6,27.2,33.8,30.4,8.6,393144,217792,111949,15510,676,95763,63403,13719,28657,15875,8160,1131,49,6980,4622,221718,113811,32959,25303,7656,74948,54368,20580,4566,3066,1500,224,1276,48558,37120,16129,1
10,0,6,5,11.2,50.3,23.2,15.3,1554069,886412,435051,30567,12643,391841,232606,45640,34051,19422,9532,670,277,8585,5097,798068,486028,169156,128449,40707,142884,20357,122527,18397,13460,4937,759,4178,43380,36109,29327,6
6,0,2,2,8.7,31.4,28.3,31.6,22248442,14420553,4418115,483048,158699,3776368,3409774,541293,41102,26641,8162,892,293,6977,6299,16415948,11941845,2886737,1965312,921425,1587366,4064,1583302,333379,270350,63029,250,62779,49241,44172,25220,295
5,0,1,1,5.1,32.4,36.6,25.9,1187981,800387,207641,16330,15567,175744,179953,32884,36126,24340,6314,497,473,5344,5472,419196,282002,70951,48141,22810,66243,-1606,67849,13141,8556,4585,1235,3350,31900,32960,20253,11
7,0,9,12,8.8,34.6,37.5,19,160729,89850,27649,1151,182,26316,43230,3079,52202,29182,8980,374,59,8547,14040,102413,51750,12629,8831,3798,38034,15699,22335,2867,1463,1404,476,928,35721,35373,24068,0
2,0,4,3,7.9,24.3,40.8,27,3116066,1722660,466895,27874,6594,432427,926511,78726,39581,21882,5931,354,84,5493,11769,1613932,1000407,342584,247732,94852,270941,-298,271239,36806,25794,11012,412,10600,43850,38784,25589,8
3,0,6,4,30.2,36.8,23.2,9.8,238000,118358,61381,5552,1019,54810,58261,12752,18664,9282,4813,435,80,4298,4569,97841,63438,18529,13943,4586,15874,10000,5874,2627,1971,656,251,405,37244,32186,14504,0
10,0,3,2,16.8,32.2,33.1,17.9,3948903,2093748,1132717,120251,5886,1006580,722438,115505,34188,18127,9807,1041,51,8715,6255,2452979,1728896,506483,374717,131766,217600,21359,196241,58070,47296,10774,528,10246,42242,36555,19153,5
10,0,8,7,13.4,32.2,41.2,13.1,120675,61717,38319,5088,595,32636,20639,4353,27722,14178,8803,1169,137,7497,4741,40932,23041,9002,7492,1510,8889,4560,4329,1358,711,647,282,365,30141,32406,11860,1
3,0,6,5,34,31.5,23.2,11.3,1927471,1015571,550798,49122,13689,487987,361102,69317,27807,14651,7946,709,197,7040,5209,1068173,744850,192391,135831,56560,130932,1649,129283,32178,24121,8057,920,7137,33196,30880,18114,3
9,0,7,11,10,32.2,35.5,22.3,284339,118089,75077,4616,1157,69304,91173,7720,36831,15297,9725,598,150,8977,11810,128634,78551,23050,15907,7143,27033,9037,17996,4143,2503,1640,325,1315,31049,31383,13685,1
6,0,4,3,8.5,24.8,42.2,24.5,1281629,710336,328673,28920,17904,281849,242620,37189,34463,19101,8838,778,481,7579,6524,886429,595155,168563,113345,55218,122711,7872,114839,22645,17296,5349,198,5151,39145,34410,22295,4
8,0,1,1,15.1,42,29.9,12.9,745492,440664,218345,25404,3211,189730,86483,23747,31393,18557,9195,1070,135,7990,3642,348461,242764,63169,43557,19612,42528,7572,34956,9663,7537,2126,283,1843,36061,32210,18967,2
2,0,7,9,14.2,38.6,31.8,15.4,427056,297389,67944,3907,1590,62447,61723,11580,36879,25681,5867,337,137,5393,5330,376066,238184,69290,50706,18584,68592,45085,23507,9134,6948,2186,756,1430,41172,34281,16438,0
0,0,6,5,30.5,40.4,18,11.1,1039797,683887,224804,25491,3561,195752,131106,40320,25789,16961,5575,632,88,4855,3252,794430,533006,156335,113958,42377,105089,24347,80742,25215,19178,6037,1883,4154,31506,27793,19437,0
1,0,8,6,15.9,43.8,26.3,14,461317,317097,75814,4351,1494,69969,68406,13908,33169,22800,5451,313,107,5031,4918,292645,193735,55877,40863,15014,43033,8603,34430,8706,5663,3043,1069,1974,33614,34211,17442,0
8,0,2,2,12,34.4,35.5,18.1,1844731,1087564,454607,44430,10111,400066,302560,51567,35773,21090,8816,862,196,7758,5867,533810,335071,96606,69625,26981,102133,19528,82605,14372,9535,4837,703,4134,37142,35141,19982,17
9,0,7,11,21,48,22.3,8.8,369667,170392,141926,19033,906,121987,57349,12677,29160,13441,11196,1501,71,9623,4524,188011,126447,35782,25966,9816,25782,13783,11999,5236,3807,1429,313,1116,35907,33214,10752,0
10,0,6,6,6.2,31.5,29.6,32.7,1521376,767276,288491,10828,5593,272070,465609,27307,55714,28098,10565,397,205,9963,17051,758354,489145,145978,102475,43503,123231,13053,110178,20276,14296,5980,707,5273,37402,34216,20895,7
8,0,6,6,8.2,33.4,37.7,20.7,835418,517674,148023,10342,2970,134711,169721,17377,48076,29791,8518,595,171,7752,9767,543076,261396,73513,52721,20792,208167,144118,64049,10892,7748,3144,685,2459,49860,33737,26047,1
3,0,6,6,15.4,39.1,26.5,19,348461,205820,77723,6650,1265,69808,64918,9988,34888,20607,7782,666,127,6989,6500,246003,167277,43147,30673,12474,35579,15077,20502,7241,5547,1694,495,1199,33974,30156,17099,1
4,0,3,2,16.2,36.2,25.6,22,2739434,1785549,510825,45056,37255,428514,443060,76566,35779,23320,6672,588,487,5597,5787,2438995,1842442,431510,295201,136309,165043,25261,139782,50963,43650,7313,569,6744,47858,42209,20727,38
10,0,7,11,4.9,27.5,35.3,32.2,1521583,779474,253618,10324,3889,239405,488491,29110,52270,26777,8712,355,134,8224,16781,904957,595227,171064,112205,58859,138666,1513,137153,21414,14677,6737,753,5984,42260,40555,22920,8
4,0,1,1,25,24.7,33.7,16.6,65369622,42108611,12728249,1597524,1237402,9893323,10532762,2146725,30451,19615,5929,744,576,4609,4906,34605889,23391524,6465952,4781333,1684619,4748413,128627,4619786,819049,593168,225881,2686,223195,42251,39435,20698,179
5,0,4,5,27,36.3,25.4,11.3,1363914,812990,412634,51091,12713,348830,138290,40887,33358,19884,10092,1250,311,8532,3382,919309,690398,145965,96249,49716,82946,318,82628,23007,17894,5113,954,4159,39958,38583,19867,1
7,0,7,11,20.3,34.6,30,15.1,705256,367159,255641,35565,5267,214809,82456,23411,30125,15683,10920,1519,225,9176,3522,297624,198112,59684,44149,15535,39828,-1240,41068,8111,6371,1740,175,1565,36694,31096,26242,0
6,0,2,2,6.1,34.6,34.9,24.5,912974,610644,144631,11340,8502,124789,157699,23576,38725,25901,6135,481,361,5293,6689,600565,391822,117276,83436,33840,91467,40032,51435,15586,11012,4574,1485,3089,38532,35581,16651,4
6,0,9,8,11.4,38.1,35.4,15,395442,258719,80132,7122,4726,68284,56591,11078,35696,23354,7233,643,427,6164,5108,159601,84507,27049,20445,6604,48045,23758,24287,4349,2685,1664,611,1053,36698,31474,23065,0
6,0,4,3,17.7,39.2,31,12.2,1430818,864972,415693,68035,15518,332140,150153,46011,31097,18799,9035,1479,337,7219,3263,1193221,805746,184249,118571,65678,203226,62724,140502,24091,20771,3320,281,3039,49530,38792,46233,1
9,0,9,9,22.5,34,29.1,14.4,151409,75641,45254,3316,278,41660,30514,3988,37966,18967,11348,831,70,10446,7651,67783,41909,11772,8971,2801,14102,8233,5869,2118,1306,812,320,492,32003,32090,11929,1
10,0,6,6,18.4,32.3,29.2,20.1,573764,281363,196557,32710,1140,162707,95844,19304,29723,14575,10182,1694,59,8429,4965,303646,213102,76183,59829,16354,14361,1044,13317,7589,5463,2126,325,1801,40011,39008,7394,1
8,0,2,2,11,25.6,32.5,30.9,41590733,30294726,4363178,477592,57912,3827674,6932829,623599,66695,48580,6997,766,93,6138,11117,36554025,17343126,3879563,2487574,1391989,15331336,-88,15331424,455426,361405,94021,938,93083,80263,47988,164707,89
1,0,4,5,34.8,27.8,25.4,12,1451767,887088,380075,75056,4422,300597,184604,70541,20580,12575,5388,1064,63,4261,2617,1007528,690205,203514,150546,52968,113809,-5832,119641,31727,23051,8676,1758,6918,31756,29943,17294,1
4,0,3,2,12.7,30.3,38,19.1,4328071,2530180,914542,70805,64235,779502,883349,137407,31498,18414,6656,515,467,5673,6429,2558425,1807164,472929,303481,169448,278332,-2417,280749,76284,55482,20802,759,20043,33538,32572,14007,15
6,0,6,5,18.7,39.8,28.8,12.7,867808,474182,253907,34464,8295,211148,139719,30300,28641,15650,8380,1137,274,6969,4611,469578,327049,95487,72494,22993,47042,7958,39084,11497,8685,2812,249,2563,40844,37657,15249,0
5,0,9,10,8.4,30.6,39.2,21.7,357906,239298,55903,5929,1108,48866,62705,7715,46391,31017,7246,769,144,6334,8128,326493,190708,41783,25148,16635,94002,61453,32549,5606,4048,1558,576,982,58240,47112,33146,0
9,0,2,2,13.2,28.9,32.3,25.6,1858092,1082136,471384,46263,3130,421991,304572,55954,33207,19340,8424,827,56,7542,5443,642815,395260,104699,72731,31968,142856,43799,99057,17504,11357,6147,267,5880,36724,34803,16846,10
0,0,7,9,21.5,43,25.5,10,686789,435840,146994,9650,4508,132836,103955,26589,25830,16392,5528,363,170,4996,3910,418613,273424,88641,66879,21762,56548,7216,49332,12345,9180,3165,742,2423,33910,29785,20360,1
2,0,6,6,12.7,40.4,29.4,17.5,676426,473757,93901,6434,1402,86065,108768,15987,42311,29634,5874,402,88,5383,6804,503571,254433,78584,58476,20108,170554,61072,109482,10822,8276,2546,685,1861,46532,30743,58830,4
8,0,6,6,7.3,43.4,30.2,19,1430402,996890,228137,14007,5531,208599,205375,34100,41947,29234,6690,411,162,6117,6023,731478,431872,119736,86610,33126,179870,72644,107226,16892,11856,5036,1155,3881,43303,36426,27628,4
3,0,6,6,25,38.2,24.8,12,856843,453228,269303,22100,2865,244338,134312,30217,28356,14999,8912,731,95,8086,4445,385759,266467,65236,47556,17680,54056,1133,52923,12369,8387,3982,961,3021,31188,31771,17518,0
4,0,4,5,22.7,29.8,35.4,12.1,1917135,963641,619441,72928,34318,512195,334053,64413,29763,14960,9617,1132,533,7952,5186,856080,528525,163559,125353,38206,163996,1517,162479,23713,15655,8058,741,7317,36102,33761,22206,6
0,0,7,9,34.2,42.4,17.1,6.3,386434,217358,117836,11706,1731,104399,51240,16515,23399,13161,7135,709,105,6321,3103,172487,107982,32417,24099,8318,32088,-463,32551,6715,4487,2228,501,1727,25687,24066,18848,1
4,0,6,6,38.6,35.1,17.1,9.2,444393,216558,175340,29704,8605,137031,52495,19352,22964,11190,9061,1535,445,7081,2713,188247,126644,37654,27619,10035,23949,9968,13981,5586,4223,1363,385,978,33700,29989,14296,0
1,0,7,11,11.5,29.9,34.2,24.3,479124,238310,100026,5528,924,93574,140788,17087,28040,13947,5854,324,54,5476,8239,278891,191791,47069,33107,13962,40031,-363,40394,10449,6930,3519,183,3336,26691,27675,12109,3
7,0,6,6,8.8,42.4,30.3,18.5,2030173,1231160,461531,24946,16001,420584,337482,51910,39109,23717,8891,481,308,8102,6501,1116864,737314,238365,176421,61944,141185,29834,111351,28035,20636,7399,1059,6340,39838,35730,17563,17
8,0,3,2,14.7,43,29.7,12.7,676960,410259,182727,17831,3083,161813,83974,21166,31983,19383,8633,842,146,7645,3967,292317,177570,55414,41980,13434,59333,14339,44994,7467,4901,2566,492,2074,39148,36231,21694,4
8,0,4,5,20,31.3,31,17.7,2945375,1697650,786102,92509,8030,685563,461623,94291,31237,18004,8337,981,85,7271,4896,1711983,1174010,304800,211935,92865,233173,57595,175578,48833,36371,12462,1372,11090,35058,32279,15832,13
1,0,1,1,10.8,25.9,38.8,24.4,25152644,18827308,2808254,232641,82813,2492800,3517082,670706,37502,28071,4187,347,123,3717,5244,15811734,11165775,2755691,1694302,1061389,1890268,7275,1882993,328631,257003,71628,1326,70302,48114,43446,26784,206
6,0,6,6,7.4,32.1,36.4,24,1243135,707179,317295,31566,12134,273595,218661,32760,37947,21587,9685,964,370,8351,6675,706078,438104,126956,89351,37605,141018,29414,111604,20058,13984,6074,979,5095,35202,31329,21905,5
8,0,9,12,12.4,32.8,36,18.8,346616,222666,72729,10432,1563,60734,51221,9294,37295,23958,7825,1122,168,6535,5511,278207,203137,60381,41796,18585,14689,3994,10695,5657,4461,1196,376,820,49179,45536,13043,0
9,0,9,12,12.4,32.8,36,18.8,358741,231354,72869,10278,1111,61480,54518,9315,38512,24837,7823,1103,119,6600,5853,292491,217953,63976,43389,20587,10562,921,9641,5646,4463,1183,372,811,51805,48836,11888,0
9,0,9,12,7.7,40.6,33.5,18.2,167981,112355,29269,1575,146,27548,26357,2974,56483,37779,9842,530,49,9263,8862,120493,42255,12146,8959,3187,66092,57673,8419,2153,1326,827,281,546,55965,31867,15419,0
3,0,6,6,31.5,40.2,19.5,8.8,653225,349453,228959,24845,4324,199790,74813,25766,25352,13563,8886,964,168,7754,2904,317493,211648,63775,47893,15882,42070,-807,42877,10642,7424,3218,669,2549,29834,28509,16821,1
3,0,9,10,18.9,35.2,33.3,12.7,197385,128208,26274,1185,781,24308,42903,3978,49619,32229,6605,298,196,6111,10785,196612,115103,24669,15478,9191,56840,48998,7842,3516,2595,921,415,506,55919,44356,15498,2
1,0,1,1,15.3,22.9,30.4,31.3,4069500,2955572,434274,42477,6178,385619,679654,132111,30804,22372,3287,322,47,2919,5145,2139471,1367459,324767,232467,92300,447245,1582,445663,65995,45486,20509,954,19555,32419,30063,22790,514
5,0,4,3,14.2,40.5,24.3,21,3698784,2375044,784644,70477,43053,671114,539096,114391,32335,20763,6859,616,376,5867,4713,2534923,1652387,442226,312200,130026,440310,39172,401138,61536,45171,16365,1651,14714,41194,36581,27262,42
5,0,2,2,13.2,36.9,30.5,19.4,9972773,4202200,3376599,280356,110884,2985359,2393974,331344,30098,12682,10191,846,335,9010,7225,4545932,3315077,871056,630105,240951,359799,-52149,411948,128566,95830,32736,3056,29680,35359,34593,13880,23
10,0,3,2,17.5,29.9,31.8,20.9,4355478,2590797,1041077,97430,5652,937995,723604,119199,36540,21735,8734,817,47,7869,6071,2879193,2099146,533183,376299,156884,246864,22626,224238,63205,49976,13229,1105,12124,45553,42003,18495,10
8,0,4,5,7.5,24.8,39,28.7,1231188,704444,289717,39706,4607,245404,237027,46532,26459,15139,6226,853,99,5274,5094,732605,503426,154827,113038,41789,74352,17723,56629,22297,16109,6188,439,5749,32857,31251,9850,3
7,0,6,4,21,35.5,29.8,13.7,854642,516698,189985,20055,4410,165520,147959,26672,32043,19372,7123,752,165,6206,5547,541651,395309,90407,63004,27403,55935,-16437,72372,13283,8717,4566,1516,3050,40778,45349,23729,0
3,0,7,8,15.4,33.5,22.6,28.5,674396,375092,165583,11148,5972,148463,133721,25399,26552,14768,6519,439,235,5845,5265,457703,319217,90001,66393,23608,48485,-2195,50680,14883,11740,3143,831,2312,30753,27191,21920,0
6,0,2,2,10.2,34.3,25.7,29.8,11265779,7379890,2225210,203904,125717,1895589,1660679,269106,41864,27424,8269,758,467,7044,6171,12107883,8767115,2672840,1988939,683901,667928,28807,639121,214571,188139,26432,738,25694,56428,46599,24874,79
7,0,5,8,8.7,35.7,37.1,18.5,2671365,2081318,191353,13256,9003,169094,398694,47861,55815,43487,3998,277,188,3533,8330,2621823,1687813,374380,218236,156144,559630,-18967,578597,36951,29747,7204,688,6516,70954,56739,88796,6
9,0,7,8,12.7,35.2,33.7,18.4,1369733,590103,497334,26074,3505,467755,282296,40871,33514,14438,12168,638,86,11445,6907,736634,525042,133480,90476,43004,78112,760,77352,20896,15425,5471,487,4984,35252,34038,15520,0
2,0,6,5,27.9,40.6,20.6,10.9,1014722,612234,268397,24957,5843,237597,134091,40918,24799,14962,6559,610,143,5807,3277,679643,468448,126609,86615,39994,84586,27656,56930,19714,16134,3580,682,2898,34475,29035,19645,0
6,0,3,2,19.5,45.7,22.2,12.6,677912,406487,178153,21550,4697,151906,93272,23787,28499,17089,7490,906,197,6386,3921,200772,125383,36805,26522,10283,38584,-992,39576,7285,4352,2933,704,2229,27560,28810,17755,0
8,0,3,2,10.9,30,27.2,31.9,4671148,2939647,1061696,99481,11157,951058,669805,125353,37264,23451,8470,794,89,7587,5343,3409227,2336619,636709,467530,169179,435899,32,435867,78431,63250,15181,1221,13960,43468,36943,31223,17
2,0,5,8,28.8,29.3,27.2,14.7,2513351,1542807,577099,60167,4264,512668,393445,84518,29737,18254,6828,712,50,6066,4655,1751524,1290274,295016,208504,86512,166234,519,165715,48390,39219,9171,1022,8149,36196,32899,20336,1
10,0,7,11,9.9,32.8,34.7,22.6,590770,260668,183447,15112,2013,166322,146655,15867,37233,16428,11562,952,127,10482,9243,283911,194996,60878,42548,18330,28037,7188,20849,8287,5478,2809,582,2227,34260,35596,9362,0
7,0,1,1,3.9,21.7,32.1,42.3,12880629,9196919,1400229,87711,55765,1256753,2283481,243733,52847,37734,5745,360,229,5156,9369,4582064,3144593,750209,493277,256932,687262,22438,664824,108583,78783,29800,489,29311,42199,39915,22682,388
4,0,8,7,30.2,39.2,21.8,8.8,215709,99516,81380,6538,2841,72001,34813,9490,22730,10486,8575,689,299,7587,3668,74980,47014,12412,8543,3869,15554,4028,11526,3168,1927,1241,411,830,23668,24398,13887,0
3,0,1,1,10.6,19.9,32.8,36.6,27061001,21483857,2114205,159162,52519,1902524,3462939,630104,42947,34096,3355,253,83,3019,5496,10462642,7299568,1455354,974873,480481,1707720,-3768,1711488,284340,183999,100341,2379,97962,36796,39672,17471,136
7,0,2,2,10.9,38.6,34.8,15.7,3189400,2033538,758016,69059,22818,666139,397846,82889,38478,24533,9145,833,275,8037,4800,1552216,1133213,266353,188120,78233,152650,-6545,159195,32362,24656,7706,620,7086,47964,45961,22466,7
6,0,7,11,11.4,30.3,33,25.3,813683,487760,169195,12582,7676,148937,156728,18401,44219,26507,9195,684,417,8094,8517,562479,300191,112747,92977,19770,149541,11183,138358,10338,7772,2566,85,2481,54409,38625,55767,0
0,0,9,10,33.4,35.3,20.5,10.8,144815,75176,49784,5554,539,43691,19855,6008,24104,12513,8286,924,90,7272,3305,59051,33232,11287,8662,2625,14532,131,14401,2363,1513,850,199,651,24990,21964,22121,0
1,0,2,2,15.6,23.5,21,39.9,74442192,48500758,4895454,311035,119835,4464584,21045980,896254,83059,54115,5462,347,134,4981,23482,47286671,33302397,6174617,4269668,1904949,7809657,10046,7799611,600698,452248,148450,210,148240,78720,73637,52615,561
10,0,6,5,21.6,33,29.5,15.9,1073534,508647,408017,60033,1567,346417,156870,35319,30395,14402,11552,1700,44,9808,4442,635866,457474,121375,84249,37126,57017,6136,50881,15235,12559,2676,120,2556,41737,36426,19906,0
7,0,1,1,9.3,28.9,35.2,26.6,10216075,6290251,2112837,313552,88784,1710501,1812987,268614,38033,23417,7866,1167,331,6368,6749,6521819,4527013,1397318,1026458,370860,597488,12638,584850,127560,105236,22324,596,21728,51127,43018,26917,26
8,0,4,3,12.5,45.2,28.4,13.9,3506154,2106887,957021,90405,17609,849007,442246,105908,33106,19894,9036,854,166,8016,4176,1716262,1127552,326045,239961,86084,262665,24860,237805,44053,32658,11395,956,10439,38959,34526,22780,8
9,0,7,9,12.1,49.4,25.1,13.4,602578,348244,161846,17255,1927,142664,92488,16438,36658,21185,9846,1050,117,8679,5626,500960,367640,82637,55681,26956,50683,194,50489,9830,7650,2180,443,1737,50962,48058,29067,1
8,0,1,1,11.6,40.3,29.2,18.9,38373,1288681,110,6055,7961,3459515,2460489,53625,36392,24031,7011,675,78,6259,5350,830396,499346,124626,82871,41755,206424,44554,161870,20673,13829,6844,1538,5306,40168,36109,30507,33
2,0,2,2,21,32.8,26.8,19.3,1139258,836408,128585,12264,1771,114550,174265,28302,40254,29553,4543,433,63,4047,6157,310598,208289,50134,36149,13985,52175,4443,47732,10768,6869,3899,65,3834,28845,30323,12450,3
3,0,9,8,28.1,33,26.6,12.3,426516,239859,106435,9372,2190,94873,80222,13292,32088,18045,8007,705,165,7138,6035,114555,63201,17688,12924,4764,33666,12825,20841,3756,2242,1514,142,1372,30499,28190,15190,0
9,0,3,2,13.9,41.3,29.1,15.8,16856,173892,53434,4554,388,48492,33930,6120,42689,28414,8731,744,63,7924,5544,119940,50497,16393,12667,3726,53050,40790,12260,2690,1619,1071,439,632,44587,31190,19399,0
3,0,6,4,15.4,38.3,29.4,16.9,997915,660043,165872,10985,6793,148094,172000,27816,35876,23729,5963,395,244,5324,6183,420038,279341,78494,55461,23033,62203,27705,34498,12392,8812,3580,932,2648,33896,31700,13028,4
9,0,6,5,10.1,34,35.6,20.3,1022309,624090,228374,12823,1524,214027,169845,21533,47476,28983,10606,596,71,9939,7888,597247,329367,92775,68039,24736,175105,98192,76913,13351,9561,3790,1083,2707,44734,34449,28413,3
7,0,3,2,21.5,37,29.9,11.6,1695279,843898,578970,88656,22022,468292,272411,55695,30439,15152,10395,1592,395,8408,4891,965317,699542,187104,134067,53037,78671,25345,53326,22801,18689,4112,220,3892,42337,37431,13701,5
9,0,9,10,21.3,39.7,27,11.9,394978,183777,161836,18582,1252,142002,49365,13926,28363,13197,11621,1334,90,10197,3545,135446,76221,24679,18707,5972,34546,4877,29669,4809,3053,1756,403,1353,28165,24966,21928,0
5,0,4,5,13.6,37.9,33.1,15.4,1780617,1053756,495147,62071,33687,399389,231714,61281,29057,17195,8080,1013,550,6517,3781,1099739,748095,224077,162008,62069,127567,20138,107429,26829,20172,6657,888,5769,40991,37086,18622,1
3,0,9,10,16.5,35.4,32.5,15.7,236672,141839,54146,3344,1399,49403,40687,6113,38716,23203,8858,547,229,8082,6656,134930,63493,16597,11516,5081,54840,36992,17848,3667,2087,1580,534,1046,36796,30423,17063,0
7,0,9,12,12,33.2,34.6,20.2,404855,243037,58607,3738,2342,52527,103211,7220,56074,33662,8117,518,324,7275,14295,293716,160864,37440,23971,13469,95412,51291,44121,5537,3956,1581,498,1083,53046,40663,40740,0
6,0,1,1,15.5,34.5,30.9,19.1,2713874,1656766,719378,71366,19075,628937,337730,86706,31300,19108,8297,823,220,7254,3895,1751590,1244769,314611,230808,83803,192210,-15430,207640,42261,30040,12221,3667,8554,41447,41437,24274,12
0,0,3,2,21.1,37.1,25.3,16.5,1121563,764159,198284,17073,3009,178202,159120,42683,26277,17903,4646,400,70,4175,3728,704551,493147,148719,112612,36107,62685,7673,55012,20663,15534,5129,1360,3769,34097,31746,14596,2
10,0,2,2,14.1,33.5,28.7,23.8,2919184,1762348,736324,67458,3683,665183,420512,75459,38686,23355,9758,894,49,8815,5573,2902005,2174816,447528,294393,153135,279661,-2873,282534,48427,40622,7805,393,7412,59925,53538,38118,42
0,0,7,8,17,31.9,35.3,15.9,604890,350872,165775,12402,3595,149778,88243,21913,27604,16012,7565,566,164,6835,4027,382201,264942,71198,49027,22171,46061,7744,38317,13131,10313,2818,875,1943,29107,25690,19721,0
0,0,9,10,27,43.1,21.6,8.3,198520,99535,69609,6874,696,62039,29376,9557,20772,10415,7284,719,73,6491,3074,73816,36787,11789,9021,2768,25240,1708,23532,3744,1814,1930,707,1223,19716,20279,19241,0
6,0,2,2,10.1,30.7,39.1,20.1,415329,194065,135175,16705,5173,113297,86089,12950,32072,14986,10438,1290,399,8749,6648,178456,119013,37567,26590,10977,21876,614,21262,4558,3012,1546,286,1260,39152,39513,16875,2
2,0,6,6,39.3,38.1,15.1,7.5,501536,274615,177540,26633,2490,148417,49381,22179,22613,12382,8005,1201,112,6692,2226,276005,183076,53287,39206,14081,39642,-2411,42053,9188,6907,2281,237,2044,30040,26506,20574,0
8,0,7,9,18.2,35.1,35,11.7,684600,405556,157653,12363,2463,142827,121391,19591,34945,20701,8047,631,126,7290,6196,378803,265539,68242,48913,19329,45022,-1753,46775,9719,6123,3596,1380,2216,38976,43367,21108,1
9,0,6,3,7.6,39.5,32.2,20.7,560517,336152,133309,12666,2008,118635,91056,16524,33921,20343,8068,767,122,7180,5511,347313,235567,62399,43044,19355,49347,24228,25119,8454,6510,1944,535,1409,41083,36185,17828,1
5,0,7,9,9.1,33.9,36.2,20.9,619471,404502,100568,7529,5453,87586,114401,15849,39086,25522,6345,475,344,5526,7218,429077,292322,90397,60936,29461,46358,-4139,50497,9599,7217,2382,241,2141,44700,40505,23586,2
6,0,2,2,6,16,38.6,39.4,14829683,10067708,2247897,347268,80667,1819962,2514078,530860,27935,18965,4234,654,152,3428,4736,9387719,7044584,1721728,1154368,567360,621407,35075,586332,264693,187325,77368,2145,75223,35466,37606,7795,325
2,0,1,1,19.8,25,27.5,27.7,19325241,14709517,1845403,176874,68584,1599945,2770321,495752,38982,29671,3722,357,138,3227,5588,12658472,9260818,2355149,1679914,675235,1042505,11602,1030903,269312,226269,43043,565,42478,47003,40928,24269,137
0,0,3,2,20.8,22.9,31.4,24.8,7405312,5698618,523176,63406,5580,454190,1183518,122516,60444,46513,4270,518,46,3707,9660,6158363,2362158,498707,338613,160094,3297498,5975,3291523,84531,62233,22298,483,21815,72853,37957,150883,10
5,0,4,3,10.1,41,32.8,16.1,3123892,2096886,594688,35774,47804,511110,432318,88747,35200,23628,6701,403,539,5759,4871,1973063,1304403,381284,274244,107040,287376,25455,261921,43941,34216,9725,1811,7914,44903,38123,33096,27
1,0,7,11,8.4,27.8,25.4,38.4,752750,478830,40024,3872,1534,34618,233896,9811,76725,48805,4080,395,156,3528,23840,563809,292747,59863,36802,23061,211199,0,211199,10215,6689,3526,0,3526,55194,43765,59898,0
2,0,4,5,16.6,38.5,28.7,16.3,3010196,2026833,578130,48206,20946,508978,405233,101657,29611,19938,5687,474,206,5007,3986,1529481,1076639,310449,223129,87320,142393,14720,127673,43267,32120,11147,1463,9684,35350,33519,13184,32
0,0,5,8,14.2,39.3,30.5,16,1192857,741280,244614,21330,5771,217513,206963,40332,29576,18379,6065,529,143,5393,5131,980088,701349,184416,124224,60192,94323,13629,80694,26916,22863,4053,501,3552,36413,30676,22718,5
2,0,6,6,37.9,30.5,21.9,9.7,828627,494264,218583,21994,2231,194358,115780,31004,26726,15942,7050,709,72,6269,3734,466955,322546,88369,63892,24477,56040,9823,46217,15456,11860,3596,847,2749,30212,27196,16812,1
8,0,7,11,6.5,26.5,34.1,32.9,575031,391762,64552,7036,2152,55364,118717,8962,64163,43714,7203,785,240,6178,13247,422918,220947,78853,60778,18075,123118,0,123118,6608,4647,1961,0,1961,64001,47546,62783,0
2,0,6,6,21.5,49.5,19.2,9.9,606195,408667,129162,9528,2489,117145,68366,21580,28091,18937,5985,442,115,5428,3168,404638,262360,72542,52601,19941,69736,29688,40048,11595,8835,2760,769,1991,34898,29696,20115,1
9,0,6,5,14.9,39.6,25.7,19.8,1698198,1082360,354334,30764,2908,320662,261504,46938,36180,23059,7549,655,62,6832,5571,1027763,721381,190270,133280,56990,116112,25963,90149,25140,19754,5386,799,4587,40882,36518,19653,9
7,0,1,1,13.2,28.6,27.1,31.1,770047,495938,141636,13927,3821,123888,132473,22467,34275,22074,6304,620,170,5514,5896,354505,227517,57709,41051,16658,69279,12201,57078,11575,8221,3354,157,3197,30627,27675,17854,5
4,0,4,5,23,37.3,23.1,16.6,1548366,913077,352379,28797,13810,309772,282910,44799,34563,20382,7866,643,308,6915,6315,949414,581014,128216,85992,42224,240184,-16678,256862,23412,16356,7056,1207,5849,40552,35523,43916,93
1,0,7,11,18.1,37.5,29.4,15.1,397392,238220,105004,6983,2635,95386,54168,13705,28996,17382,7662,510,192,6960,3952,267329,198145,50299,34111,16188,18885,388,18497,7147,5722,1425,193,1232,37404,34629,15014,2
2,0,2,2,13,27.5,29.4,30.1,18836632,13602878,1926395,130650,31507,1764238,3307359,398843,47228,34106,4830,328,79,4423,8292,14091235,10377099,2217302,1519169,698133,1496834,-4241,1501075,260416,209658,50758,585,50173,54110,49495,29918,258
5,0,8,7,21.3,34.3,30.1,14.3,489787,245782,166622,17224,4471,144927,77383,18464,26527,13311,9024,933,242,7849,4191,211137,143049,41103,29866,11237,26985,198,26787,7690,5465,2225,524,1701,27456,26175,15748,0
3,0,6,6,31.9,35.5,20.8,11.7,1766642,1188753,315614,29639,6919,279056,262275,59420,29731,20006,5312,499,116,4696,4414,934802,705930,167285,119456,47829,61587,27053,34534,26441,21069,5372,733,4639,35354,33506,7444,11
4,0,1,1,13.4,26.2,22.1,38.2,57872484,39176330,6307886,313345,622608,5371933,12388268,900319,64280,43514,7006,348,692,5967,13760,37872102,25989821,5671129,3741821,1929308,6211152,2133,6209019,598923,458619,140304,46,140258,63234,56670,44269,255
3,0,3,2,7.6,22.3,27.4,42.7,3644069,2449243,472271,46091,12187,413993,722555,109010,33429,22468,4332,423,112,3798,6628,2367445,1700801,445216,317853,127363,221428,1136,220292,67975,54159,13816,874,12942,34828,31404,17021,14
0,0,2,2,15.3,27.4,37.4,19.8,8462224,5858571,1175087,153029,20676,1001382,1428566,266017,31811,22023,4417,575,78,3764,5370,7437036,5189237,1625031,1213489,411542,622768,4247,618521,166099,142720,23379,2023,21356,44775,36360,28962,16
10,0,7,8,3.4,22,28.3,46.3,1383949,724164,156472,8460,5037,142975,503313,17277,80104,41915,9057,490,292,8275,29132,817255,441315,110585,77806,32779,265355,-23,265378,17090,9304,7786,59,7727,47821,47433,34344,7
2,0,9,10,24.4,33.4,26,16.2,146962,83762,24283,1423,156,22704,38917,4591,32011,18245,5289,310,34,4945,8477,82625,44971,10565,7409,3156,27089,19185,7904,2648,1640,1008,420,588,31203,27421,13442,0
6,0,1,1,16.4,44.7,28,10.9,40575,294658,125331,12932,4689,107710,70434,15370,31908,19171,8154,841,305,7008,4583,163343,104956,31362,23416,7946,27025,-334,27359,6041,3346,2695,784,1911,27039,31368,14317,0
9,0,9,9,17.7,41.1,27.4,13.8,668952,321868,229460,21567,1775,206118,117624,25652,26078,12547,8945,841,69,8035,4585,296518,183430,62386,49172,13214,50702,15536,35166,10058,6210,3848,1189,2659,29481,29538,13225,2
6,0,1,1,7.5,16.9,25.5,50.2,8931189,7080831,748527,49597,36321,662609,1101831,182034,49063,38898,4112,272,200,3640,6053,4340410,2794398,576965,381034,195931,969047,3935,965112,82545,60659,21886,248,21638,52582,46067,44603,78
5,0,9,12,6.2,39.3,37.1,17.3,149860,85119,39286,2934,972,35380,25455,4023,37251,21158,9765,729,242,8794,6327,74965,39004,11578,8596,2982,24383,18594,5789,2270,1391,879,429,450,33024,28040,12864,1
5,0,1,1,11.3,33.1,32.9,22.7,14918609,8272350,4051928,318467,154432,3579029,2594331,465490,32049,17771,8705,684,332,7689,5573,5043870,3543777,902643,644819,257824,597450,-451,597901,143695,102443,41252,922,40330,35101,34593,14825,53
6,0,7,8,10.7,37.7,33.9,17.6,966542,529394,300232,34910,14537,250785,136916,32638,29614,16220,9199,1070,445,7684,4195,661836,460052,140540,102278,38262,61244,5407,55837,17676,13378,4298,327,3971,37443,34389,14061,4
7,0,6,4,16.7,45.6,25.9,11.8,635002,359505,183276,17553,5471,160252,92221,19738,32172,18214,9285,889,277,8119,4672,378392,253438,61583,40470,21113,63371,-1786,65157,9979,7827,2152,425,1727,37919,32380,37728,2
10,0,1,1,12.4,19.5,20.3,47.7,91863399,58500468,9022562,688986,99529,8234047,24340369,976103,94112,59933,9243,706,102,8436,24936,45308118,30903759,7205319,4924479,2280840,7199040,695,7198345,616088,447713,168375,70,168305,73542,69026,42770,1307
0,0,4,5,18.4,48.2,18.7,14.7,2363536,1492725,565966,49359,18343,498264,304845,89452,26422,16687,6327,552,205,5570,3408,1516218,948055,302621,220722,81899,265542,1994,263548,43996,33062,10934,1291,9643,34463,28675,27330,10
2,0,9,12,12.6,34,33.6,19.8,60310,39632,10476,609,35,9832,10202,1670,36114,23732,6273,365,21,5887,6109,43047,16764,4123,2766,1357,22160,4495,17665,1211,707,504,206,298,35547,23711,59279,0
7,0,9,8,6.5,33.9,43.4,16.2,196271,141159,21333,1145,152,20036,33779,2553,76879,55291,8356,448,60,7848,13231,127327,41967,8708,5479,3229,76652,62348,14304,1649,1035,614,263,351,77215,40548,40752,1
0,0,6,5,17.7,42.1,18.1,22.1,603408,406101,118354,7147,2691,108516,78953,18183,33185,22334,6509,393,148,5968,4342,694436,514712,143526,108170,35356,36198,2150,34048,14600,12723,1877,408,1469,47564,40455,23178,0
2,0,6,5,30.1,30.2,20.4,19.3,863606,489521,207911,35765,3174,168972,166174,32987,26180,14840,6303,1084,96,5122,5038,556197,391733,107349,80782,26567,57115,26581,30534,15998,13294,2704,344,2360,34767,29467,12938,0
1,0,1,1,11.9,24.8,30.7,32.6,12308045,9144506,1093277,104388,12083,976806,2070262,298496,41234,30635,3663,350,40,3272,6936,6805863,5020695,1064151,707641,356510,721017,-186,721203,159381,127458,31923,174,31749,42702,39391,22716,57
1,0,2,2,8.5,17.1,26.3,48.1,14192205,9913714,1315531,100307,49356,1165868,2962960,344018,41254,28817,3824,292,143,3389,8613,12467445,9081690,2607245,1922880,684365,778510,5328,773182,247735,205376,42359,1079,41280,50326,44220,18730,405
2,0,8,3,22,32.3,28.4,17.2,258887,178604,43074,2843,473,39758,37209,7996,32377,22337,5387,356,59,4972,4653,324765,246259,57051,42002,15049,21455,-114,21569,6056,4414,1642,331,1311,53627,55790,16452,3
1,0,6,6,35.8,32.1,22.1,10,727214,465576,168541,19556,3279,145706,93097,27311,26627,17047,6171,716,120,5335,3409,475339,325017,86243,60247,25996,64079,23098,40981,13137,10987,2150,220,1930,36183,29582,21234,2
4,0,6,6,21.1,38.5,26.4,14,918603,568423,209241,14164,11304,183773,140939,29659,30972,19165,7055,478,381,6196,4752,452101,276018,95266,73124,22142,80817,22881,57936,15356,9039,6317,2218,4099,29441,30536,14134,3
5,0,9,12,15.4,36.2,33.8,14.6,185617,109251,49523,12141,1267,36115,26843,5326,34851,20513,9298,2280,238,6781,5040,127758,71573,22516,16961,5555,33669,15322,18347,3060,2316,744,319,425,41751,30904,43169,0
10,0,6,6,14,45.7,25,15.3,1050127,531827,367663,29439,4224,334000,150637,30143,34838,17643,12197,977,140,11081,4997,446628,279771,76834,56868,19966,90023,23791,66232,12186,7917,4269,917,3352,36651,35338,19759,1
7,0,2,2,15.3,30.3,30.8,23.6,3745115,2216887,916991,80071,22508,814412,611237,119678,31293,18524,7662,669,188,6805,5107,1911481,1351410,354130,249285,104845,205941,-3690,209631,48715,36786,11929,630,11299,39238,36737,18553,53
3,0,6,6,20,39.3,27,13.6,551294,345167,117771,9015,4395,104361,88356,16634,33143,20751,7080,542,264,6274,5312,284552,163442,53962,42453,11509,67148,40013,27135,7770,5156,2614,508,2106,36622,31699,12885,1
6,0,6,6,15.4,38,29.5,17,658776,385918,174585,17571,7471,149543,98273,21279,30959,18136,8205,826,351,7028,4618,372764,263502,68102,48064,20038,41160,-5058,46218,9540,6247,3293,980,2313,39074,42181,19982,4
9,0,1,1,11.8,27.2,29,32,55486209,35882528,9992512,1269043,77240,8646229,9611169,1319511,42051,27194,7573,962,59,6553,7284,46039143,34465926,7319805,4855260,2464545,4253412,45430,4207982,844102,674212,169890,1963,167927,54542,51120,25058,341
1,0,9,8,20.1,42.7,24.3,12.8,159710,103269,28351,1660,152,26539,28090,5595,28545,18457,5067,297,27,4743,5021,79844,43549,10863,7524,3339,25432,9171,16261,2750,1698,1052,389,663,29034,25647,24526,1
1,0,3,2,17,36.1,23.8,23.1,1927368,1183278,357948,24636,3861,329451,386142,44925,42902,26339,7968,548,86,7333,8595,1608425,933393,261022,167888,93134,414010,-1070,415080,35569,30862,4707,191,4516,45220,30244,91913,4
8,0,9,10,19.2,48,22.9,9.9,155257,73064,61633,5982,746,54905,20560,5573,27859,13110,11059,1073,134,9852,3689,53759,29939,11012,8662,2350,12808,211,12597,1548,942,606,223,383,34728,31782,32890,0
8,0,9,12,3.6,18.5,38.7,39.3,41368,18972,6540,192,119,6229,15856,732,56514,25918,8934,262,163,8510,21661,22680,16558,3309,2137,1172,2813,350,2463,808,516,292,11,281,28069,32089,8765,0
6,0,9,12,12.8,36,40.8,10.4,87470,51503,22189,2132,352,19705,13778,1996,43823,25803,11117,1068,176,9872,6903,55582,15969,5335,4067,1268,34278,12748,21530,974,594,380,161,219,57066,26884,98311,0
7,0,7,9,9.5,46.5,29.1,15,828940,549924,165384,11994,4801,148589,113632,22538,36780,24400,7338,532,213,6593,5042,512348,332273,88709,61358,27351,91366,35669,55697,11562,8738,2824,538,2286,44313,38026,24364,3
10,0,3,2,9.1,31.3,40.1,19.4,2040832,1159756,442887,61614,3244,378029,438189,61524,33171,18850,7199,1001,53,6144,7122,2487130,1766354,686741,519408,167333,34035,1960,32075,39622,35340,4282,37,4245,62771,49982,7556,0
5,0,2,2,8.6,26.2,31.2,34,43342396,28321887,6311494,757177,358512,5195805,8709015,956193,45328,29619,6601,792,375,5434,9108,32003073,22426815,6426111,4558015,1868096,3150147,56638,3093509,595786,496958,98828,744,98084,53716,45128,31539,77
1,0,9,10,24.2,27.7,33.1,15,111422,72264,19273,2119,134,17020,19885,4052,27498,17834,4756,523,33,4200,4907,67765,40379,10196,7348,2848,17190,8097,9093,2062,1415,647,263,384,32864,28536,23680,0
6,0,7,9,9.4,36,34,20.5,772103,359740,265322,22369,9937,233016,147041,24772,31168,14522,10711,903,401,9406,5936,395215,257645,84472,64547,19925,53098,3140,49958,10500,7471,3029,295,2734,37640,34486,18273,0
2,0,4,3,18.4,45.7,20.8,15.1,2886231,1731522,751391,62352,18661,670378,403318,92007,31370,18819,8167,678,203,7286,4384,1635587,1118928,336494,244028,92466,180165,7888,172277,42945,33440,9505,639,8866,38086,33461,19431,9
3,0,7,9,35.3,28.3,21,15.4,413904,227624,132268,17427,1688,113153,54012,16104,25702,14135,8213,1082,105,7026,3354,202141,145082,43859,32496,11363,13200,2072,11128,6634,5229,1405,326,1079,30470,27746,10313,0
9,0,6,6,18.6,35,31.8,14.6,502474,265004,156698,12547,971,143180,80772,16143,31126,16416,9707,777,60,8869,5004,251258,167375,44109,30358,13751,39774,4707,35067,7094,4819,2275,485,1790,35418,34732,19591,0
1,0,2,2,16.5,30.2,26.4,26.9,31112252,22363138,4669807,620591,165197,3884019,4079307,785345,39616,28476,5946,790,210,4946,5194,20036736,14352321,3392097,2334897,1057200,2292318,1299,2291019,419538,339144,80394,1085,79309,47759,42319,28887,394
4,0,8,6,19,29.6,35.9,15.5,368737,141555,141144,13794,7189,120161,86038,13762,26794,10286,10256,1002,522,8731,6252,152629,84887,33132,27483,5649,34610,-1278,35888,4746,2731,2015,177,1838,32160,31083,19526,0
7,0,7,9,21.1,31.9,31,16,278881,143421,82621,7545,1252,73824,52839,8241,33841,17403,10026,916,152,8958,6412,190335,137047,32013,22358,9655,21275,-5997,27272,5343,3503,1840,559,1281,35623,39123,21290,0
3,0,7,12,20.4,33.4,30.8,15.5,210177,104893,58423,5222,1986,51215,46861,7961,26401,13176,7339,656,249,6433,5886,123259,83225,29948,22311,7637,10086,2713,7373,3891,2611,1280,349,931,31678,31875,7919,0
10,0,3,2,9.6,35.3,30,25.1,3494790,2085018,907262,91250,10172,805840,502510,87030,40156,23957,10425,1048,117,9259,5774,2386979,1693032,529905,388942,140963,164042,-1269,165311,45094,38094,7000,347,6653,52933,44444,24848,75
5,0,7,11,7.7,38.9,35.1,18.4,474305,217004,178590,15973,9475,153142,78711,16399,28923,13233,10890,974,578,9338,4800,262036,180831,60610,45747,14863,20595,-176,20771,7197,5829,1368,50,1318,36409,31023,15759,0
4,0,3,2,24.4,33.9,24.5,17.2,3198852,1930842,760147,89577,46109,624461,507863,95492,33499,20220,7960,938,483,6539,5318,2075069,1503534,392866,273747,119119,178669,41612,137057,51832,43105,8727,382,8345,40035,34881,16424,5
10,0,2,2,10.6,33.4,37.3,18.6,1553770,776683,476554,44968,7205,424381,300533,43596,35640,17815,10931,1031,165,9734,6894,639576,410153,122159,82661,39498,107264,16488,90776,16670,10952,5718,1030,4688,38367,37450,19363,2
9,0,5,8,40.8,21,26.4,11.8,1549066,928030,479369,87956,8731,382682,141667,57031,27162,16272,8405,1542,153,6710,2484,880913,564038,172765,133268,39497,144110,5967,138143,23307,18019,5288,257,5031,37796,31302,27458,2
2,0,4,3,25.8,33.5,26.5,14.2,4147531,2577375,873705,77189,24221,772295,696451,135626,30581,19004,6442,569,179,5694,5135,2618808,1909613,493223,342022,151201,215972,4178,211794,64435,51570,12865,832,12033,40643,37030,17601,3
9,0,2,2,10.4,30.6,30.7,28.3,3129081,1919327,630721,39253,4313,587155,579033,77035,40619,24915,8187,510,56,7622,7516,1088504,746127,181766,125534,56232,160611,-6259,166870,29956,20426,9530,1227,8303,36337,36528,20098,22
9,0,6,6,13,44.7,30.7,11.5,361277,221690,91069,8487,954,81628,48518,10488,34447,21137,8683,809,91,7783,4626,114263,58279,17001,12350,4651,38983,16221,22762,3891,1936,1955,810,1145,29366,30103,19879,0
2,0,8,7,17.8,41.4,28.3,12.4,523452,346432,94718,5265,2053,87400,82302,14961,34988,23156,6331,352,137,5842,5501,229436,103515,28466,20322,8144,97455,60223,37232,6979,3857,3122,1003,2119,32875,26838,17571,3
0,0,2,2,25.5,32.5,25.1,16.9,1953325,1346438,324559,30668,3945,289946,282328,71303,27395,18883,4552,430,55,4066,3960,1300591,943854,234040,163344,70696,122697,33458,89239,32090,24567,7523,1081,6442,40529,38420,13853,15
1,0,2,2,14,32,27.8,26.2,11561394,8040766,1474622,96593,41127,1336902,2046006,270814,42691,29691,5445,357,152,4937,7555,9118524,6291764,1698349,1258986,439363,1128411,4504,1123907,172895,144414,28481,609,27872,52740,43568,40324,139
2,0,8,4,20.9,42.4,24.8,12,225210,144130,50320,3696,532,46092,30760,8309,27104,17346,6056,445,64,5547,3702,100877,49175,15761,12323,3438,35941,14091,21850,4041,1933,2108,1042,1066,24963,25440,20497,1
0,0,6,5,15.1,33.1,24.7,27.1,22919,768437,226180,22135,4716,199329,284448,36960,34607,20791,6120,599,128,5393,7696,897176,586403,163169,116347,46822,147604,4,147600,25282,19323,5959,193,5766,35487,30347,25598,9
7,0,4,5,3.8,19,30.8,46.4,1301829,794948,206908,15388,4298,187222,299973,38072,34194,20880,5435,404,113,4918,7879,743489,472110,148329,106116,42213,123050,12875,110175,21080,15627,5453,957,4496,35270,30211,24505,7
1,0,7,8,35.4,40.8,15.4,8.4,544585,330094,150438,19344,2993,128101,64053,24838,21925,13290,6057,779,121,5157,2579,202431,121492,39051,29915,9136,41888,4472,37416,8287,4872,3415,1119,2296,24428,24937,16296,3
5,0,2,2,10,27.9,34.7,27.4,4369176,2827329,946210,104024,64441,777745,595637,137466,31784,20567,6883,757,469,5658,4333,1456283,1030377,262255,181692,80563,163651,-262,163913,45153,31259,13894,351,13543,32252,32963,12103,23
9,0,9,9,9.2,47.5,28.8,14.4,356073,227859,77019,5120,660,71239,51195,8733,40773,26092,8819,586,76,8157,5862,162939,69851,22051,16567,5484,71037,55753,15284,4225,2207,2018,940,1078,38565,31650,14178,0
1,0,8,7,25,34.1,28.6,12.4,129359,71100,38554,5416,794,32344,19705,5277,24514,13474,7306,1026,150,6129,3734,87241,56995,16203,11701,4502,14043,5441,8602,2996,2235,761,314,447,29119,25501,19244,0
6,0,2,2,13.6,15.5,31.1,39.8,13302889,8885558,1705052,164346,143651,1397055,2712279,265103,50180,33517,6432,620,542,5270,10231,7754728,4234339,1174449,871366,303083,2345940,164756,2181184,138208,95796,42412,516,41896,56109,44202,52062,530
8,0,3,2,6.2,26.8,28.7,38.3,35636,228910,52342,6612,1157,44573,68301,6984,50051,32776,7495,947,166,6382,9780,93688,38391,12688,9255,3433,42609,6604,36005,2701,1289,1412,114,1298,34686,29784,27739,5
9,0,7,9,16.3,31.1,35.2,17.3,352272,193158,93032,18387,1469,73176,66082,15052,23404,12833,6181,1222,98,4862,4390,230100,163896,49912,36706,13206,16292,387,15905,6348,4510,1838,694,1144,36248,36341,13903,1
10,0,6,4,16,40.7,30.2,13.1,1091642,599225,282378,25194,3641,253543,210039,32822,33259,18257,8603,768,111,7725,6399,660775,474213,147378,114210,33168,39184,-19015,58199,15652,12190,3462,646,2816,42217,38902,20667,8
10,0,2,2,12.7,21.3,25.9,40.1,3805095,2131504,621847,38411,2152,581284,1051744,68418,55615,31154,9089,561,31,8496,15372,883247,552123,138216,94229,43987,192908,33627,159281,23941,15584,8357,929,7428,36893,35429,21443,29
1,0,6,5,12.9,41.2,22.4,23.6,538757,363050,100831,5196,1212,94423,74876,22698,23736,15995,4442,229,53,4160,3299,414718,273472,86360,67215,19145,54886,15972,38914,13438,9939,3499,1318,2181,30862,27515,17842,0
4,0,5,8,23,36.8,25.1,15.1,1564821,909473,379725,38844,12260,328621,275623,47421,32998,19179,8008,819,259,6930,5812,1168140,838584,200152,137507,62645,129404,-14333,143737,30404,23283,7121,1275,5846,38421,36017,24587,6
0,0,3,2,11.5,26.2,22.7,39.6,3533474,2291316,472209,34338,12639,425232,769949,128121,27579,17884,3686,268,99,3319,6010,2890152,2081769,608925,452942,155983,199458,700,198758,83544,70275,13269,446,12823,34594,29623,15500,20
9,0,1,1,12,25.2,33.3,29.5,15074714,10379525,2316229,212420,30498,2073311,2378960,313609,48068,33097,7386,677,97,6611,7586,7226039,4933278,1328441,1003170,325271,964320,-2636,966956,149462,109349,40113,550,39563,48347,45115,24441,99
6,0,9,12,26.1,38.4,21.4,14,181931,106464,42734,5212,823,36699,32733,8800,20674,12098,4856,592,94,4170,3720,83835,52429,17347,13485,3862,14059,8577,5482,2337,1786,551,187,364,35873,29356,15060,0
6,0,1,1,12.4,24.1,29.8,33.7,24588215,18340956,2642680,251706,93217,2297757,3604579,471438,52156,38904,5606,534,198,4874,7646,10642042,6518466,1265219,821842,443377,2858357,-7555,2865912,212932,143760,69172,1491,67681,49979,45343,42344,166
0,0,6,6,15.4,29,38.4,17.3,447987,277226,97808,9726,1342,86740,72953,24607,18206,11266,3975,395,55,3525,2965,254465,178069,57941,43273,14668,18455,-9022,27477,10797,7481,3316,699,2617,23568,23803,10499,7
3,0,6,6,27,39.6,23,10.5,1058958,632287,293234,28398,3416,261420,133437,35170,30110,17978,8338,807,97,7433,3794,535716,380159,87558,62525,25033,67999,-1541,69540,16209,11563,4646,838,3808,33051,32877,18262,0
1,0,7,8,5.3,18.9,30,45.8,2956940,573215,59856,2070,2245,55541,2323869,20014,147744,28641,2991,103,112,2775,116112,808887,684000,144412,75375,69037,-19525,1879,-21404,25714,18648,7066,104,6962,31457,36680,-3074,10
1,0,1,1,20.5,17.5,31.2,30.8,149663507,107737836,12280403,1354836,255084,10670483,29645268,2932261,51040,36742,4188,462,87,3639,10110,119780156,80617139,17880320,11672130,6208190,21282697,72231,21210466,2017131,1606739,410392,231,410161,59381,50174,51713,1852
10,0,7,8,15,39.6,28.7,16.7,889061,575062,157163,15340,2658,139165,156836,23563,37731,24405,6670,651,113,5906,6656,804083,538038,116644,77449,39195,149401,13109,136292,16492,11673,4819,883,3936,48756,46093,34627,1
0,0,9,12,15.3,38.1,30.2,16.4,131691,80602,27735,1951,268,25516,23354,4395,29964,18339,6311,444,61,5806,5314,88927,41801,12478,9350,3128,34648,28548,6100,2802,1820,982,331,651,31737,22968,9370,2
6,0,3,2,8.9,31.5,32,27.5,4885300,3060306,1002147,103142,38264,860741,822847,131470,37159,23278,7623,785,291,6547,6259,4139056,3054279,739210,491747,247463,345567,70986,274581,91173,77726,13447,743,12704,45398,39295,21614,23
4,0,2,2,15,44.1,28.2,12.7,555846,362027,117395,8199,2628,106568,76424,14972,37126,24180,7841,548,176,7118,5104,238483,128375,35831,25903,9928,74277,40996,33281,6774,4236,2538,661,1877,35206,30306,17731,1
4,0,6,3,14.3,46.9,24.1,14.7,1207979,777974,265898,22988,18884,224026,164107,38180,31639,20376,6964,602,495,5868,4298,823547,572946,142446,98414,44032,108155,34951,73204,19631,15528,4103,653,3450,41951,36898,21219,5
5,0,9,10,28.4,36.4,24.4,10.8,721922,365753,267199,31883,3511,231805,88970,24082,29978,15188,11095,1324,146,9626,3694,497941,379445,89482,62248,27234,29014,-554,29568,9762,8545,1217,99,1118,51008,44406,26447,0
4,0,9,10,20,39.2,24.2,16.6,247297,161895,48168,2389,1519,44260,37234,5781,42778,28005,8332,413,263,7656,6441,142314,54157,15723,11734,3989,72434,49741,22693,3117,1974,1143,375,768,45657,27435,29548,0
5,0,2,2,11.4,33.3,27.5,27.8,3422294,2066958,810461,85866,39855,684740,544875,98959,34583,20887,8190,868,403,6919,5506,2506249,1782265,489635,347637,141998,234349,28367,205982,56072,46326,9746,437,9309,44697,38472,22127,6
3,0,6,6,15.4,37,34,13.5,150518,87212,29328,1634,266,27428,33978,3761,40021,23189,7798,434,71,7293,9034,89490,47154,13358,9789,3569,28978,3959,25019,2504,1586,918,295,623,35739,29731,40159,0
9,0,6,6,19.2,41,26.1,13.6,1125919,543906,210782,16160,1335,193287,371231,20516,54880,26511,10274,788,65,9421,18095,603904,384207,87517,64012,23505,132180,-5482,137662,12857,8757,4100,1546,2554,46971,43874,53901,1
2,0,9,10,37.1,39.4,14.4,9.1,118153,56817,44660,3893,577,40190,16676,5053,23383,11244,8838,770,114,7954,3300,42692,26766,7942,5929,2013,7984,-2065,10049,1919,1079,840,338,502,22247,24806,20018,0
3,0,6,6,26.4,41,20.6,11.9,491127,305005,118118,10748,3165,104205,68004,17182,28584,17751,6875,626,184,6065,3958,419501,298851,81001,57385,23616,39649,11183,28466,11340,9141,2199,428,1771,36993,32693,16073,0
9,0,6,4,17,38.3,26.6,18.1,1263630,649786,248009,12159,1538,234312,365835,24789,50975,26213,10005,490,62,9452,14758,599177,395784,92328,66194,26134,111065,-1798,112863,17369,10135,7234,2546,4688,34497,39051,24075,1
4,0,1,1,19.8,30.8,28.1,21.3,6927995,4946161,999242,100352,93571,805319,982592,198533,34896,24914,5033,505,471,4056,4949,2871263,2018803,514882,356546,158336,337578,40541,297037,79640,56728,22912,918,21994,36053,35587,13505,21
10,0,1,1,10.9,25.3,33.9,30,8088461,5607717,1359882,133436,5904,1220542,1120862,196315,41201,28565,6927,680,30,6217,5710,4133593,2943459,698887,473136,225751,491247,26233,465014,95011,72920,22091,485,21606,43506,40366,21522,23
5,0,7,11,5.9,38.7,34.3,21.1,262214,138278,62581,4402,1698,56481,61355,7377,35545,18744,8483,597,230,7656,8317,154888,98319,28881,18674,10207,27688,15385,12303,4525,3008,1517,599,918,34229,32686,13402,0
7,0,9,10,14.9,34.5,34,16.5,47080,23012,9459,885,281,8293,14609,1326,35505,17354,7133,667,212,6254,11017,22827,17546,5073,3701,1372,208,-898,1106,978,570,408,71,337,23340,30782,3282,0
3,0,4,5,35.3,32.1,21.3,11.3,1276141,771697,357668,53357,11418,292893,146776,47037,27131,16406,7604,1134,243,6227,3120,1066414,792633,188071,125754,62317,85710,41137,44573,24677,21427,3250,287,2963,43215,36992,15043,1
10,0,6,3,14.7,43.4,28.4,13.4,1072199,665351,262969,25916,1757,235296,143879,31543,33992,21093,8337,822,56,7460,4561,513605,334130,88432,64458,23974,91043,2071,88972,13065,9091,3974,941,3033,39312,36754,29335,2
4,0,2,2,12.7,32.3,34.6,20.4,2345141,1628089,399698,29682,31214,338802,317354,65617,35740,24812,6091,452,476,5163,4836,977250,628806,174827,127223,47604,173617,25846,147771,28720,19963,8757,1182,7575,34027,31499,19508,12
6,0,3,2,10.6,40.5,31,17.9,396658,244152,86909,5330,1981,79598,65597,10666,37189,22891,8148,500,186,7463,6150,100577,52144,13774,10308,3466,34659,-2088,36747,3811,1698,2113,785,1328,26391,30709,27671,0
2,0,4,3,18.8,29.2,28.7,23.3,1779896,848075,359334,21531,1927,335876,572487,48352,36811,17540,7432,445,40,6946,11840,976562,626174,143213,100301,42912,207175,-81,207256,29655,19560,10095,1069,9026,32931,32013,22962,6
8,0,1,1,7.9,32.9,31.9,27.2,9849061,6648056,1823283,117503,37320,1668460,1377722,229885,42843,28919,7931,511,162,7258,5993,5790902,4190201,1097157,784511,312646,503544,14249,489295,122146,98539,23607,169,23438,47410,42523,20876,98
3,0,1,1,9.5,28.6,30.2,31.7,14936297,11028771,1557174,76487,30204,1450483,2350352,294996,50632,37386,5279,259,102,4917,7967,9238181,6533398,1421548,973301,448247,1283235,1744,1281491,193183,146861,46322,556,45766,47821,44487,28001,111
8,0,2,2,13.6,15.5,31.1,39.8,14551892,9699302,1802715,169688,95074,1537953,3049875,269395,54017,36004,6692,630,353,5709,11321,8315535,4499657,1270542,945813,324729,2545336,223610,2321726,144623,100908,43715,517,43198,57498,44592,53746,632
6,0,4,5,15.4,38,28,18.6,1732645,800350,623999,53577,11591,558831,308296,56522,30654,14160,11040,948,205,9887,5454,862983,519215,131884,91452,40432,211884,-4534,216418,25086,17385,7701,715,6986,34401,29866,30979,0
7,0,4,5,7.5,35.7,29.7,27.1,3101079,2143645,510067,44479,18471,447117,447367,75443,41105,28414,6761,590,245,5927,5930,2744830,1883437,460415,314262,146153,400978,31838,369140,51578,43772,7806,754,7052,53217,43028,52345,19
0,0,2,2,14.5,25.8,34.3,25.3,1958188,1284423,305862,25474,9700,270688,367903,68585,28551,18727,4460,371,141,3947,5364,856608,538266,167789,117844,49945,150553,24290,126263,27586,19409,8177,1254,6923,31052,27733,18238,15
6,0,3,2,9.1,31.3,40.1,19.4,1962561,1123050,377337,67560,17580,292197,462174,65089,30152,17254,5797,1038,270,4489,7101,2656028,1869929,752161,573816,178345,33938,1359,32579,42535,38558,3977,40,3937,62443,48497,8275,2
6,0,6,6,7.5,41.5,27.2,23.7,37036,303000,387,2171,3913,109967,72088,10087,47002,30039,7405,411,128,6865,9559,318751,152958,40456,28473,11983,125337,95482,29855,7264,5190,2074,792,1282,43881,29472,23288,6
3,0,9,12,19.2,37.7,30.2,13,281043,167451,62981,3403,1291,58287,50611,7342,38279,22807,8578,463,176,7939,6893,156613,71892,21204,15499,5705,63517,42015,21502,4346,2612,1734,787,947,36036,27524,22705,0
0,0,8,5,20.3,41,26,12.7,327645,224737,52769,4713,1102,46954,50139,11862,27621,18946,4449,397,93,3958,4227,173113,109694,28964,20735,8229,34455,15612,18843,5734,4086,1648,508,1140,30191,26846,16529,3
3,0,8,7,8.3,30.4,38.6,22.7,95265,58373,23379,1431,488,21460,13513,1803,52837,32375,12967,794,271,11902,7495,120013,91287,23412,15522,7890,5314,0,5314,2436,2109,327,0,327,49266,43284,16251,0
4,0,6,6,27.2,43.9,17.4,11.5,312995,161680,99087,9957,2647,86483,52228,13483,23214,11991,7349,738,196,6414,3874,173082,114976,28244,20481,7763,29862,2492,27370,6138,4025,2113,925,1188,28198,28565,23039,0
1,0,7,8,17.8,47.9,20.3,14,1309419,800028,315786,27625,11625,276536,193605,44309,29552,18056,7127,623,262,6241,4369,862754,576155,192320,144415,47905,94279,793,93486,22732,18540,4192,259,3933,37953,31076,23770,2
9,0,2,2,14.1,39.2,32.1,14.5,1851402,1103781,534674,50627,5767,478280,212947,61797,29959,17861,8652,819,93,7740,3446,1003952,731863,179114,118004,61110,92975,21909,71066,26603,20708,5895,792,5103,37738,35342,13926,3
5,0,1,1,11.5,34.8,33.8,20,3957638,2655634,840987,80007,46734,714246,461017,110568,35794,24018,7606,724,423,6460,4170,2672311,1777776,472324,337260,135064,422211,2336,419875,60486,50582,9904,503,9401,44181,35146,44663,8
5,0,2,2,12.2,28.2,35.3,24.3,1838967,938487,573886,49226,23612,501048,326594,58940,31201,15923,9737,835,401,8501,5541,867362,578749,154366,110592,43774,134247,2786,131461,24909,17815,7094,555,6539,34821,32487,20104,2
2,0,6,5,24.4,45.5,21.7,8.4,368764,235550,83760,5241,1295,77224,49454,13047,28264,18054,6420,402,99,5919,3790,181019,131572,37233,28112,9121,12214,1533,10681,4517,3310,1207,288,919,40075,39750,11622,1
2,0,1,1,11.2,36.4,27.7,24.8,6759224,4900976,803839,41061,18171,744607,1054409,168775,40049,29039,4763,243,108,4412,6247,3182348,2280378,576248,401265,174983,325722,1748,323974,84034,64054,19980,811,19169,37870,35601,16901,57
10,0,2,2,13.3,37.7,29.7,19.3,1975461,1101296,606205,45007,2788,558410,267960,52748,37451,20878,11492,853,53,10586,5080,1431009,1104838,215874,143564,72310,110297,-3145,113442,23959,19348,4611,464,4147,59727,57103,27355,6
2,0,7,9,12.1,20.7,38.4,28.9,523529,359192,40745,3957,2503,34285,123592,13678,38275,26261,2979,289,183,2507,9036,416964,263026,72079,51819,20260,81859,3722,78137,9956,7628,2328,74,2254,41881,34482,34666,4
9,0,1,1,15.2,35.3,30.1,19.5,1929654,1284962,332260,23929,3162,305169,312432,46143,41819,27847,7201,519,69,6614,6771,500305,276040,73091,54875,18216,151174,-277,151451,15947,8403,7544,2213,5331,31373,32850,28409,8
3,0,4,5,17.2,37.3,27.6,17.9,3334291,2126268,737299,72935,17811,646553,470724,98726,33773,21537,7468,739,180,6549,4768,2570777,1908977,509556,363852,145704,152244,27859,124385,50969,40451,10518,1476,9042,50438,47192,13756,59
7,0,8,7,9.5,41.2,35.6,13.7,268829,162159,51268,3061,1018,47189,55402,5865,45836,27649,8741,522,174,8046,9446,145449,57315,15927,11403,4524,72207,47704,24503,3109,1782,1327,534,793,46783,32163,30899,0
8,0,6,7,10.3,38.5,29.1,22.1,670548,405862,174359,16766,5091,152502,90327,18374,36494,22089,9489,912,277,8300,4916,308677,172556,67991,52281,15710,68130,14618,53512,7167,5085,2082,346,1736,43069,33934,30825,4
9,0,6,5,16.5,39.9,29.9,13.7,1107981,606041,322743,33183,2964,286596,179197,35505,31206,17069,9090,935,83,8072,5047,686481,437596,129715,93498,36217,119170,12444,106726,18649,13433,5216,1293,3923,36811,32576,27205,3
6,0,5,8,11.8,35.4,36.8,16.1,1386612,825856,351498,30942,9861,310695,209258,38463,36051,21471,9139,804,256,8078,5441,957304,642137,174348,127070,47278,140819,48369,92450,21678,18236,3442,440,3002,44160,35213,30796,1
7,0,2,2,12.2,28.2,35.3,24.3,1976791,977050,604912,52023,15683,537206,394829,58665,33696,16655,10311,887,267,9157,6730,892293,602865,157099,110369,46730,132329,1577,130752,25111,17797,7314,515,6799,35534,33875,19231,1
1,0,4,5,21.9,41.2,24.2,12.6,1213119,853878,203008,16586,4510,181912,156233,38978,31123,21907,5208,426,116,4667,4008,845463,549959,158800,120566,38234,136704,55085,81619,19851,15485,4366,1054,3312,42590,35516,24643,7
4,0,3,2,23.7,36.3,29,11.1,1126504,683485,306155,27626,10379,268150,136864,39084,28823,17488,7833,707,266,6861,3502,380113,225065,60052,44645,15407,94996,-11275,106271,13238,7511,5727,1463,4264,28714,29965,24923,0
9,0,1,1,13.8,31.3,30.6,24.3,1745325,1162091,305927,27853,3282,274792,277307,45027,38762,25809,6794,619,73,6103,6159,872633,601228,156604,107547,49057,114801,15152,99649,22261,16299,5962,1301,4661,39200,36887,21379,6
4,0,1,1,28.9,34.2,20.3,16.5,3197012,1986654,700367,92928,41061,566378,509991,110433,28950,17990,6342,841,372,5129,4618,1921860,1418936,366927,268116,98811,135997,25092,110905,52333,39282,13051,848,12203,36724,36122,9088,8
8,0,3,2,18.6,40.7,25.9,14.8,678891,425636,149431,13125,2145,134161,103824,17244,39370,24683,8666,761,124,7780,6021,320206,193283,43880,30328,13552,83043,7667,75376,8443,4711,3732,1307,2425,37926,41028,31083,0
7,0,6,6,14.1,36.5,27.4,22,1886344,1116774,457219,43295,19439,394485,312351,48601,38813,22978,9408,891,400,8117,6427,956219,582570,218629,169618,49011,155020,1993,153027,20558,15002,5556,249,5307,46513,38833,28835,1
7,0,6,6,7.2,31.3,24.8,36.7,36124,1118136,206,7169,7681,66962562,47879652,36796,45295,30387,6949,687,185,6077,7959,1042620,578290,152975,103682,49293,311355,43263,268092,22722,16053,6669,727,5942,45886,36024,45118,5
3,0,7,11,15.5,41.2,28.9,14.5,379928,211817,82221,4786,660,76775,85890,10399,36535,20369,7907,460,63,7383,8259,236036,139311,35899,24714,11185,60826,36117,24709,7712,4723,2989,1004,1985,30606,29496,12448,0
7,0,6,6,27.2,33.8,30.4,8.6,363960,201910,103728,17317,3246,83165,58322,14306,25441,14114,7251,1210,227,5813,4077,209014,111328,31371,23544,7827,66315,45284,21031,4608,3211,1397,228,1169,45359,34671,17991,0
6,0,2,2,4.9,15.3,25.4,54.3,15734011,10675269,2084202,188345,94237,1801620,2974540,349102,45070,30579,5970,540,270,5161,8521,12848732,9178783,2727420,2046741,680679,942529,27596,914933,245292,199008,46284,1058,45226,52381,46123,20230,564
2,0,6,5,18,38.9,27.7,15.4,825529,468299,207772,9569,1447,196756,149458,22843,36139,20501,9096,419,63,8613,6543,451314,301206,84545,61833,22712,65563,29164,36399,14327,10543,3784,1101,2683,31501,28569,13567,2
2,0,4,5,22.1,29.7,22.8,25.4,1661489,1069435,297534,38779,4210,254545,294520,65768,25263,16261,4524,590,64,3870,4478,1024504,746093,192527,144770,47757,85884,16393,69491,32071,25590,6481,564,5917,31945,29156,11744,1
1,0,7,8,23.2,35,29.2,12.7,935962,551007,236294,17470,3237,215587,148661,36056,25959,15282,6554,485,90,5979,4123,669542,475034,116242,79717,36525,78266,16122,62144,20942,15418,5524,1100,4424,31971,30810,14047,1
5,0,2,2,13.7,33,26.7,26.6,10705833,6577451,2491054,258347,303523,1929184,1637328,274761,38964,23939,9066,940,1105,7021,5959,8182340,5985605,1466372,988895,477477,730363,16599,713764,171005,142285,28720,365,28355,47849,42068,25172,17
10,0,1,1,11,41.1,31.4,16.5,631080,406801,135546,12820,712,122014,88733,17922,35213,22698,7563,715,40,6808,4951,166337,101098,31182,24041,7141,34057,2286,31771,5351,3060,2291,253,2038,31085,33039,15589,2
5,0,4,3,15,27.5,38.5,19,1622652,655849,681029,51046,16157,613826,285774,53572,30289,12242,12712,953,302,11458,5334,757886,540043,148740,107903,40837,69103,-1628,70731,20544,14546,5998,205,5793,36891,37127,12210,1
9,0,2,2,18.2,42.1,25.4,14.4,758059,378280,250322,29862,3970,216490,129457,25588,29626,14783,9783,1167,155,8461,5059,488324,299566,105287,83098,22189,83471,52820,30651,9525,7166,2359,234,2125,51268,41804,14424,0
8,0,8,7,7.1,25.4,46.1,21.4,112628,55949,28753,2531,1179,25043,27926,3030,37171,18465,9489,835,389,8265,9217,36017,19591,9630,8422,1208,6796,1981,4815,1074,592,482,37,445,33535,33093,10820,1
1,0,6,6,25.8,40.1,25.6,8.4,626760,393513,149065,17729,853,130483,84182,28506,21987,13805,5229,622,30,4577,2953,343632,249743,71472,53705,17767,22417,137,22280,9615,7985,1630,365,1265,35739,31277,17613,0
10,0,2,2,15.2,36.7,21.7,26.5,24866409,16428679,4334943,330918,66370,3937655,4102787,536534,46346,30620,8080,617,124,7339,7647,17211022,10728552,2798186,1923842,874344,3684284,233740,3450544,324102,249545,74557,5090,69467,53104,42992,49672,148
3,0,3,2,19.8,30,33,17.2,3949903,2395674,869568,62317,10099,797152,684661,118834,33239,20160,7318,524,85,6708,5761,2218830,1644217,345726,236810,108916,228887,-7637,236524,63208,45844,17364,2441,14923,35104,35865,15850,10
10,0,4,5,13,34.3,31.6,21.1,1857034,1162702,341637,32470,5160,304007,352695,42964,43223,27062,7952,756,120,7076,8209,1492109,1119225,263919,177402,86517,108965,2588,106377,28462,24499,3963,613,3350,52425,45685,31754,6
3,0,6,6,29.8,32.4,25.6,12.1,856976,501148,219792,18267,4969,196556,136036,29123,29426,17208,7547,627,171,6749,4671,512738,383319,98233,70398,27835,31186,-5325,36511,16369,13118,3251,833,2418,31324,29221,15100,0
10,0,7,8,16,39.2,24,20.8,1141448,627103,342446,29869,2030,310547,171899,33846,33725,18528,10118,882,60,9175,5079,684933,437956,132757,101386,31371,114220,33116,81104,16098,12456,3642,779,2863,42548,35160,28328,0
1,0,9,11,28.6,39.4,18.6,13.5,202291,124580,49857,6919,616,42322,27854,9165,22072,13593,5440,755,67,4618,3039,90265,58978,15572,11483,4089,15715,7832,7883,2908,2010,898,198,700,31040,29342,11261,0
2,0,6,6,31.5,40.2,19.5,8.8,630860,360480,206746,24287,2555,179904,63634,25541,24700,14114,8095,951,100,7044,2491,335577,223127,65662,49107,16555,46788,-5106,51894,11365,8104,3261,689,2572,29527,27533,20177,1
0,0,6,6,35,35.9,17.1,12,246872,129439,66855,8390,770,57695,50578,10553,23394,12266,6335,795,73,5467,4793,151483,97091,26699,19951,6748,27693,12276,15417,4967,3793,1174,306,868,30498,25597,17762,0
10,0,7,10,28.6,34.9,25.2,11.4,778925,279576,410482,48654,2610,359218,88867,27507,28317,10164,14923,1769,95,13059,3231,329728,237675,69503,50791,18712,22550,-176,22726,8258,6834,1424,27,1397,39928,34778,16268,0
10,0,4,3,16.7,33.9,31.3,18.1,2930482,1577781,890647,67956,7963,814728,462054,79447,36886,19860,11211,855,100,10255,5816,1052474,598523,161310,119626,41684,292641,3985,288656,30782,17666,13116,1744,11372,34191,33880,25383,16
6,0,3,2,8.6,29.2,42,20.2,8073259,5461317,1091284,126131,46172,918981,1520658,185013,43636,29519,5898,682,250,4967,8219,6353185,4361564,1701678,1271813,429865,289943,46768,243175,114456,100451,14005,300,13705,55508,43420,17744,3
4,1,7,11,29.2,37.7,21.1,12.1,713704,371568,227849,32705,10092,185052,114287,26038,27410,14270,8751,1256,388,7107,4389,412551,297140,79205,56979,22226,36206,4021,32185,12426,9326,3100,270,2830,33201,31861,11373,0
0,1,6,7,31.7,36.4,19.5,12.4,299675,158520,59384,6662,498,52224,81771,10198,29386,15544,5823,653,49,5121,8018,161909,95000,25309,18718,6591,41600,0,41600,5214,3458,1756,0,1756,31053,27473,23690,1
10,1,3,2,9.8,27.8,31.7,30.7,8400864,4911148,1768065,125954,8158,1633953,1721651,202863,41412,24209,8716,621,40,8054,8487,3665610,2531374,594097,403569,190528,540139,-2105,542244,103943,73835,30108,842,29266,35266,34284,18528,13
7,1,8,7,34.4,38.2,21.3,6.1,35407,20234,8502,1908,295,6299,6671,1403,25237,14422,6060,1360,210,4490,4755,17681,8163,2062,1368,694,7456,6528,928,439,296,143,65,78,40276,27578,11897,0
0,1,7,8,33.3,33.8,21.5,11.4,680713,467357,140054,13517,1807,124730,73302,28567,23829,16360,4903,473,63,4366,2566,490740,343058,83396,55870,27526,64286,6549,57737,15629,12465,3164,780,2384,31399,27522,24219,0
9,1,1,1,17.9,43.9,25,13.2,636539,375975,192507,21455,1113,169939,68057,22533,28249,16686,8543,952,49,7542,3020,256094,177871,46379,33266,13113,31844,2883,28961,6490,4728,1762,167,1595,39460,37621,18157,0
3,1,3,2,20.7,27.9,28.6,22.8,2226967,1249782,528158,54959,5864,467335,449027,74196,30015,16844,7118,741,79,6299,6052,1995889,1427987,350678,248068,102610,217224,3232,213992,48071,41296,6775,329,6446,41520,34579,33198,4
10,1,7,9,16.7,29.9,37.1,16.3,708040,382312,231928,21423,880,209625,93800,21479,32964,17799,10798,997,41,9760,4367,314038,205129,54485,38932,15553,54424,30801,23623,8629,6462,2167,478,1689,36393,31744,13986,1
8,1,2,2,13,28.9,26.2,31.8,11527548,8196697,1486672,171752,12571,1302349,1844179,231418,49813,35419,6424,742,54,5628,7969,10725523,7277924,1452133,977966,474167,1995466,3602,1991864,188591,148394,40197,526,39671,56872,49045,50210,59
1,1,4,5,26.1,32.2,27.6,14,1905978,1106754,491680,43051,3105,445524,307544,66330,28735,16686,7413,649,47,6717,4637,1443524,1049744,273631,197460,76171,120149,9132,111017,39275,33341,5934,903,5031,36754,31485,22067,1
6,1,2,2,13.5,33.2,29.4,24,10485395,6104468,2110113,310356,36758,1762999,2270814,256997,40800,23753,8211,1208,143,6860,8836,7657243,5315993,1259497,908884,350613,1081753,7292,1074461,164810,128772,36038,512,35526,46461,41282,30244,12
4,1,3,2,26.9,41.6,21.7,9.8,568921,347270,155316,18677,3524,133115,66335,22069,25779,15736,7038,846,160,6032,3006,189303,123752,40097,31889,8208,25454,1554,23900,5446,3695,1751,216,1535,34760,33492,15570,0
4,1,7,8,29.7,32,25.7,12.5,1051858,547354,352387,51261,7791,293335,152117,40332,26080,13571,8737,1271,193,7273,3772,651682,463329,118116,83280,34836,70237,2439,67798,21500,16212,5288,481,4807,30311,28579,14104,1
8,1,1,1,19,28.2,25,27.8,103429133,59304606,21352036,3447246,336030,17568760,22772491,2643934,39119,22430,8076,1304,127,6645,8613,75174928,54584695,11841281,7953822,3887459,8748952,190130,8558822,1564249,1105174,459075,2107,456968,48058,49390,18730,392
4,1,2,2,23.3,31.9,26.2,18.6,12592489,7684564,2963955,432848,91966,2439141,1943970,411994,30565,18652,7194,1051,223,5920,4718,9557729,7177450,1713825,1192678,521147,666454,19045,647409,225897,183314,42583,680,41903,42310,39154,15450,19
6,1,9,8,17.9,34.5,31.2,16.4,321903,183741,97492,10830,1787,84875,40670,10432,30857,17613,9345,1038,171,8136,3899,77792,40352,10571,7131,3440,26869,7556,19313,2793,1435,1358,448,910,27852,28120,21223,0
3,1,2,2,46.7,24,18.7,10.6,431135,280650,69936,7022,718,62196,80549,15767,27344,17800,4436,445,46,3945,5109,359475,265140,74553,62027,12526,19782,2150,17632,6944,5591,1353,143,1210,51768,47423,14572,0
9,1,2,2,21.5,43.5,22.3,12.7,2943729,1861260,613061,86821,3130,523110,469408,73758,39911,25235,8312,1177,42,7092,6364,2336392,1734537,361328,251938,109390,240527,-7198,247725,44000,34568,9432,208,9224,53100,50178,26857,6
0,1,9,10,39.4,28.8,19.2,12.6,133684,73164,43327,9023,683,33621,17193,5707,23425,12820,7592,1581,120,5891,3013,72792,36634,9536,6842,2694,26622,22590,4032,1993,1610,383,84,299,36524,22754,13485,0
10,1,9,8,21.1,34.9,30.8,13.3,559218,316038,182936,16047,770,166119,60244,16023,34901,19724,11417,1001,48,10368,3760,160574,106058,27007,19026,7981,27509,8345,19164,5094,3321,1773,279,1494,31522,31936,12827,0
6,1,2,2,17.1,37.5,25.3,20.1,961690,690841,162429,21921,3628,136880,108420,24097,39909,28669,6741,910,151,5680,4499,747364,535910,128321,91759,36562,83133,438,82695,14721,12159,2562,95,2467,50769,44075,33520,0
9,1,7,11,17,46.7,23.8,12.5,645118,314451,216039,27351,1548,187140,114628,21931,29416,14338,9851,1247,71,8533,5227,347360,267831,66591,46791,19800,12938,-5433,18371,9241,6897,2344,441,1903,37589,38833,9654,1
1,1,8,6,35.2,31.1,21.2,12.4,309713,165875,108220,19247,851,88122,35618,14059,22030,11798,7698,1369,61,6268,2533,165349,117485,31371,22727,8644,16493,11103,5390,5720,4181,1539,338,1201,28907,28100,4488,0
5,1,6,5,19.7,44.2,22.2,13.9,843994,443066,301720,48771,8977,243972,99208,27872,30281,15896,10825,1750,322,8753,3559,361375,214193,61440,47323,14117,85742,41283,44459,10301,7268,3033,371,2662,35082,29471,16701,0
1,1,7,11,29.2,37.7,21.1,12.1,665489,380146,181965,26267,1664,154034,103378,26755,24873,14208,6801,982,62,5757,3864,415622,293433,74438,53030,21408,47751,7302,40449,13375,10269,3106,253,2853,31075,28575,14178,0
3,1,1,1,31.3,34.2,23.7,10.8,999714,659915,131068,14599,1046,115423,208731,22677,44085,29101,5780,644,46,5090,9205,1186928,878755,206222,151006,55216,101951,7344,94607,19301,16206,3095,128,2967,61496,54224,31886,1
8,1,3,2,18,36.2,25.9,19.9,4314259,2634836,1153814,152748,10598,990468,525609,125443,34392,21004,9198,1218,84,7896,4190,2389277,1608701,422405,325471,96934,358171,10488,347683,60200,44760,15440,910,14530,39689,35941,23929,4
4,1,1,1,25.3,23.4,25.5,25.8,13708627,8151035,2218827,377320,59079,1782428,3338765,327803,41820,24866,6769,1151,180,5437,10185,13009176,9370421,2105136,1511101,594035,1533619,0,1533619,235208,191581,43627,0,43627,55309,48911,35153,11
1,1,8,6,30.3,37.8,22.1,9.8,512518,298747,145421,17476,1083,126862,68350,20128,25463,14842,7225,868,54,6303,3396,189724,117030,31602,22857,8745,41092,11361,29731,6283,4515,1768,388,1380,30196,25920,21544,0
7,1,7,9,21.8,33.3,32.6,12.3,682373,371003,228260,22514,3429,202317,83110,25351,26917,14635,9004,888,135,7981,3278,333951,234093,60824,41714,19110,39034,1854,37180,10087,7753,2334,432,1902,33107,30194,19548,0
6,1,2,2,11.6,33.9,26.9,27.6,4511956,3424751,617716,69707,14922,533087,469489,109996,41019,31135,5616,634,136,4846,4268,2431410,1796276,418715,302292,116423,216419,2626,213793,50818,38828,11990,215,11775,47845,46262,18157,8
5,1,7,9,21.8,33.3,32.6,12.3,636245,332049,221504,21008,6236,194260,82692,25227,25221,13162,8780,833,247,7700,3278,304969,224045,58207,41018,17189,22717,-502,23219,9271,7713,1558,459,1099,32895,29048,21127,0
8,1,4,5,20.2,48.9,20.2,10.6,2069957,1255886,462223,62881,3661,395681,351848,53550,38655,23453,8632,1174,68,7389,6570,1856975,1406860,306273,217441,88832,143842,-3505,147347,33948,28402,5546,96,5450,54701,49534,27036,4
9,1,1,1,15.8,44.5,25.7,14,935388,669327,173499,22229,1290,149980,92562,21523,43460,31098,8061,1033,60,6968,4301,802516,542188,158875,126008,32867,101453,-58,101511,10488,8327,2161,46,2115,76518,65112,47996,0
3,1,6,6,28.1,41.3,19.1,11.5,18811,199873,135622,16273,1051,118298,62720,14494,27474,13790,9357,1123,73,8162,4327,199191,142315,35715,26713,9002,21161,667,20494,5594,4192,1402,171,1231,35608,33949,16648,0
7,1,2,2,18.5,33.9,24.6,23,488046,316087,78893,8351,1270,69272,93066,15463,31562,20442,5102,540,82,4480,6019,395641,271965,78294,63932,14362,45382,11872,33510,7036,5449,1587,138,1449,56231,49911,23126,2
7,1,8,6,20.9,40.9,26.7,11.5,546329,277755,190375,14620,2880,172875,78199,19606,27865,14167,9710,746,147,8817,3989,250014,173487,46184,31379,14805,30343,516,29827,7332,5666,1666,255,1411,34099,30619,21139,1
0,1,3,2,23.6,34.1,23.8,18.5,2429403,1462942,507618,41522,6113,459983,458843,89358,27187,16372,5681,465,68,5148,5135,1289633,854407,223910,158023,65887,211316,29770,181546,42490,33055,9435,1348,8087,30351,25848,22449,8
10,1,6,6,22.6,30.9,34.1,12.3,588319,311139,198922,23042,883,174997,78258,18671,31510,16664,10654,1234,47,9373,4191,244967,153629,38854,27101,11753,52484,-842,53326,7031,4941,2090,385,1705,34841,31093,31276,1
7,1,9,10,15.5,37.8,30.6,16.2,237780,126025,79428,9051,1040,69337,32327,7903,30087,15946,10050,1145,132,8774,4090,94725,62692,17533,12715,4818,14500,2537,11963,2766,1862,904,165,739,34246,33669,16188,0
9,1,6,6,24.6,41.7,21.5,12.2,467969,282407,127813,10257,522,117034,57749,14870,31471,18992,8595,690,35,7870,3884,274241,182886,50147,39346,10801,41208,-698,41906,6305,4896,1409,161,1248,43496,37354,33579,0
1,1,2,2,26.6,40.6,21.7,11.1,724192,523811,126226,15894,1380,108952,74155,22666,31951,23110,5569,701,61,4807,3272,545403,395160,93936,67641,26295,56307,6099,50208,12786,10551,2235,93,2142,42656,37452,23440,0
8,1,7,11,16.8,39.6,28.1,15.4,682230,359262,216160,31456,2054,182650,106808,20105,33933,17869,10752,1565,102,9085,5313,402154,271346,69984,49626,20358,60824,26134,34690,9585,7506,2079,431,1648,41957,36151,21050,0
9,1,3,2,10.9,30.9,35.9,22.4,6929572,3893469,1578583,153687,12126,1412770,1457520,178221,38882,21846,8857,862,68,7927,8178,4487884,3286487,837666,581234,256432,363731,-56,363787,102764,82356,20408,97,20311,43672,39906,17911,13
1,1,7,8,34.1,31.5,25.6,8.8,591371,368578,155592,10456,2004,143132,67201,23217,25471,15875,6702,450,86,6165,2894,249418,176149,43731,30391,13340,29538,3508,26030,7914,6278,1636,427,1209,31516,28058,21530,2
5,1,7,9,25.5,36.5,26.2,11.8,477773,251477,160509,20179,4453,135877,65787,17439,27397,14420,9204,1157,255,7792,3772,279210,191257,46198,30761,15437,41755,18111,23644,8626,6376,2250,505,1745,32368,29996,13550,0
5,1,6,6,20.4,42.6,23.9,13.1,684253,407309,192608,21301,5672,165635,84336,25721,26603,15836,7488,828,221,6440,3279,411436,288278,85921,69716,16205,37237,3339,33898,10736,8929,1807,359,1448,38323,32286,23410,0
3,1,7,9,40.6,30.4,19.5,9.5,451156,222188,142479,16261,2422,123796,86489,17639,25577,12596,8077,922,137,7018,4903,218464,170653,44049,30386,13663,3762,9292,-5530,8289,6113,2176,520,1656,26356,27916,-3339,0
10,1,2,2,13.7,32.6,30.6,23,14893696,8796150,3706020,501331,22083,3182606,2391526,414588,35924,21217,8939,1209,53,7677,5768,11263204,8189790,1968893,1357560,611333,1104521,20766,1083755,233931,183792,50139,588,49551,48148,44560,21872,16
6,1,2,2,12.2,31.6,35.6,20.7,4884492,2962702,1035820,106969,24947,903904,885970,139936,34905,21172,7402,764,178,6459,6331,3306590,2444123,633765,454704,179061,228702,-5961,234663,65271,52898,12373,367,12006,50659,46204,19545,1
0,1,6,6,40.3,26.7,21.9,11.2,397335,194201,158478,33642,1883,122953,44656,20052,19815,9685,7903,1678,94,6132,2227,180222,116096,31516,22834,8682,32610,16264,16346,6309,4640,1669,468,1201,28566,25021,13610,0
0,1,3,2,34.8,35.9,21.2,8.1,391336,239234,103354,17191,943,85220,48748,16622,23543,14393,6218,1034,57,5127,2933,168755,102861,29010,21306,7704,36884,23509,13375,5363,4046,1317,366,951,31467,25423,14064,0
4,1,7,9,27.1,33.4,27.4,12.1,607030,328440,195161,20442,4603,170116,83429,21790,27858,15073,8956,938,211,7807,3829,272485,183972,49921,36005,13916,38592,20150,18442,8482,6518,1964,533,1431,32125,28225,12887,1
7,1,2,2,9.8,27.2,28.6,34.5,19350106,12691638,3127156,481020,48415,2597721,3531312,442980,43682,28651,7059,1086,109,5864,7972,17856255,12853451,2893327,2088122,805205,2109477,159,2109318,337357,274782,62575,365,62210,52930,46777,33906,51
8,1,7,11,29.5,39.3,21.5,9.8,293255,164111,87822,15771,912,71139,41322,7498,39111,21887,11713,2103,122,9488,5511,171971,68499,20523,16258,4265,82949,72322,10627,2915,2096,819,175,644,58995,32681,16502,0
10,1,9,10,19.8,45,24.8,10.3,439524,226325,155340,18439,669,136232,57859,14590,30125,15512,10647,1264,46,9337,3966,154680,89321,22768,15990,6778,42591,15510,27081,4938,2930,2008,567,1441,31324,30485,18793,0
7,1,6,6,22.6,30.9,34.1,12.3,582818,332611,178589,22912,2615,153062,71618,19149,30436,17370,9326,1197,137,7993,3740,274643,151890,38793,26738,12055,83960,1399,82561,7064,5067,1997,395,1602,38879,29976,51536,1
5,1,7,11,18.5,44.3,24.2,13,738027,386796,241344,35072,9504,196768,109887,25765,28645,15012,9367,1361,369,7637,4265,427095,303352,80829,57427,23402,42914,4139,38775,12221,9019,3202,263,2939,34948,33635,13193,0
5,1,6,6,16.5,44.7,24.6,14.2,700202,399879,207828,18593,3703,185532,92495,24233,28895,16501,8576,767,153,7656,3817,337432,188551,53833,41796,12037,95048,27621,67427,8452,6048,2404,327,2077,39923,31176,32464,0
7,1,7,11,18.5,44.3,24.2,13,757455,412337,235700,34174,4695,196831,109418,25152,30115,16394,9371,1359,187,7826,4350,435410,308635,76624,53649,22975,50151,2147,48004,11982,8792,3190,239,2951,36339,35104,16267,2
1,1,7,8,31.9,34.8,21.5,11.7,864466,482977,257856,21963,2441,233452,123633,36183,23891,13348,7126,607,67,6452,3417,573608,421168,100034,67994,32040,52406,-2531,54937,17197,14330,2867,467,2400,33355,29391,22890,0
10,1,5,8,13.8,30.7,35.4,20.1,2763431,1515938,741940,87737,3655,650548,505553,78275,35304,19367,9479,1121,47,8311,6459,1927538,1389995,339690,230261,109429,197853,2313,195540,45704,37472,8232,303,7929,42174,37094,24661,3
9,1,6,6,20.6,37.1,30.3,11.9,736493,458281,190136,19657,1271,169208,88076,23310,31596,19660,8157,843,55,7259,3778,278530,204603,50822,35583,15239,23105,-1959,25064,8242,5843,2399,492,1907,33794,35017,13143,0
2,1,4,5,26.1,32.2,27.6,14,2004061,1158517,514148,45824,2858,465466,331396,66760,30019,17353,7701,686,43,6972,4964,1520249,1111377,283843,205249,78594,125029,9651,115378,40033,33681,6352,891,5461,37975,32997,21128,0
0,1,7,9,35.1,31.3,23.6,9.9,546096,330702,144542,13004,2205,129333,70852,25608,21325,12914,5644,508,86,5050,2767,305779,222841,59051,42457,16594,23887,4261,19626,9971,8507,1464,507,957,30667,26195,20508,0
7,1,7,9,16.7,29.9,37.1,16.3,652373,352264,215028,23072,2591,189365,85081,21496,30349,16387,10003,1073,121,8809,3958,287588,196799,52064,36264,15800,38725,11511,27214,8538,6511,2027,492,1535,33683,30226,17729,1
8,1,4,3,8.8,27.8,31.6,31.8,4941002,1974498,552826,41625,5982,505219,2413678,75914,65087,26010,7282,548,79,6655,31795,2295772,1623506,373416,253187,120229,298850,0,298850,57961,40542,17419,0,17419,39609,40045,17157,18
1,1,3,2,12,27.1,36.6,24.2,7250159,4329582,944539,72063,5611,866865,1976038,184071,39388,23521,5131,391,30,4709,10735,5562782,4017815,1078792,767884,310908,466175,2145,464030,125289,104985,20304,434,19870,44400,38270,23353,19
10,1,2,2,11.6,33.9,26.9,27.6,5570826,4210083,749194,70279,5962,672953,611549,119376,46666,35267,6276,589,50,5637,5123,3529353,2649516,616066,444334,171732,263771,-91,263862,61218,47879,13339,203,13136,57652,55338,20087,7
5,1,3,2,13.3,27.6,32.3,26.7,2357250,1330413,627229,73005,15258,538966,399608,75007,31427,17737,8362,973,203,7186,5328,2090253,1456793,358780,253094,105686,274680,1509,273171,47862,40703,7159,323,6836,43672,35791,39961,10
6,1,9,10,19.9,39.9,28.6,11.6,404661,212498,139617,18058,2709,118850,52546,13607,29739,15617,10261,1327,199,8734,3862,240572,169890,40603,28207,12396,30079,1205,28874,5503,3930,1573,232,1341,43717,43229,21532,0
2,1,6,5,40.6,36.9,15.1,7.4,690517,464541,145274,19373,1055,124846,80702,23543,29330,19732,6171,823,45,5303,3428,288160,206287,49501,36205,13296,32372,1252,31120,7369,5462,1907,68,1839,39104,37768,16922,0
7,1,9,10,23.8,45.9,20.6,9.7,190447,107089,50792,8760,685,41347,32566,4999,38097,21422,10160,1752,137,8271,6515,108708,40631,11144,8500,2644,56933,46636,10297,2004,1288,716,217,499,54246,31546,20635,0
6,1,6,6,24.6,41.7,21.5,12.2,444515,267386,125115,9798,1606,113711,52014,14930,29773,17909,8380,656,108,7616,3484,252233,181089,47149,36073,11076,23995,-168,24163,6285,4940,1345,163,1182,40133,36658,20442,2
5,1,7,9,24.7,39.3,22.5,13.4,307276,165270,107771,22052,2773,82946,34235,12105,25384,13653,8903,1822,229,6852,2828,176352,106082,34759,28219,6540,35511,17352,18159,5062,3908,1154,253,901,34838,27145,20154,2
6,1,1,1,14.1,23,26.4,36.5,15111718,9154765,2661636,494502,56769,2110365,3295317,360661,41900,25383,7380,1371,157,5851,9137,13888269,9710821,2166204,1520788,645416,2011244,0,2011244,247365,196983,50382,0,50382,56145,49298,39920,13
0,1,2,2,16.1,26.4,26.7,30.8,14513756,9686347,2428659,500462,76312,1851885,2398750,413812,35073,23408,5869,1209,184,4475,5797,13046733,9445722,2276256,1687939,588317,1324755,690,1324065,309845,266027,43818,393,43425,42107,35507,30491,57
4,1,6,5,33.4,38.8,18.1,9.7,849081,460945,286844,44275,9287,233282,101292,28147,30166,16376,10191,1573,330,8288,3599,382976,240453,59408,44929,14479,83115,46812,36303,10446,7458,2988,374,2614,36662,32241,13888,0
0,1,9,10,40.5,34.8,15.2,9.5,261138,144823,88498,11355,2660,74483,27817,11958,21838,12111,7401,950,222,6229,2326,134356,84105,22045,16586,5459,28206,17583,10623,4335,2963,1372,724,648,30993,28385,16394,0
4,1,1,1,39.5,30.2,21.3,9.1,292090,163127,85165,19767,3151,62247,43798,10862,26891,15018,7841,1820,290,5731,4032,513878,420257,70776,39137,31639,22845,17084,5761,14240,13296,944,78,866,36087,31608,6652,0
8,1,7,11,19.3,35.3,31.9,13.4,849716,455702,267242,27865,2908,236469,126772,30220,28118,15079,8843,922,96,7825,4195,481256,320409,82636,57072,25564,78211,30675,47536,13263,10236,3027,653,2374,36286,31302,20024,3
3,1,9,8,33.4,34.7,21,10.9,274728,156210,80040,8834,965,70241,38478,10694,25690,14607,7485,826,90,6568,3598,56116,39586,10305,7251,3054,6225,-6989,13214,2707,1495,1212,468,744,20730,26479,17761,0
10,1,6,6,26,38.4,22.7,12.9,1063127,555280,362450,42608,1852,317990,145397,33734,31515,16461,10744,1263,55,9426,4310,468990,307683,87542,67581,19961,73765,17359,56406,11929,8838,3091,559,2532,39315,34814,22277,0
3,1,6,3,29.6,32,26.5,11.9,2425037,1452703,578455,44931,6779,526745,393879,80273,30210,18097,7206,560,84,6562,4907,1324133,939622,224785,155117,69668,159726,28273,131453,40359,29787,10572,2112,8460,32809,31545,15538,9
10,1,2,2,17.4,42.3,26.8,13.5,1027395,568777,267359,30500,1696,235163,191259,27111,37896,20980,9862,1125,63,8674,7055,485969,361427,90368,69206,21162,34174,-6246,40420,10926,7382,3544,555,2989,44478,48961,13523,2
10,1,6,6,26.1,39.3,23.3,11.3,1422417,780757,455628,52603,2289,400736,186032,41042,34658,19023,11102,1282,56,9764,4533,560302,363507,111472,89850,21622,85323,7223,78100,16125,11736,4389,787,3602,34747,30974,21682,0
9,1,9,10,23,44.8,20.3,12,336963,179084,115837,11888,842,103107,42042,11527,29232,15536,10049,1031,73,8945,3647,135733,79619,24462,19638,4824,31652,15851,15801,3957,2501,1456,598,858,34302,31835,18416,0
0,1,1,1,28.3,32.5,26.8,12.3,692782,476890,137576,15738,1828,120010,78316,26968,25689,17684,5101,584,68,4450,2904,275862,175358,45710,32501,13209,54794,11011,43783,9650,6653,2997,564,2433,28587,26358,17995,1
0,1,5,8,34.7,24.3,22.1,18.8,870408,507101,241669,48136,3248,190285,121638,36305,23975,13968,6657,1326,89,5241,3350,528572,356419,95043,68862,26181,77110,46855,30255,15998,13538,2460,359,2101,33040,26327,14400,1
10,1,5,8,11.9,21.1,24.4,42.6,1548104,904233,336117,41616,2247,292254,307754,49480,31287,18275,6793,841,45,5907,6220,1093327,790366,218068,159490,58578,84893,687,84206,28775,23546,5229,333,4896,37996,33567,17199,8
2,1,3,2,25.4,33.8,24.3,16.5,4443753,2582102,1101572,108878,5689,987005,760079,130238,34120,19826,8458,836,44,7578,5836,3161886,2286080,568482,423428,145054,307324,14951,292373,79354,66776,12578,794,11784,39845,34235,24811,6
8,1,2,2,13,29.2,35.6,22.2,6735981,3779351,1552904,192236,20135,1340533,1403726,196051,34358,19277,7921,981,103,6838,7160,5205159,3816004,1008222,698460,309762,380933,1372,379561,121322,98291,23031,275,22756,42904,38824,16680,8
7,1,2,2,23.6,36,26.1,14.3,752730,387371,242867,43427,4058,195382,122492,28336,26564,13671,8571,1533,143,6895,4323,364784,251762,68681,49236,19445,44341,333,44008,9961,7012,2949,551,2398,36621,35904,18352,0
10,1,6,5,15,33.1,32.6,19.4,1378138,794843,375992,49719,2411,323862,207303,39003,35334,20379,9640,1275,62,8304,5315,801485,499019,150495,121008,29487,151971,29323,122648,18697,14196,4501,521,3980,42867,35152,30816,1
8,1,3,2,14.1,26.5,32.6,26.7,2699385,1458790,432111,39264,4548,388299,808484,59179,45614,24650,7302,663,77,6561,13662,1229235,794417,181159,122691,58468,253659,4721,248938,33975,23035,10940,610,10330,36181,34487,24099,13
2,1,2,2,31.2,35.3,22.6,10.9,738201,442743,210377,21787,1271,187319,85081,27512,26832,16093,7647,792,46,6809,3093,324707,198431,50064,35143,14921,76212,30787,45425,11190,8222,2968,631,2337,29018,24134,19437,0
1,1,1,1,32.1,22.3,23.9,21.7,89171620,53639962,14735037,2078620,125870,12530547,20796621,2405911,37064,22295,6125,864,52,5208,8644,67660193,48687033,10270843,6875574,3395269,8702317,52961,8649356,1420814,1106519,314295,1581,312714,47621,44000,27659,209
10,1,2,2,21.5,30.7,34.5,13.3,899136,512054,288982,42921,1299,244762,98100,28812,31207,17772,10030,1490,45,8495,3405,402848,266644,73330,51589,21741,62874,14064,48810,11002,7736,3266,410,2856,36616,34468,17090,0
4,1,7,9,34.5,32.4,22.2,10.9,978775,525737,311250,31821,11275,268154,141788,37258,26270,14111,8354,854,303,7197,3806,483288,344819,90212,63405,26807,48257,4438,43819,13703,10415,3288,615,2673,35269,33108,16393,1
6,1,8,6,17.3,39.7,24.7,18.2,365878,185933,130769,26920,3170,100679,49176,13491,27120,13782,9693,1995,235,7463,3645,185433,114659,35067,26341,8726,35707,22627,13080,5308,3680,1628,381,1247,34935,31157,10489,0
2,1,1,1,39,32.5,19.4,9,890794,588706,215077,32399,2299,180379,87011,36950,24108,15933,5821,877,62,4882,2355,314798,209784,51711,35945,15766,53303,2827,50476,11767,7333,4434,489,3945,26753,28608,12795,3
1,1,6,4,36.5,29.5,23.1,10.8,812158,491769,213904,32733,2430,178741,106485,34705,23402,14170,6163,943,70,5150,3068,510293,340885,88272,62589,25683,81136,10964,70172,15509,12195,3314,634,2680,32903,27953,26184,0
1,1,9,10,32.5,33.8,23.2,10.5,184959,107760,55715,6402,456,48857,21484,8111,22803,13286,6869,789,56,6024,2649,83755,56816,15754,11537,4217,11185,2405,8780,2734,1952,782,168,614,30635,29107,14300,0
2,1,4,5,34.4,38,16.9,10.7,1765274,1125005,328040,34457,2029,291554,312229,56835,31060,19794,5772,606,36,5130,5494,777957,537445,126980,94167,32813,113532,16532,97000,21336,15027,6309,988,5321,36462,35765,18230,1
0,1,7,9,31.8,33.3,21,13.8,460941,269480,124258,16334,1369,106555,67203,19583,23538,13761,6345,834,70,5441,3432,256258,178266,43801,30373,13428,34191,10426,23765,7858,6001,1857,473,1384,32611,29706,17171,0
4,1,3,2,23.6,34.1,23.8,18.5,2744942,1535274,695076,59543,21308,614225,514592,92526,29667,16593,7512,644,230,6638,5562,1387893,970847,255880,182830,73050,161166,12980,148186,43682,33172,10510,1445,9065,31773,29267,16347,1
10,1,7,9,24.9,37.4,25,12.6,656917,367212,195368,25901,956,168511,94337,20486,32067,17925,9537,1264,47,8226,4605,336658,191881,46330,32034,14296,98447,46480,51967,7827,5499,2328,407,1921,43012,34894,27052,0
3,1,8,7,33.6,34.9,21.2,10.4,322031,179648,104522,14507,1099,88916,37861,12636,25485,14217,8272,1148,87,7037,2996,157677,118781,24637,16205,8432,14259,4523,9736,4115,2902,1213,355,858,38318,40931,11347,0
4,1,9,8,33.3,34.5,22.4,9.8,489687,274329,146405,18131,3845,124429,68953,17344,28234,15817,8441,1045,222,7174,3976,216354,144747,37178,26303,10875,34429,18860,15569,6208,4542,1666,424,1242,34851,31869,12535,1
2,1,1,1,20.7,30,27.8,21.5,18722605,11605830,2524430,248330,17601,2258499,4592345,432683,43271,26823,5834,574,41,5220,10614,12859101,8756020,1801473,1238877,562596,2301608,243,2301365,265423,211695,53728,50,53678,48448,41361,42874,43
8,1,8,7,24.3,35.8,25,15,315157,158452,122723,19001,1603,102119,33982,11953,26366,13256,10267,1590,134,8543,2843,111265,59021,15767,11079,4688,36477,25943,10534,3344,1956,1388,286,1102,33273,30174,9559,0
0,1,9,8,33.3,34.5,22.4,9.8,420652,263182,110352,16970,1302,92080,47118,17496,24043,15042,6307,970,74,5263,2693,206768,125858,33316,24056,9260,47594,26671,20923,6114,4532,1582,446,1136,33819,27771,18418,0
3,1,2,2,30.7,30.2,27.6,11.6,786673,460668,227698,32006,2420,193272,98307,29584,26591,15572,7697,1082,82,6533,3323,360269,253335,69650,50487,19163,37284,7190,30094,12233,9407,2826,530,2296,29451,26930,13107,0
0,1,3,2,22.1,29.3,31.3,17.3,1272801,647897,437387,109584,5008,322795,187517,47715,26675,13578,9167,2297,105,6765,3930,784651,574588,146015,102422,43593,64048,251,63797,18149,14516,3633,252,3381,43234,39583,18869,2
9,1,3,2,9.8,27.8,31.7,30.7,7875234,4602407,1670285,126945,9254,1534086,1602542,199064,39561,23120,8391,638,46,7706,8050,3430467,2368668,548311,368769,179542,513488,3654,509834,99837,70747,29090,845,28245,34361,33481,18050,12
1,1,7,9,35.3,34.8,20.4,9.5,498047,288849,129611,18353,1127,110131,79587,21111,23592,13682,6140,869,53,5217,3770,270288,183492,45771,32213,13558,41025,13003,28022,8234,6329,1905,457,1448,32826,28992,19352,0
2,1,2,2,19.6,21.9,31.3,27.2,8031125,4850088,1470834,239472,13544,1217818,1710203,246546,32575,19672,5966,971,55,4940,6937,7663687,5622428,1299522,898311,401211,741737,1312,740425,174004,145000,29004,874,28130,44043,38775,26322,7
2,1,7,11,29.2,37.7,21.1,12.1,700247,390064,191580,28028,1777,161775,118603,26436,26488,14755,7247,1060,67,6119,4486,435251,310135,78079,55545,22534,47037,7653,39384,13784,10314,3470,292,3178,31577,30069,12393,0
3,1,1,1,16.1,26.5,29,28.3,10661320,7076737,1391113,106877,11623,1272613,2193470,229252,46505,30869,6068,466,51,5551,9568,4646158,3039455,674181,485530,188651,932522,-1007,933529,116916,81182,35734,503,35231,39739,37440,26497,23
8,1,3,2,16.1,33.7,31.4,18.8,1822526,1022719,524515,49806,6128,468581,275292,54528,33424,18756,9619,913,112,8593,5049,1370411,986541,249945,172080,77865,133925,25422,108503,30599,24641,5958,625,5333,44786,40037,20346,2
0,1,8,6,30.3,37.8,22.1,9.8,525012,312389,138087,18122,1074,118891,74536,20192,26001,15471,6839,897,53,5888,3691,215228,116082,32192,23371,8821,66954,36271,30683,6251,4519,1732,403,1329,34431,25688,23087,0
10,1,6,4,22.2,38.2,25.2,14.4,1057842,587309,335516,50066,1878,283572,135017,34153,30974,17196,9824,1466,55,8303,3953,606368,422425,99985,67720,32265,83958,1882,82076,16833,11970,4863,613,4250,36023,35290,19312,0
10,1,9,10,22.6,41.6,21.9,13.9,313302,159771,110555,12176,661,97718,42976,10038,31212,15917,11014,1213,66,9735,4281,120187,75790,23812,19065,4747,20585,-2076,22661,3866,2408,1458,480,978,31088,31474,23171,0
1,1,6,3,21.5,22.7,24.7,31.1,1317820,806006,204747,15781,2107,186859,307067,44281,29760,18202,4624,356,48,4220,6935,920321,641399,169796,123279,46517,109126,2180,106946,26690,21194,5496,431,5065,34482,30263,21115,6
4,1,2,2,21.3,32.2,25.9,20.6,9793652,5893266,2000502,271697,47453,1681352,1899884,253245,38673,23271,7899,1073,187,6639,7502,7588619,5062346,1219238,894156,325082,1307035,-155,1307190,162007,129309,32698,523,32175,46841,39149,40628,12
8,1,7,9,19.8,33.7,25.6,21,311024,148201,116421,13338,1496,101587,46402,10575,29411,14014,11009,1261,141,9606,4388,134923,88150,22597,15911,6686,24176,7917,16259,4024,2954,1070,293,777,33530,29841,20925,0
5,1,4,3,8.8,27.8,31.6,31.8,4473432,1841866,529043,39240,19857,469946,2102523,73219,61097,25156,7225,536,271,6418,28716,2106018,1540868,364760,248329,116431,200390,0,200390,53678,38029,15649,0,15649,39234,40518,12805,15
5,1,6,5,19.3,34.6,30.1,15.9,1091964,564736,376896,56824,8364,311708,150332,40447,26997,13962,9318,1405,207,7707,3717,670962,465660,117321,82677,34644,87981,3347,84634,20976,15714,5262,469,4793,31987,29633,17658,0
5,1,6,6,21.7,38.3,27.9,12.1,563684,319233,182406,24802,4391,153213,62045,23738,23746,13448,7684,1045,185,6454,2614,286869,176632,46654,32702,13952,63583,36079,27504,8649,6467,2182,586,1596,33168,27313,17233,0
4,1,9,8,39.5,28.3,21.9,10.3,231109,104612,92677,10817,2455,79405,33820,10526,21956,9938,8805,1028,233,7544,3213,76932,54909,16850,12617,4233,5173,2961,2212,3001,2120,881,373,508,25635,25900,4354,0
0,1,1,1,39.5,30.2,21.3,9.1,251934,153504,60555,13701,1045,45809,37875,10425,24166,14725,5809,1314,100,4394,3633,596488,472366,84178,46553,37625,39944,23199,16745,16609,15931,678,79,599,35914,29651,27955,0
7,1,9,8,15.9,37.3,32.9,13.9,527657,296806,161114,19748,2406,138960,69737,16553,31877,17931,9733,1193,145,8395,4213,240979,167214,42669,29283,13386,31096,10798,20298,6392,4687,1705,385,1320,37700,35676,15377,0
3,1,8,6,37.6,30.4,22,10,264422,121474,107180,22221,1321,83638,35768,10722,24662,11329,9996,2072,123,7801,3336,119871,72141,19879,14351,5528,27851,12814,15037,3973,2801,1172,333,839,30171,25755,17923,0
8,1,9,10,18.6,35.6,28.5,17.3,240776,135059,77391,9398,962,67031,28326,8455,28477,15974,9153,1112,114,7928,3350,128452,86330,22680,16224,6456,19442,5993,13449,3434,2405,1029,212,817,37406,35896,16461,1
1,1,3,2,25.2,30.2,32.2,12.4,407347,245293,106328,9613,1153,95562,55726,15968,25510,15362,6659,602,72,5985,3490,192774,133504,33566,23736,9830,25704,983,24721,6740,4766,1974,277,1697,28601,28012,14567,0
9,1,7,11,18.5,44.3,24.2,13,809571,439186,253046,34799,1825,216422,117339,24865,32559,17663,10177,1400,73,8704,4719,473317,336107,84421,60203,24218,52789,4164,48625,12052,8946,3106,242,2864,39273,37571,16978,0
0,1,6,6,27.4,37.1,25.3,10.1,365012,209528,86491,7921,587,77983,68993,15781,23130,13277,5481,502,37,4942,4372,203560,130786,39226,30150,9076,33548,0,33548,5866,4303,1563,0,1563,34702,30394,21464,0
10,1,7,11,19.3,35.3,31.9,13.4,910201,479028,285780,28188,1496,256096,145393,30116,30223,15906,9489,936,50,8504,4828,501986,339334,91186,64723,26463,71466,30258,41208,13371,10375,2996,645,2351,37543,32707,17528,2
2,1,8,4,41.2,32.2,18.8,7.8,182450,111436,55902,7390,564,47948,15112,8603,21208,12953,6498,859,66,5573,1757,56553,35375,9574,6931,2643,11604,688,10916,2107,1294,813,268,545,26841,27338,20029,1
6,1,7,11,16.8,39.6,28.1,15.4,658510,341942,208655,32505,4293,171857,107913,20649,31891,16560,10105,1574,208,8323,5226,360642,249971,68421,49191,19230,42250,8569,33681,9855,7412,2443,448,1995,36595,33725,16883,0
8,1,1,1,15.1,31.4,28.3,25.2,19453497,12514515,3426715,370312,29049,3027354,3512267,435197,44700,28756,7874,851,67,6956,8071,14007210,9559127,1987336,1355148,632188,2460747,3605,2457142,273331,208206,65125,51,65074,51246,45912,37759,59
4,1,6,5,26.4,39.7,21,12.9,467836,266053,141272,13525,2580,125167,60511,16118,29026,16507,8765,839,160,7766,3754,213735,134948,34786,26974,7812,44001,3288,40713,5109,3846,1263,173,1090,41835,35088,37351,1
3,1,9,8,33.3,34.5,22.4,9.8,502050,296778,138310,16281,1472,120557,66962,17550,28607,16910,7881,928,84,6869,3815,232089,158124,38394,26920,11474,35571,16336,19235,6546,4831,1715,436,1279,35455,32731,15039,1
7,1,7,9,19.8,33.7,25.6,21,302791,141027,114327,13699,1856,98772,47437,10599,28568,13306,10787,1292,175,9319,4476,121232,84332,21816,15165,6651,15084,-1928,17012,4023,2948,1075,296,779,30135,28607,21838,1
4,1,7,8,31.9,34.8,21.5,11.7,968565,497468,325128,30616,9125,285387,145969,36868,26271,13493,8819,830,248,7741,3959,595401,441525,105146,71895,33251,48730,-423,49153,16581,13444,3137,452,2685,35909,32842,18307,0
5,1,3,2,20.2,37.8,30.3,11.8,577747,301478,194139,25999,5038,163102,82130,19749,29254,15265,9830,1316,255,8259,4159,195863,120144,34656,25089,9567,41063,15531,25532,5849,4038,1811,404,1407,33487,29753,18146,0
1,1,7,8,29.7,32,25.7,12.5,976530,552929,287309,39325,2262,245722,136292,40241,24267,13740,7140,977,56,6106,3387,661533,469341,118417,83195,35222,73775,-1340,75115,21983,17323,4660,508,4152,30093,27094,18091,1
7,1,7,9,25.5,36.5,26.2,11.8,519806,282508,163824,20932,2849,140043,73474,17497,29708,16146,9363,1196,163,8004,4199,307911,197467,48282,31323,16959,62162,20930,41232,8720,6401,2319,485,1834,35311,30849,22482,0
7,1,1,1,15.8,37.3,30.5,16.4,1658644,1139411,340608,56207,5556,278845,178625,44728,37083,25474,7615,1257,124,6234,3994,1194043,794371,208639,158283,50356,191033,1771,189262,21020,15739,5281,16,5265,56805,50472,35947,1
10,1,7,8,19.2,33.5,31.3,15.9,1217167,650463,393689,35015,1453,357221,173015,37250,32676,17462,10569,940,39,9590,4645,714263,526436,121945,82061,39884,65882,1822,64060,19179,15012,4167,429,3738,37242,35068,17138,1
9,1,7,9,29.1,34.6,26.2,10.1,388474,202029,135534,23503,985,111046,50911,14701,26425,13743,9219,1599,67,7554,3463,188261,113472,28098,18982,9116,46691,23424,23267,5178,3692,1486,432,1054,36358,30735,22075,0
2,1,3,2,23,34.6,25.6,16.9,6327311,3928813,1090371,114411,8259,967701,1308127,187081,33821,21001,5828,612,44,5173,6992,4706934,3472500,849549,631277,218272,384885,-1111,385996,109153,91597,17556,815,16741,43122,37911,23057,4
4,1,7,9,31.8,33.3,21,13.8,496197,242475,173745,23295,6520,143930,79977,19211,25829,12622,9044,1213,339,7492,4163,210930,151528,38398,26906,11492,21004,7712,13292,7267,5243,2024,457,1567,29026,28901,8482,2
8,1,7,9,31.8,30.1,25.3,12.9,381448,223757,120792,23879,1651,95262,36899,11052,34514,20246,10929,2161,149,8619,3339,189364,80010,22210,15913,6297,87144,64106,23038,4849,2797,2052,485,1567,39052,28606,14702,1
7,1,8,6,18.3,36.8,28.8,16.1,561802,309336,174407,23836,2456,148115,78059,19442,28896,15911,8971,1226,126,7618,4015,262235,171354,44892,31342,13550,45989,10979,35010,7927,5573,2354,424,1930,33081,30747,18140,1
10,1,4,5,20.2,48.9,20.2,10.6,2096470,1215674,503539,59745,3502,440292,377257,52920,39616,22972,9515,1129,66,8320,7129,1819603,1381407,317720,230559,87161,120476,-8724,129200,32648,27076,5572,96,5476,55734,51020,23594,2
7,1,2,2,21.5,43.5,22.3,12.7,2919444,1834220,596506,89534,7022,499950,488718,73783,39568,24860,8085,1213,95,6776,6624,2274051,1649537,335997,229186,106811,288517,-1710,290227,44220,34971,9249,210,9039,51426,47169,32108,12
9,1,8,7,23.1,42.8,21.8,12.4,309777,169853,100752,10278,474,90000,39172,9946,31146,17078,10130,1033,48,9049,3938,132700,87361,25862,20283,5579,19477,-1059,20536,3892,2729,1163,241,922,34096,32012,22273,0
3,1,4,5,18,29.6,29.3,23.1,6286039,3662845,1141954,70757,11210,1059987,1481240,175827,35751,20832,6495,402,64,6029,8424,2871664,2113709,471021,315696,155325,286934,-5250,292184,92684,68177,24507,948,23559,30983,31003,12402,7
10,1,4,5,12.8,32.2,32.1,22.9,1730681,995801,446614,61268,2368,382978,288266,47510,36428,20960,9400,1290,50,8061,6067,1236126,928211,246018,172281,73737,61897,332,61565,26838,21916,4922,187,4735,46059,42353,13002,2
8,1,5,8,16.8,25.9,33.9,23.5,2960763,1868453,660899,75527,9548,575824,431411,84961,34848,21992,7779,889,112,6778,5078,2742073,2021085,443828,287198,156630,277160,13793,263367,64455,54581,9874,441,9433,42542,37029,27920,14
0,1,9,10,41.2,31.2,20.5,7.1,43107,32677,6597,1519,206,4872,3833,1720,25062,18998,3835,883,120,2833,2228,25838,7813,2000,1405,595,16025,14625,1400,456,334,122,74,48,56662,23392,29167,0
7,1,6,4,22.4,33.7,29.4,14.5,629083,343657,208602,23561,3146,181895,76824,21904,28720,15689,9523,1076,144,8304,3507,304422,207392,53246,36053,17193,43784,-382,44166,9338,6597,2741,598,2143,32600,31437,20609,0
2,1,3,2,23.6,34.1,23.8,18.5,2711149,1574248,585068,48926,6302,529840,551833,91107,29758,17279,6422,537,69,5816,6057,1394920,968293,236098,164596,71502,190529,21859,168670,45370,35230,10140,1530,8610,30745,27485,19590,3
6,1,2,2,13.5,26.4,25.2,34.9,21341492,7405497,2708576,199013,59748,2449815,11227419,327667,65132,22601,8266,607,182,7477,34265,7751079,5301096,1053556,676066,377490,1396427,41647,1354780,176891,123692,53199,243,52956,43818,42857,25583,61
5,1,9,8,17.9,34.5,31.2,16.4,296404,165111,92654,10805,2397,79452,38639,10602,27957,15574,8739,1019,226,7494,3645,62333,38800,10146,7060,3086,13387,-3522,16909,2734,1396,1338,456,882,22799,27794,19171,0
3,1,3,2,32.9,35.8,19,12.3,4385737,3019682,699509,86767,5477,607265,666546,111453,39351,27094,6276,779,49,5449,5981,3596321,2708193,533291,363376,169915,354837,8913,345924,72088,60687,11401,133,11268,49888,44626,30700,5
3,1,8,7,27.1,34.2,26.8,12,357521,200838,115097,10987,1170,102940,41586,13038,27421,15404,8828,843,90,7895,3190,174397,116859,28726,20260,8466,28812,13482,15330,4615,3234,1381,389,992,37789,36135,15454,0
3,1,8,7,34.6,38.6,18,8.8,312485,183537,94499,9120,650,84729,34449,10224,30564,17952,9243,892,64,8287,3369,115509,82586,23024,17981,5043,9899,-1275,11174,3934,2887,1047,255,792,29362,28606,14109,0
5,1,2,2,13,29.2,35.6,22.2,6537042,3753883,1417256,165397,36445,1215414,1365903,187838,34801,19985,7545,881,194,6471,7272,5177508,3743769,985558,690554,295004,448181,-1572,449753,118388,99022,19366,294,19072,43733,37807,23582,14
6,1,1,1,21.3,29.5,32,17.1,307170,166365,94567,21650,3175,69742,46238,10580,29033,15724,8938,2046,300,6592,4370,484513,386662,69345,35556,33789,28506,19459,9047,13203,11923,1280,82,1198,36697,32430,7552,0
0,1,4,5,26.1,32.2,27.6,14,1808624,1054743,489386,53193,3941,432252,264495,65871,27457,16012,7429,808,60,6562,4015,1339356,941081,250006,181168,68838,148269,50390,97879,36937,31188,5749,929,4820,36261,30174,20307,1
3,1,2,2,30.9,39.1,17.3,12.8,788681,482456,168812,22328,1374,145110,137413,22966,34341,21007,7351,972,60,6318,5983,311825,211638,55584,41348,14236,44603,12537,32066,8977,6326,2651,366,2285,34736,33455,14033,0
1,1,7,10,45.6,24.2,19.2,10.9,314481,174408,93082,17641,996,74445,46991,15283,20577,11412,6091,1154,65,4871,3075,128631,80999,20973,14899,6074,26659,13347,13312,4521,3371,1150,384,766,28452,24028,17379,0
9,1,2,2,10.3,26.2,34.3,29.2,6226424,4277381,1093221,83247,5562,1004412,855822,148406,41955,28822,7366,561,37,6768,5767,3866015,2576246,572259,382631,189628,717510,45226,672284,85378,65897,19481,565,18916,45281,39095,35540,6
10,1,3,2,15.3,37.1,27.5,20.1,5581124,3084823,1578941,143996,7532,1427413,917360,131993,42283,23371,11962,1091,57,10814,6950,3757732,2478895,660620,496442,164178,618217,11555,606662,76220,62487,13733,690,13043,49301,39671,46512,7
7,1,6,6,20.6,39,25,15.4,689348,389330,208556,28227,2800,177529,91462,20919,32953,18611,9970,1349,134,8486,4372,346567,216165,57809,43094,14715,72593,34312,38281,9671,6962,2709,648,2061,35836,31049,18574,0
6,1,9,10,18.6,35.6,28.5,17.3,219045,113893,75358,9187,1404,64767,29794,8443,25944,13490,8926,1088,166,7671,3529,105889,71981,18942,13441,5501,14966,979,13987,3145,2187,958,223,735,33669,32913,19030,0
9,1,4,3,8.8,27.8,31.6,31.8,5477252,2085487,592373,41849,2677,547847,2799392,76492,71606,27264,7744,547,35,7162,36597,2425799,1723599,386244,260255,125989,315956,0,315956,60201,42072,18129,0,18129,40295,40968,17428,20
2,1,7,8,29.7,32,25.7,12.5,1000646,555708,297808,41745,2102,253961,147130,40141,24928,13844,7419,1040,52,6327,3665,661522,469780,118906,84102,34804,72836,-704,73540,22039,16997,5042,512,4530,30016,27639,16234,0
0,1,2,2,17.9,28.3,32.7,21,8886428,5399671,1640904,197995,10772,1432137,1845853,298339,29786,18099,5500,664,36,4800,6187,6957198,5119555,1351701,980023,371678,485942,4409,481533,172394,146989,25405,590,24815,40356,34830,19405,18
3,1,3,2,19,30.6,32.7,17.7,6097526,3543208,1159220,100811,18528,1039881,1395098,166267,36673,21310,6972,606,111,6254,8391,4103972,2988025,763891,546114,217777,352056,-66,352122,99109,81267,17842,113,17729,41409,36768,19861,15
5,1,3,2,14.1,35.3,28.1,22.5,2886404,1616473,752448,67520,22147,662781,517483,92735,31125,17431,8114,728,239,7147,5580,1421988,971691,259383,182268,77115,190914,-394,191308,43230,32756,10474,1425,9049,32894,29665,21141,4
10,1,2,2,22.5,38.8,23.8,15,1217285,752502,304837,39441,2003,263393,159946,33152,36718,22699,9195,1190,60,7945,4825,1333741,1035599,258443,193704,64739,39699,-2506,42205,20110,16672,3438,127,3311,66322,62116,12747,2
3,1,7,8,36.6,33.7,18.7,11,285619,145326,103251,21013,980,81258,37042,12340,23146,11777,8367,1703,79,6585,3002,150969,108462,32113,25703,6410,10394,237,10157,4949,3914,1035,260,775,30505,27711,13106,1
4,1,3,2,35.2,34.9,19.4,10.5,248314,107672,84797,16498,2006,66293,55845,9182,27044,11726,9235,1797,218,7220,6082,111521,74553,24568,18895,5673,12400,8251,4149,3432,2423,1009,268,741,32494,30769,5599,0
8,1,2,2,18.5,33.9,24.6,23,500073,318896,85252,8358,890,76004,95925,15448,32371,20643,5519,541,58,4920,6210,422585,285238,86989,71936,15053,50358,14615,35743,7268,5622,1646,135,1511,58143,50736,23655,4
4,1,8,6,35.4,36,20,8.7,485313,233804,173915,12727,4895,156293,77594,19552,24822,11958,8895,651,250,7994,3969,224154,162377,43527,31145,12382,18250,-494,18744,7117,5648,1469,284,1185,31496,28749,15818,2
2,1,2,2,18.2,27.4,30.6,23.8,4854574,3367748,696981,52640,5740,638601,789845,136694,35514,24637,5099,385,42,4672,5778,3036037,2190414,480758,323777,156981,364865,15281,349584,80205,63168,17037,668,16369,37853,34676,21356,12
7,1,5,8,20.5,34.8,27.4,17.4,1034276,518288,319010,45373,4252,269385,196978,32175,32145,16108,9915,1410,132,8372,6122,625687,418661,94404,62120,32284,112622,3159,109463,16401,12171,4230,155,4075,38149,34398,26862,0
8,1,5,8,11.9,21.1,24.4,42.6,1465692,885916,312114,41330,5232,265552,267662,49076,29866,18052,6360,842,107,5411,5454,1042998,724377,201015,147257,53758,117606,14702,102904,27185,22205,4980,337,4643,38367,32622,22163,17
8,1,8,7,20.5,37.6,28.7,13.3,421236,215063,147705,15075,1228,131402,58468,14210,29644,15135,10394,1061,86,9247,4115,182552,126660,32859,22880,9979,23033,2947,20086,5517,3696,1821,321,1500,33089,34269,13391,0
5,1,2,2,17.1,37.5,25.3,20.1,910548,659637,161393,21024,5011,135358,89518,23953,38014,27539,6738,878,209,5651,3737,713312,496203,129483,96759,32724,87626,4134,83492,14210,11689,2521,98,2423,50198,42450,34458,0
6,1,6,4,22.4,33.7,29.4,14.5,612692,328497,208337,22815,4046,181476,75858,22026,27817,14914,9459,1036,184,8239,3444,301589,207404,52710,35389,17321,41475,662,40813,9461,6634,2827,598,2229,31877,31264,18310,0
9,1,9,8,17.9,34.5,31.2,16.4,329205,184895,96025,9554,543,85928,48285,10233,32171,18069,9384,934,53,8397,4719,63423,41566,11331,8084,3247,10526,-12692,23218,2775,1442,1333,429,904,22855,28825,25684,0
4,1,9,10,33,34,22.5,10.4,360215,179087,133908,17772,3266,112870,47220,15505,23232,11550,8636,1146,211,7280,3045,136302,86814,22479,15824,6655,27009,8739,18270,5091,3168,1923,626,1297,26773,27403,14086,0
2,1,1,1,36.8,35.7,20.4,7.1,540644,346947,136071,15750,997,119324,57626,22438,24095,15462,6064,702,44,5318,2568,204190,145323,37815,27119,10696,21052,2656,18396,6565,4788,1777,186,1591,31103,30352,11563,0
1,1,9,8,31.2,36.8,22.3,9.6,434655,265424,124612,12580,920,111112,44619,16976,25604,15635,7340,741,54,6545,2628,135098,89221,23834,17269,6565,22043,4125,17918,4933,3396,1537,324,1213,27387,26272,14772,0
7,1,9,8,17.9,34.5,31.2,16.4,327218,186753,96012,10711,1502,83799,44453,10401,31460,17955,9231,1030,144,8057,4274,74408,43073,11351,7757,3594,19984,-4913,24897,2791,1473,1318,435,883,26660,29242,28196,0
2,1,3,2,19,30.6,32.7,17.7,5897951,3528582,1017523,89567,9858,918098,1351846,165345,35671,21341,6154,542,60,5553,8176,4086851,2982734,742797,525898,216899,361320,65,361255,100794,82430,18364,120,18244,40547,36185,19801,25
7,1,9,10,24.6,35.9,28.2,11.2,402572,205110,146732,16336,1995,128401,50730,14830,27146,13831,9894,1102,135,8658,3421,163580,115033,29451,20158,9293,19096,-4869,23965,5756,3895,1861,523,1338,28419,29534,17911,0
5,1,1,1,20.6,41.3,25,13.1,930839,543620,293549,46040,9076,238433,93670,37050,25124,14673,7923,1243,245,6435,2528,316385,220921,54345,37324,17021,41119,-4612,45731,11585,6988,4597,498,4099,27310,31614,11157,2
1,1,7,9,34.3,35.2,18.1,12.4,415598,239550,110279,14419,1000,94860,65769,17109,24291,14001,6446,843,58,5544,3844,227988,146333,43514,35278,8236,38141,17126,21015,6115,4933,1182,184,998,37283,29664,21057,0
10,1,3,2,18,36.2,25.9,19.9,4643079,2805229,1293079,153916,7436,1131727,544771,128735,36067,21791,10045,1196,58,8791,4232,2364586,1613068,456686,356664,100022,294832,2942,291890,60732,45338,15394,894,14500,38935,35579,20130,3
9,1,6,5,15,33.1,32.6,19.4,1308393,766795,344810,50435,1993,292382,196788,39126,33440,19598,8813,1289,51,7473,5030,764878,485606,142644,113717,28927,136628,29421,107207,18784,14259,4525,526,3999,40720,34056,26808,0
5,1,7,9,31.8,30.1,25.3,12.9,291825,146890,112804,23593,3241,85970,32131,11481,25418,12794,9825,2055,282,7488,2799,138931,78138,21545,15497,6048,39248,16444,22804,4605,2925,1680,500,1180,30170,26714,19325,0
0,1,9,10,38.6,36.7,15.3,9.4,241763,134220,78929,14518,1800,62611,28614,10258,23568,13084,7694,1415,175,6104,2789,120075,60935,18174,14395,3779,40966,17942,23024,3940,2709,1231,377,854,30476,22494,26960,0
3,1,8,7,29.2,38.3,23.3,9.1,425400,255828,118819,13231,1177,104411,50753,16345,26026,15652,7269,809,72,6388,3105,186792,103484,29012,21194,7818,54296,35895,18401,5338,3459,1879,635,1244,34993,29917,14792,0
10,1,7,9,31.8,30.1,25.3,12.9,338147,163258,131881,23734,613,107534,43008,10939,30912,14924,12056,2170,56,9830,3932,138504,85913,23291,16647,6644,29300,9011,20289,4890,2872,2018,478,1540,28324,29914,13175,0
8,1,6,4,22.2,38.2,25.2,14.4,1055834,619962,315278,50907,4896,259475,120594,34403,30690,18021,9164,1480,142,7542,3505,639823,400401,96847,66024,30823,142575,39876,102699,16136,11733,4403,620,3783,39652,34126,27148,0
8,1,2,2,21.2,37.9,25.1,15.8,881393,559784,195167,23455,1595,170117,126442,22420,39313,24968,8705,1046,71,7588,5640,348285,203636,54515,39697,14818,90134,37923,52211,9038,6085,2953,327,2626,38536,33465,19882,0
10,1,6,4,26.4,42.5,20.8,10.3,952703,636611,206986,22367,1475,183144,109106,22895,41612,27806,9041,977,64,7999,4765,269591,189872,50563,38535,12028,29156,-3554,32710,6789,4768,2021,56,1965,39710,39822,16646,0
6,1,2,2,20.7,35.2,30.8,13.3,807634,440113,276061,29803,3917,242341,91460,27392,29484,16067,10078,1088,143,8847,3339,346161,226765,56718,38488,18230,62678,281,62397,11526,8414,3112,539,2573,30033,26951,24251,0
9,1,8,7,34.4,38.2,21.3,6.1,19732,3295,9539,1944,136,7459,6898,1393,14165,2365,6848,1396,98,5355,4952,-511,6750,1923,1326,597,-9184,-9684,500,474,291,183,67,116,-1078,23196,4310,0
1,1,5,8,26.6,31.7,24.2,17.5,892210,473778,253700,32036,2012,219652,164732,33220,26858,14262,7637,964,61,6612,4959,577049,410186,91913,61062,30851,74950,2058,72892,17193,13697,3496,209,3287,33563,29947,22176,3
6,1,4,5,20.2,48.9,20.2,10.6,1939640,1167259,450866,64524,8955,377387,321515,54135,35830,21562,8329,1192,165,6971,5939,1726062,1293527,279109,197355,81754,153426,-621,154047,33334,27868,5466,100,5366,51781,46416,28708,3
10,1,5,8,21.8,35.5,24.8,17.9,964020,421074,344529,61379,1804,281346,198417,30194,31928,13946,11411,2033,60,9318,6571,673535,522825,134678,94217,40461,16032,-41735,57767,18706,15685,3021,263,2758,36006,33333,20945,2
3,1,7,9,32.3,31.7,24.6,11.4,906540,556824,226084,24915,2101,199068,123632,29562,30666,18836,7648,843,71,6734,4182,706550,477451,111541,77313,34228,117558,34729,82829,17987,15210,2777,621,2156,39281,31391,38418,0
1,1,6,6,40.3,26.7,21.9,11.2,405567,196498,164388,32860,1586,129942,44681,19932,20348,9858,8247,1649,80,6519,2242,185121,126756,33432,23940,9492,24933,7863,17070,6720,4996,1724,462,1262,27548,25371,13526,0
4,1,4,5,23,26.5,29.7,20.8,1569569,940173,365011,51304,11350,302357,264385,48548,32330,19366,7519,1057,234,6228,5446,1169670,901485,229531,161300,68231,38654,7433,31221,28701,23752,4949,210,4739,40754,37954,6588,4
10,1,3,2,15.7,36.6,29.2,18.5,485579,229789,140341,10861,318,129162,115449,15940,30463,14416,8804,681,20,8103,7243,203650,142815,39366,29341,10025,21469,0,21469,5649,3879,1770,0,1770,36051,36817,12129,0
9,1,7,8,24,30.9,30.3,14.9,901440,561417,238735,24916,1629,212190,101288,30787,29280,18236,7754,809,53,6892,3290,568223,410927,94241,60152,34089,63055,-1151,64206,16359,12803,3556,756,2800,34735,32096,22931,0
8,1,9,10,22.6,41.6,21.9,13.9,344965,201331,102704,12143,756,89805,40930,10255,33639,19632,10015,1184,74,8757,3991,165923,78321,23572,18430,5142,64030,38517,25513,4150,2689,1461,480,981,39981,29126,26007,0
2,1,3,2,26.7,33.9,25.3,14.1,1613941,952245,409513,34956,5448,369109,252183,54486,29621,17477,7516,642,100,6774,4628,1198598,858684,215223,150729,64494,124691,3851,120840,29626,23915,5711,654,5057,40458,35906,23896,1
3,1,7,9,31.5,33.7,21.5,13.2,685242,394221,184476,15334,2325,166817,106545,26931,25444,14638,6850,569,86,6194,3956,406260,290944,69012,46922,22090,46304,2150,44154,13108,9677,3431,635,2796,30993,30066,15792,0
7,1,6,6,20.6,41.3,24.1,14,537441,283495,148857,18759,1873,128225,105089,16872,31854,16803,8823,1112,111,7600,6229,278810,189468,47722,36398,11324,41620,14002,27618,6264,4723,1541,252,1289,44510,40116,21426,0
8,1,6,6,20.6,37.1,30.3,11.9,706472,452213,173462,17703,2513,153246,80797,23199,30453,19493,7477,763,108,6606,3483,243724,168353,43436,30571,12865,31935,6636,25299,7717,5332,2385,494,1891,31583,31574,13379,1
4,1,3,2,17,27,29.2,26.8,1668341,1100639,288369,27901,7964,252504,279333,54197,30783,20308,5321,515,147,4659,5154,785425,535646,127921,87925,39996,121858,5723,116135,27042,19081,7961,404,7557,29045,28072,15368,1
7,1,2,2,12.2,31.6,35.6,20.7,4838254,3017742,1031051,110960,20484,899607,789461,139890,34586,21572,7370,793,146,6431,5643,3338171,2438513,650576,464249,186327,249082,-7830,256912,65213,52331,12882,358,12524,51189,46598,20514,5
9,1,7,9,24.9,37.4,25,12.6,708554,422435,189148,26140,1211,161797,96971,20451,34646,20656,9249,1278,59,7911,4742,389361,203472,48991,34086,14905,136898,72212,64686,7966,5688,2278,416,1862,48878,35772,34740,0
10,1,4,3,10.5,18.9,28.8,41.9,1966595,1136487,372291,26142,2184,343965,457817,52654,37349,21584,7071,496,41,6533,8695,1330561,925554,227412,159813,67599,177595,-223,177818,31996,24579,7417,377,7040,41585,37656,25258,6
1,1,8,4,36.8,32.9,22.3,8,733585,436047,202764,17313,1527,183924,94774,30779,23834,14167,6588,562,50,5976,3079,504315,356747,91937,64070,27867,55631,6136,49495,15498,12739,2759,623,2136,32541,28004,23172,1
4,1,2,2,16.1,26.4,26.7,30.8,17181191,11384327,2821785,380371,68164,2373250,2975079,437623,39260,26014,6448,869,156,5423,6798,16385920,12173978,2788281,2050167,738114,1423661,-641,1424302,333872,276192,57680,407,57273,49078,44078,24869,29
4,1,8,7,32.6,38,21.4,8,300210,173558,91909,10155,2857,78897,34743,14449,20777,12012,6361,703,198,5460,2405,98298,65683,19182,14310,4872,13433,3905,9528,3402,2326,1076,346,730,28894,28239,13052,0
7,1,2,2,14.7,40.4,27.5,17.4,4705017,3363254,821048,93996,12755,714297,520715,131843,35687,25510,6227,713,97,5418,3950,1442884,910609,222393,163533,58860,309882,-771,310653,39003,25327,13676,350,13326,36994,35954,23312,2
0,1,4,5,19.6,24.7,23.9,31.8,1190504,731266,241814,33271,6557,201986,217424,44580,26705,16403,5424,746,147,4531,4877,868226,529963,144658,113018,31640,193605,27396,166209,23084,19038,4046,277,3769,37612,27837,44099,0
0,1,1,1,20.7,30,27.8,21.5,15257862,10277876,2867691,539381,53601,2274709,2112295,456554,33420,22512,6281,1181,117,4982,4627,10963758,7628856,1677134,1173556,503578,1657768,486,1657282,255091,212271,42820,45,42775,42980,35939,38744,37
9,1,3,2,13.9,33.9,30.5,21.7,8087496,5313247,1548143,171319,8573,1368251,1226106,196641,41128,27020,7873,871,44,6958,6235,6258510,4318354,1118987,837420,281567,821169,11164,810005,116398,94086,22312,751,21561,53768,45898,37568,5
3,1,2,2,22.8,43.2,22.6,11.4,4093792,3005255,661853,72540,6627,582686,426684,123962,33025,24243,5339,585,53,4701,3442,1186813,817795,197576,146582,50994,171442,-1415,172857,38402,24688,13714,400,13314,30905,33125,12983,2
9,1,9,8,15.9,37.3,32.9,13.9,576852,339099,172684,19679,931,152074,65069,16529,34899,20515,10447,1191,56,9200,3937,262931,157539,41043,29247,11796,64349,42610,21739,6315,4332,1983,377,1606,41636,36366,13536,0
9,1,4,5,17.8,31.1,32.6,18.4,2574837,1465073,728102,68318,2837,656947,381662,68303,37697,21450,10660,1000,42,9618,5588,1860529,1259111,316700,226763,89937,284718,84501,200217,38663,31236,7427,792,6635,48122,40310,30176,1
10,1,8,6,23.4,37,28.2,11.4,258942,114077,99805,17896,545,81364,45060,8510,30428,13405,11728,2103,64,9561,5295,95917,61968,19543,14852,4691,14406,10747,3659,3110,1953,1157,266,891,30841,31730,4107,1
7,1,2,2,20.7,35.2,30.8,13.3,855779,487569,274462,30891,3167,240404,93748,27413,31218,17786,10012,1127,116,8770,3420,372885,226624,57202,39105,18097,89059,23607,65452,11359,8175,3184,512,2672,32827,27722,24496,0
3,1,6,5,27.3,32.1,22.2,18.4,1171009,718152,291771,44880,2758,244133,161086,39244,29839,18300,7435,1144,70,6221,4105,715529,456889,123016,96661,26355,135624,5038,130586,18771,14871,3900,491,3409,38119,30723,38306,0
8,1,6,6,24.6,41.7,21.5,12.2,453551,271812,128020,9665,808,117547,53719,14812,30621,18351,8643,653,55,7936,3627,284045,195971,50858,38938,11920,37216,-712,37928,6652,5254,1398,161,1237,42701,37299,30661,0
7,1,6,6,21.7,38.3,27.9,12.1,583929,327400,190900,26050,2907,161943,65629,23194,25176,14116,8231,1123,125,6982,2830,263359,163613,42707,28770,13937,57039,17323,39716,8030,5718,2312,550,1762,32797,28614,22540,1
6,1,6,6,20.6,37.1,30.3,11.9,655376,414347,166055,17267,4213,144575,74974,22845,28688,18137,7269,756,184,6329,3282,213503,150894,39153,27421,11732,23456,-1868,25324,7406,4993,2413,512,1901,28828,30221,13321,0
0,1,7,8,35.4,34.5,20.6,9.6,537472,302183,163045,34634,4073,124338,72244,19885,27029,15197,8199,1742,205,6253,3633,290234,152525,42953,33842,9111,94756,14066,80690,7685,5846,1839,328,1511,37766,26090,53402,1
9,1,1,1,10.5,25.9,31.1,32.5,13987088,9772767,1863922,137156,9816,1716950,2350399,245511,56971,39806,7592,559,40,6993,9573,7569218,4048356,916643,666180,250463,2604219,5287,2598932,131302,89952,41350,501,40849,57647,45006,63623,57
8,1,2,2,12.2,31.6,35.6,20.7,4838137,3013305,1055211,114480,16138,924593,769621,140260,34494,21484,7523,816,115,6592,5487,3540856,2603485,693219,492434,200785,244152,-2930,247082,66990,53816,13174,351,12823,52856,48378,19269,4
5,1,8,7,23.1,42.8,21.8,12.4,306692,170285,102381,11109,2433,88839,34026,10154,30204,16770,10083,1094,240,8749,3351,122400,82951,25033,19865,5168,14416,468,13948,3880,2774,1106,253,853,31546,29903,16352,1
9,1,4,5,11.8,26.8,25.2,36.2,1650745,980469,333356,42010,2378,288968,336920,47342,34869,20710,7041,887,50,6104,7117,1100057,692464,184029,141856,42173,223564,28223,195341,25411,19115,6296,283,6013,43291,36226,32486,10
9,1,8,7,24.3,35.8,25,15,317180,153949,128527,19166,764,108597,34704,11822,26830,13022,10872,1621,65,9186,2936,102659,61116,16926,12184,4742,24617,14864,9753,3405,2051,1354,285,1069,30149,29798,9123,3
3,1,7,9,31,37.6,21.8,9.6,321975,153299,117402,13052,1301,103049,51274,12857,25043,11923,9131,1015,101,8015,3988,148195,99337,26872,19310,7562,21986,-789,22775,4922,3303,1619,320,1299,30109,30075,17533,1
7,1,6,6,20.6,37.1,30.3,11.9,683978,425810,170181,18066,3205,148910,87987,22906,29860,18589,7430,789,140,6501,3841,231793,162939,41640,28924,12716,27214,-2117,29331,7715,5288,2427,501,1926,30044,30813,15229,0
1,1,7,9,34.5,35.9,20.6,9,507178,304981,148602,14511,1345,132746,53595,21688,23385,14062,6852,669,62,6121,2471,313422,224442,56193,38455,17738,32787,-411,33198,10465,7962,2503,602,1901,29950,28189,17463,0
9,1,6,6,21.7,38.3,27.9,12.1,688806,418038,203476,25838,989,176649,67292,23182,29713,18033,8777,1115,43,7620,2903,342761,173051,46246,32238,14008,123464,88972,34492,8084,5833,2251,538,1713,42400,29668,20135,0
1,1,3,2,21.2,28.4,26.4,24,5545149,3534160,965370,99874,7493,858003,1045619,181383,30571,19485,5322,551,41,4730,5765,4423397,3291893,815874,584024,231850,315630,2852,312778,108650,93227,15423,461,14962,40712,35311,20905,8
6,1,7,9,19,37,30,14,379475,189641,139084,16764,2415,119905,50750,12516,30319,15152,11112,1339,193,9580,4055,166330,106540,27750,19014,8736,32040,7047,24993,5328,3460,1868,317,1551,31218,30792,16114,0
5,1,3,2,15.3,37.1,27.5,20.1,4761857,2742542,1290872,139358,23763,1127751,728443,131772,36137,20813,9796,1058,180,8558,5528,3324355,2304464,613927,465075,148852,405964,33204,372760,75894,63083,12811,753,12058,43803,36531,30914,6
1,1,2,2,18.2,26.2,27.6,27.9,20829534,7862361,1733567,97975,11593,1623999,11233606,312621,66629,25150,5545,313,37,5195,35934,8558763,5961974,1136877,721707,415170,1459912,81165,1378747,190179,147122,43057,205,42852,45004,40524,32175,69
6,1,7,11,29.5,39.3,21.5,9.8,247053,117587,85197,17177,1832,66188,44269,7657,32265,15357,11127,2243,239,8644,5782,125921,65688,19692,15594,4098,40541,31822,8719,2862,2164,698,178,520,43998,30355,16767,0
4,1,8,5,32.8,35.6,22.2,9.4,329924,172795,114520,14024,2715,97781,42609,13171,25049,13119,8695,1065,206,7424,3235,94588,60997,15703,11116,4587,17888,8537,9351,3639,2257,1382,511,871,25993,27026,10736,0
0,1,4,3,15.1,28.9,30.5,25.5,4184826,1781469,358677,34706,2994,320977,2044680,75819,55195,23496,4731,458,39,4233,26968,1976590,1402569,329312,231506,97806,244709,0,244709,53888,40122,13766,0,13766,36680,34958,17776,16
3,1,2,2,14.6,29.2,33.4,22.9,5316075,3352838,868233,65573,12334,790326,1095004,148538,35789,22572,5845,441,83,5321,7372,1796249,1244139,326879,235456,91423,225231,6131,219100,51538,35385,16153,540,15613,34853,35160,14033,19
7,1,8,7,18.5,42.6,23.2,15.6,287524,160265,80745,12163,945,67637,46514,9074,31687,17662,8899,1340,104,7454,5126,159025,113036,29166,21972,7194,16823,4402,12421,4206,2852,1354,217,1137,37809,39634,10924,1
10,1,3,2,14.2,46.6,26.5,12.8,808627,468019,236654,23481,1267,211906,103954,22499,35941,20802,10518,1044,56,9418,4620,284511,164390,47661,36651,11010,72460,32439,40021,8125,5152,2973,349,2624,35017,31908,15252,0
7,1,8,7,24.1,36.8,30.5,8.7,343917,200830,105163,12679,1985,90499,37924,14338,23986,14007,7335,884,138,6312,2645,94703,64901,18999,13992,5007,10803,-1807,12610,3417,2298,1119,341,778,27715,28242,16208,0
2,1,7,9,31,37.6,21.8,9.6,311679,160776,105554,12661,821,92072,45349,13036,23909,12333,8097,971,63,7063,3479,148740,94838,25621,18521,7100,28281,2311,25970,4950,3223,1727,324,1403,30048,29425,18510,0
9,1,7,8,27.8,29.4,28.3,14.5,726753,336576,272822,53323,1958,217541,117355,27398,26526,12285,9958,1946,71,7940,4283,417091,295799,81609,59051,22558,39683,2448,37235,12178,9765,2413,275,2138,34250,30292,17416,0
0,1,3,2,20.7,27.9,28.6,22.8,1966955,1180658,450059,65021,5096,379942,336238,72043,27303,16388,6247,903,71,5274,4667,1735823,1236369,318104,228160,89944,181350,7792,173558,46335,40844,5491,360,5131,37462,30271,33825,6
10,1,7,11,18.5,44.3,24.2,13,832256,447852,259818,34061,1618,224139,124586,24708,33684,18126,10516,1379,65,9072,5042,479377,335302,86596,61962,24634,57479,3973,53506,12146,8957,3189,238,2951,39468,37435,18131,2
6,1,5,8,15.3,30.7,30.4,23.6,1983918,1159599,480844,64312,10826,405706,343475,59591,33292,19459,8069,1079,182,6808,5764,1507199,1111386,275493,185775,89718,120320,-90,120410,34274,28023,6251,363,5888,43975,39660,20450,5
8,1,6,6,18.6,36.7,26.2,18.4,355927,157159,95458,10481,618,84359,103310,11519,30899,13643,8287,910,54,7323,8969,182198,114107,32215,23835,8380,35876,0,35876,5430,3632,1798,0,1798,33554,31417,19953,1
9,1,9,8,20,33,33.9,13.1,279723,141030,105773,12923,857,91993,32920,10248,27295,13762,10321,1261,84,8977,3212,305926,235530,52871,34755,18116,17525,8758,8767,5379,4367,1012,324,688,56874,53934,12743,0
5,1,8,7,19.8,42.3,26.8,11,458988,277491,135452,16249,3034,116169,46045,16503,27812,16815,8208,985,184,7039,2790,205128,102771,27706,19810,7896,74651,51315,23336,5223,3277,1946,604,1342,39274,31361,17389,1
2,1,8,7,34.6,38.6,18,8.8,280375,169338,83664,7890,482,75292,27373,10189,27517,16620,8211,774,47,7390,2687,112031,76433,22491,17822,4669,13107,2843,10264,3999,2897,1102,255,847,28015,26384,12118,0
1,1,3,2,26.9,41.6,21.7,9.8,484118,314006,118367,14015,1120,103232,51745,21039,23011,14925,5626,666,53,4907,2459,162867,102348,33982,27588,6394,26537,2171,24366,5002,3487,1515,189,1326,32560,29351,18376,1
1,1,3,2,20.7,27.9,28.6,22.8,2098878,1260657,445279,49124,4070,392085,392942,73219,28666,17218,6081,671,56,5355,5367,1916904,1360036,337456,238127,99329,219412,6702,212710,48298,42133,6165,345,5820,39689,32280,36548,3
5,1,1,1,17.8,36.3,26.6,19.3,998905,686959,158955,16964,3085,138906,152991,23123,43200,29709,6874,734,133,6007,6616,1287790,915387,235136,176372,58764,137267,10258,127009,19813,16157,3656,118,3538,64997,56656,35899,1
6,1,3,2,15.7,36.6,29.2,18.5,424176,208108,124207,11160,2656,110391,91861,15760,26915,13205,7881,708,169,7005,5829,183964,129389,37914,28585,9329,16661,0,16661,5283,3727,1556,0,1556,34822,34717,10708,1
0,1,2,2,30.7,30.2,27.6,11.6,658232,405439,179946,28962,2274,148710,72847,29134,22593,13916,6176,994,78,5104,2500,326204,219262,63633,47111,16522,43309,13916,29393,11619,8914,2705,584,2121,28075,24597,13858,1
7,1,1,1,15.8,44.5,25.7,14,891282,632077,172872,22952,3184,146736,86333,21638,41191,29211,7989,1061,147,6781,3990,734026,496965,136884,106505,30379,100177,2586,97591,10604,8475,2129,46,2083,69222,58639,46851,0
5,1,9,10,20.9,43.2,23.9,12,299946,126538,129905,29961,3997,95947,43503,11562,25942,10944,11236,2591,346,8298,3763,169806,107275,28780,20911,7869,33751,7659,26092,4405,2896,1509,301,1208,38548,37042,21599,0
2,1,9,10,35,34.7,20.6,9.6,339738,175138,114672,14360,877,99435,49928,14216,23898,12320,8066,1010,62,6995,3512,239120,180565,40089,27955,12134,18466,2837,15629,5635,4375,1260,241,1019,42435,41272,15338,0
5,1,7,8,23.6,40.6,24.4,11.4,676472,417129,183461,28653,4560,150248,75882,20839,32462,20017,8804,1375,219,7210,3641,418567,188883,54525,42853,11672,175159,16544,158615,8365,6257,2108,395,1713,50038,30187,92595,0
8,1,9,8,21.1,34.9,30.8,13.3,573621,345828,169851,17024,1979,150848,57942,16421,34932,21060,10344,1037,121,9186,3529,176105,113568,28311,19757,8554,34226,11198,23028,5084,3464,1620,286,1334,34639,32785,17262,0
4,1,6,6,33.5,33.4,21.6,11.5,669614,332820,236240,31069,5390,199781,100554,26979,24820,12336,8756,1152,200,7405,3727,371772,269088,63832,43680,20152,38852,13293,25559,11618,8733,2885,501,2384,32000,30813,10721,0
9,1,3,2,18.9,42.7,23.9,14.4,485789,254913,161099,24473,1080,135546,69777,15048,32283,16940,10706,1626,72,9008,4637,159232,100388,28249,20799,7450,30595,18543,12052,4861,3006,1855,398,1457,32757,33396,8272,0
8,1,6,5,15,33.1,32.6,19.4,1273874,741846,345781,51654,3010,291117,186247,39112,32570,18967,8841,1321,77,7443,4762,741733,478603,135507,106640,28867,127623,36806,90817,18778,14253,4525,527,3998,39500,33579,22716,0
6,1,9,8,20,33,33.9,13.1,242949,113903,96875,12937,2034,81904,32171,10308,23569,11050,9398,1255,197,7946,3121,111349,79616,21627,15230,6397,10106,884,9222,3508,2620,888,348,540,31741,30388,17078,1
6,1,2,2,22.5,38.8,23.8,15,1147911,728706,265781,41213,5759,218809,153424,33353,34417,21848,7969,1236,173,6560,4600,1096460,825796,206945,156624,50321,63719,7477,56242,17871,14691,3180,134,3046,61354,56211,18464,1
1,1,9,10,35,34.7,20.6,9.6,331906,179676,111817,12436,784,98597,40413,14431,23000,12451,7748,862,54,6832,2800,247406,188548,41172,28710,12462,17686,-86,17772,5661,4519,1142,211,931,43704,41723,19089,0
2,1,5,8,20,21.7,23.4,34.8,1200753,749343,209945,27448,2584,179913,241465,46032,26085,16279,4561,596,56,3908,5246,871567,629129,172543,126691,45852,69895,1431,68464,25992,21887,4105,385,3720,33532,28744,18404,18
3,1,6,6,24,32.3,27.4,16.2,1981833,1043386,326586,25577,5072,295937,611861,53563,37000,19480,6097,478,95,5525,11423,933333,668049,156984,109521,47463,108300,942,107358,29547,20675,8872,666,8206,31588,32312,13083,9
0,1,6,3,25.4,31.2,29.5,13.9,1271560,759716,342830,50858,4373,287599,169014,50990,24937,14899,6723,997,86,5640,3315,453589,277708,75500,55057,20443,100381,2923,97458,17074,10917,6157,766,5391,26566,25438,18078,0
5,1,3,2,9.8,27.8,31.7,30.7,6643563,3814502,1441178,109557,40737,1290884,1387883,183110,36282,20832,7871,598,222,7050,7580,2799688,2000662,487721,332314,155407,311305,-8550,319855,89246,63795,25451,906,24545,31370,31361,13031,11
6,1,7,8,21.2,29,31.7,18.1,680172,352815,223402,28608,4186,190608,103955,21608,31478,16328,10339,1324,194,8821,4811,471683,332426,82612,54975,27637,56645,5400,51245,12885,10428,2457,277,2180,36607,31878,23507,0
0,1,9,10,35,34.7,20.6,9.6,318924,174515,102487,13022,860,88605,41922,14545,21927,11998,7046,895,59,6092,2882,232983,178334,40884,28905,11979,13765,-98,13863,5542,4472,1070,215,855,42040,39878,16214,0
3,1,7,8,34.1,31.5,25.6,8.8,638479,362748,187691,11807,3290,172594,88040,23412,27271,15494,8017,504,141,7372,3760,259219,192395,48208,34040,14168,18616,5283,13333,7990,6323,1667,411,1256,32443,30428,10615,2
